continent,country,pop,date,new_cases,new_deaths,total_cases,total_deaths,case_rate,death_rate,days,country_id
Asia,Afghanistan,37172386,2020-04-16,70,2,784,25,0.021090924860190572,0.03188775510204082,0,1
Asia,Afghanistan,37172386,2020-04-17,10,4,794,29,0.02135994175891749,0.036523929471032744,1,1
Asia,Afghanistan,37172386,2020-04-18,51,1,845,30,0.022731927942424787,0.03550295857988166,2,1
Asia,Afghanistan,37172386,2020-04-19,63,0,908,30,0.02442673440440439,0.03303964757709251,3,1
Asia,Afghanistan,37172386,2020-04-20,88,3,996,33,0.02679408311320129,0.03313253012048193,4,1
Asia,Afghanistan,37172386,2020-04-21,35,2,1031,35,0.02773564225874551,0.03394762366634336,5,1
Asia,Afghanistan,37172386,2020-04-22,61,1,1092,36,0.029376645340979727,0.03296703296703297,6,1
Asia,Afghanistan,37172386,2020-04-23,84,4,1176,40,0.03163638729028586,0.034013605442176874,7,1
Asia,Afghanistan,37172386,2020-04-24,105,2,1281,42,0.034461064726918525,0.03278688524590164,8,1
Asia,Afghanistan,37172386,2020-04-25,70,1,1351,43,0.036344183018006966,0.03182827535159141,9,1
Asia,Afghanistan,37172386,2020-04-26,112,4,1463,47,0.03935717228374848,0.03212576896787423,10,1
Asia,Afghanistan,37172386,2020-04-27,68,10,1531,57,0.041186487195091534,0.037230568256041804,11,1
Asia,Afghanistan,37172386,2020-04-28,172,0,1703,57,0.04581357785319457,0.03347034644744568,12,1
Asia,Afghanistan,37172386,2020-04-29,124,3,1827,60,0.04914938739740839,0.03284072249589491,13,1
Asia,Afghanistan,37172386,2020-04-30,122,0,1949,60,0.05243139356187682,0.03078501795792714,14,1
Asia,Afghanistan,37172386,2020-05-01,222,4,2171,64,0.058403568713614455,0.02947950253339475,15,1
Asia,Afghanistan,37172386,2020-05-02,164,4,2335,68,0.06281544585273596,0.029122055674518203,16,1
Asia,Afghanistan,37172386,2020-05-03,134,4,2469,72,0.0664202722956767,0.02916160388821385,17,1
Asia,Afghanistan,37172386,2020-05-04,235,13,2704,85,0.07274216941575933,0.03143491124260355,18,1
Asia,Afghanistan,37172386,2020-05-05,190,5,2894,90,0.07785349049157081,0.031098825155494125,19,1
Asia,Afghanistan,37172386,2020-05-06,330,5,3224,95,0.08673104814955919,0.02946650124069479,20,1
Asia,Afghanistan,37172386,2020-05-07,168,9,3392,104,0.09125053204817145,0.030660377358490566,21,1
Asia,Afghanistan,37172386,2020-05-08,171,2,3563,106,0.0958507210164018,0.029750210496772383,22,1
Asia,Afghanistan,37172386,2020-05-09,215,3,3778,109,0.1016345843390306,0.028851244044467973,23,1
Asia,Afghanistan,37172386,2020-05-10,255,6,4033,115,0.10849451525656706,0.02851475328539549,24,1
Asia,Afghanistan,37172386,2020-05-11,369,5,4402,120,0.11842123881959044,0.027260336210813266,25,1
Asia,Afghanistan,37172386,2020-05-12,285,2,4687,122,0.12608822043330767,0.026029443140601665,26,1
Asia,Afghanistan,37172386,2020-05-13,280,5,4967,127,0.13362069359766143,0.025568753774914434,27,1
Asia,Afghanistan,37172386,2020-05-14,259,3,5226,130,0.1405882312746887,0.024875621890547265,28,1
Asia,Afghanistan,37172386,2020-05-15,113,6,5339,136,0.14362812223030288,0.025472935006555536,29,1
Asia,Afghanistan,37172386,2020-05-16,1063,32,6402,168,0.17222461856497456,0.026241799437675725,30,1
Asia,Afghanistan,37172386,2020-05-17,0,0,6402,168,0.17222461856497456,0.026241799437675725,31,1
Asia,Afghanistan,37172386,2020-05-18,262,1,6664,169,0.17927286131161985,0.02536014405762305,32,1
Asia,Afghanistan,37172386,2020-05-19,408,4,7072,173,0.19024875077967823,0.02446266968325792,33,1
Asia,Afghanistan,37172386,2020-05-20,581,5,7653,178,0.2058786325957123,0.023258852737488567,34,1
Asia,Afghanistan,37172386,2020-05-21,492,9,8145,187,0.2191142640130768,0.02295887047268263,35,1
Asia,Afghanistan,37172386,2020-05-22,531,6,8676,193,0.2333990613354763,0.022245274319963117,36,1
Asia,Afghanistan,37172386,2020-05-23,540,12,9216,205,0.24792597386673002,0.022243923611111112,37,1
Asia,Afghanistan,37172386,2020-05-24,782,11,9998,216,0.26896309534717516,0.021604320864172834,38,1
Asia,Afghanistan,37172386,2020-05-25,584,2,10582,218,0.28467368223282735,0.020601020601020602,39,1
Asia,Afghanistan,37172386,2020-05-26,591,1,11173,219,0.3005725809475884,0.019600823413586325,40,1
Asia,Afghanistan,37172386,2020-05-27,658,1,11831,220,0.31827389288381974,0.01859521595807624,41,1
Europe,Albania,2866376,2020-03-19,4,1,59,2,0.020583482418217287,0.03389830508474576,0,2
Europe,Albania,2866376,2020-03-20,11,0,70,2,0.024421080835173054,0.02857142857142857,1,2
Europe,Albania,2866376,2020-03-21,0,0,70,2,0.024421080835173054,0.02857142857142857,2,2
Europe,Albania,2866376,2020-03-22,6,0,76,2,0.026514316335330742,0.02631578947368421,3,2
Europe,Albania,2866376,2020-03-23,13,0,89,2,0.03104965991900574,0.02247191011235955,4,2
Europe,Albania,2866376,2020-03-24,11,2,100,4,0.034887258335961506,0.04,5,2
Europe,Albania,2866376,2020-03-25,23,1,123,5,0.04291132775323265,0.04065040650406504,6,2
Europe,Albania,2866376,2020-03-26,23,0,146,5,0.0509353971705038,0.03424657534246575,7,2
Europe,Albania,2866376,2020-03-27,28,1,174,6,0.060703829504573016,0.034482758620689655,8,2
Europe,Albania,2866376,2020-03-28,12,3,186,9,0.06489030050488839,0.04838709677419355,9,2
Europe,Albania,2866376,2020-03-29,11,1,197,10,0.06872789892184417,0.050761421319796954,10,2
Europe,Albania,2866376,2020-03-30,15,0,212,10,0.0739609876722384,0.04716981132075472,11,2
Europe,Albania,2866376,2020-03-31,11,2,223,12,0.07779858608919415,0.053811659192825115,12,2
Europe,Albania,2866376,2020-04-01,20,3,243,15,0.08477603775638647,0.06172839506172839,13,2
Europe,Albania,2866376,2020-04-02,16,0,259,15,0.0903579990901403,0.05791505791505792,14,2
Europe,Albania,2866376,2020-04-03,18,1,277,16,0.09663770559061338,0.05776173285198556,15,2
Europe,Albania,2866376,2020-04-04,27,1,304,17,0.10605726534132297,0.05592105263157895,16,2
Europe,Albania,2866376,2020-04-05,29,2,333,19,0.11617457025875182,0.057057057057057055,17,2
Europe,Albania,2866376,2020-04-06,28,2,361,21,0.12594300259282104,0.05817174515235457,18,2
Europe,Albania,2866376,2020-04-07,16,1,377,22,0.13152496392657487,0.058355437665782495,19,2
Europe,Albania,2866376,2020-04-08,6,0,383,22,0.13361819942673256,0.057441253263707574,20,2
Europe,Albania,2866376,2020-04-09,17,0,400,22,0.13954903334384602,0.055,21,2
Europe,Albania,2866376,2020-04-10,9,1,409,23,0.14268888659408258,0.05623471882640587,22,2
Europe,Albania,2866376,2020-04-11,7,0,416,23,0.14513099467759988,0.055288461538461536,23,2
Europe,Albania,2866376,2020-04-12,17,0,433,23,0.15106182859471332,0.053117782909930716,24,2
Europe,Albania,2866376,2020-04-13,13,0,446,23,0.1555971721783883,0.0515695067264574,25,2
Europe,Albania,2866376,2020-04-14,21,0,467,23,0.16292349642894022,0.04925053533190578,26,2
Europe,Albania,2866376,2020-04-15,8,1,475,24,0.16571447709581716,0.05052631578947368,27,2
Europe,Albania,2866376,2020-04-16,19,1,494,25,0.17234305617964985,0.05060728744939271,28,2
Europe,Albania,2866376,2020-04-17,24,1,518,26,0.1807159981802806,0.05019305019305019,29,2
Europe,Albania,2866376,2020-04-18,21,0,539,26,0.18804232243083252,0.04823747680890538,30,2
Europe,Albania,2866376,2020-04-19,9,0,548,26,0.19118217568106904,0.04744525547445255,31,2
Europe,Albania,2866376,2020-04-20,14,0,562,26,0.19606639184810368,0.046263345195729534,32,2
Europe,Albania,2866376,2020-04-21,22,0,584,26,0.2037415886820152,0.04452054794520548,33,2
Europe,Albania,2866376,2020-04-22,25,0,609,26,0.21246340326600557,0.042692939244663386,34,2
Europe,Albania,2866376,2020-04-23,25,1,634,27,0.22118521784999595,0.04258675078864353,35,2
Europe,Albania,2866376,2020-04-24,29,0,663,27,0.2313025227674248,0.04072398190045249,36,2
Europe,Albania,2866376,2020-04-25,15,0,678,27,0.23653561151781902,0.03982300884955752,37,2
Europe,Albania,2866376,2020-04-26,34,0,712,27,0.24839727935204592,0.037921348314606744,38,2
Europe,Albania,2866376,2020-04-27,14,1,726,28,0.2532814955190805,0.03856749311294766,39,2
Europe,Albania,2866376,2020-04-28,10,0,736,28,0.2567702213526767,0.03804347826086957,40,2
Europe,Albania,2866376,2020-04-29,14,2,750,30,0.26165443751971135,0.04,41,2
Europe,Albania,2866376,2020-04-30,16,1,766,31,0.2672363988534651,0.04046997389033943,42,2
Europe,Albania,2866376,2020-05-01,7,0,773,31,0.2696785069369824,0.040103492884864166,43,2
Europe,Albania,2866376,2020-05-02,9,0,782,31,0.272818360187219,0.03964194373401535,44,2
Europe,Albania,2866376,2020-05-03,7,0,789,31,0.2752604682707363,0.03929024081115336,45,2
Europe,Albania,2866376,2020-05-04,6,0,795,31,0.27735370377089397,0.0389937106918239,46,2
Europe,Albania,2866376,2020-05-05,8,0,803,31,0.2801446844377709,0.038605230386052306,47,2
Europe,Albania,2866376,2020-05-06,17,0,820,31,0.2860755183548844,0.03780487804878049,48,2
Europe,Albania,2866376,2020-05-07,12,0,832,31,0.29026198935519976,0.037259615384615384,49,2
Europe,Albania,2866376,2020-05-08,10,0,842,31,0.2937507151887959,0.03681710213776722,50,2
Europe,Albania,2866376,2020-05-09,8,0,850,31,0.2965416958556728,0.036470588235294116,51,2
Europe,Albania,2866376,2020-05-10,6,0,856,31,0.2986349313558305,0.036214953271028034,52,2
Europe,Albania,2866376,2020-05-11,12,0,868,31,0.3028214023561459,0.03571428571428571,53,2
Europe,Albania,2866376,2020-05-12,4,0,872,31,0.30421689268958435,0.03555045871559633,54,2
Europe,Albania,2866376,2020-05-13,4,0,876,31,0.3056123830230228,0.03538812785388128,55,2
Europe,Albania,2866376,2020-05-14,4,0,880,31,0.30700787335646124,0.035227272727272725,56,2
Europe,Albania,2866376,2020-05-15,18,0,898,31,0.31328757985693434,0.034521158129175944,57,2
Europe,Albania,2866376,2020-05-16,18,0,916,31,0.3195672863574074,0.03384279475982533,58,2
Europe,Albania,2866376,2020-05-17,17,0,933,31,0.32549812027452085,0.03322615219721329,59,2
Europe,Albania,2866376,2020-05-18,13,0,946,31,0.3300334638581959,0.03276955602536998,60,2
Europe,Albania,2866376,2020-05-19,2,0,948,31,0.33073120902491504,0.03270042194092827,61,2
Europe,Albania,2866376,2020-05-20,1,0,949,31,0.3310800816082747,0.032665964172813484,62,2
Europe,Albania,2866376,2020-05-21,15,0,964,31,0.3363131703586689,0.032157676348547715,63,2
Europe,Albania,2866376,2020-05-22,5,0,969,31,0.338057533275467,0.03199174406604747,64,2
Europe,Albania,2866376,2020-05-23,12,0,981,31,0.3422440042757824,0.03160040774719674,65,2
Europe,Albania,2866376,2020-05-24,8,0,989,31,0.34503498494265933,0.03134479271991911,66,2
Europe,Albania,2866376,2020-05-25,9,1,998,32,0.3481748381928958,0.03206412825651302,67,2
Europe,Albania,2866376,2020-05-26,6,0,1004,32,0.35026807369305357,0.03187250996015936,68,2
Europe,Albania,2866376,2020-05-27,25,1,1029,33,0.3589898882770439,0.03206997084548105,69,2
Africa,Algeria,42228429,2020-04-02,131,14,847,58,0.02005757779906991,0.06847697756788666,0,3
Africa,Algeria,42228429,2020-04-03,139,5,986,63,0.02334919918522188,0.06389452332657201,1,3
Africa,Algeria,42228429,2020-04-04,185,42,1171,105,0.027730134123625582,0.089666951323655,2,3
Africa,Algeria,42228429,2020-04-05,80,25,1251,130,0.02962459247536772,0.10391686650679456,3,3
Africa,Algeria,42228429,2020-04-06,69,22,1320,152,0.03125856280374532,0.11515151515151516,4,3
Africa,Algeria,42228429,2020-04-07,103,21,1423,173,0.03369767793161332,0.12157413914265636,5,3
Africa,Algeria,42228429,2020-04-08,45,20,1468,193,0.03476331075446827,0.13147138964577657,6,3
Africa,Algeria,42228429,2020-04-09,104,12,1572,205,0.037226106611733055,0.13040712468193386,7,3
Africa,Algeria,42228429,2020-04-10,94,30,1666,235,0.03945209517503007,0.14105642256902762,8,3
Africa,Algeria,42228429,2020-04-11,95,21,1761,256,0.04170176446772386,0.14537194775695628,9,3
Africa,Algeria,42228429,2020-04-12,64,19,1825,275,0.04321733114911758,0.1506849315068493,10,3
Africa,Algeria,42228429,2020-04-13,89,18,1914,293,0.04532491606543071,0.15308254963427378,11,3
Africa,Algeria,42228429,2020-04-14,69,20,1983,313,0.046958886393808304,0.1578416540595058,12,3
Africa,Algeria,42228429,2020-04-15,87,12,2070,325,0.04901910985132788,0.1570048309178744,13,3
Africa,Algeria,42228429,2020-04-16,90,11,2160,336,0.05115037549703779,0.15555555555555556,14,3
Africa,Algeria,42228429,2020-04-17,108,12,2268,348,0.053707894271889677,0.15343915343915343,15,3
Africa,Algeria,42228429,2020-04-18,150,16,2418,364,0.05726000368140619,0.15053763440860216,16,3
Africa,Algeria,42228429,2020-04-19,117,3,2535,367,0.06003064902082907,0.14477317554240632,17,3
Africa,Algeria,42228429,2020-04-20,94,8,2629,375,0.06225663758412609,0.14263978699125143,18,3
Africa,Algeria,42228429,2020-04-21,89,9,2718,384,0.06436422250043923,0.141280353200883,19,3
Africa,Algeria,42228429,2020-04-22,93,8,2811,392,0.06656653033433946,0.13945215225898258,20,3
Africa,Algeria,42228429,2020-04-23,99,10,2910,402,0.06891092254462036,0.13814432989690723,21,3
Africa,Algeria,42228429,2020-04-24,97,5,3007,407,0.0712079532961077,0.13535084802128367,22,3
Africa,Algeria,42228429,2020-04-25,120,8,3127,415,0.07404964082372091,0.13271506236008954,23,3
Africa,Algeria,42228429,2020-04-26,129,4,3256,419,0.07710445491590512,0.1286855036855037,24,3
Africa,Algeria,42228429,2020-04-27,126,6,3382,425,0.08008822681989898,0.12566528681253697,25,3
Africa,Algeria,42228429,2020-04-28,135,7,3517,432,0.08328512528846385,0.12283195905601364,26,3
Africa,Algeria,42228429,2020-04-29,132,5,3649,437,0.08641098156883838,0.11975883803781857,27,3
Africa,Algeria,42228429,2020-04-30,199,7,3848,444,0.09112344671879695,0.11538461538461539,28,3
Africa,Algeria,42228429,2020-05-01,158,6,4006,450,0.09486500196348767,0.11233150274588118,29,3
Africa,Algeria,42228429,2020-05-02,148,3,4154,453,0.09836974991421064,0.1090515166104959,30,3
Africa,Algeria,42228429,2020-05-03,141,6,4295,459,0.10170873275915616,0.10686845168800932,31,3
Africa,Algeria,42228429,2020-05-04,179,4,4474,463,0.10594758332117919,0.10348681269557443,32,3
Africa,Algeria,42228429,2020-05-05,174,2,4648,465,0.11006803023621836,0.10004302925989673,33,3
Africa,Algeria,42228429,2020-05-06,190,5,4838,470,0.11456736882160594,0.09714758164530798,34,3
Africa,Algeria,42228429,2020-05-07,159,6,4997,476,0.11833260479569345,0.09525715429257554,35,3
Africa,Algeria,42228429,2020-05-08,185,7,5182,483,0.12271353973409714,0.0932072558857584,36,3
Africa,Algeria,42228429,2020-05-09,187,5,5369,488,0.1271418361312944,0.09089215868876886,37,3
Africa,Algeria,42228429,2020-05-10,189,6,5558,494,0.1316174939872852,0.08888089240734078,38,3
Africa,Algeria,42228429,2020-05-11,165,8,5723,502,0.13552481433775335,0.08771623274506378,39,3
Africa,Algeria,42228429,2020-05-12,168,5,5891,507,0.13950317687641187,0.08606348667458835,40,3
Africa,Algeria,42228429,2020-05-13,176,8,6067,515,0.14367098525024458,0.08488544585462338,41,3
Africa,Algeria,42228429,2020-05-14,186,7,6253,522,0.14807560091804503,0.08347992963377579,42,3
Africa,Algeria,42228429,2020-05-15,189,7,6442,529,0.15255125877403586,0.08211735485873953,43,3
Africa,Algeria,42228429,2020-05-16,187,7,6629,536,0.1569795551712331,0.0808568411525117,44,3
Africa,Algeria,42228429,2020-05-17,192,6,6821,542,0.16152625521541422,0.0794604896642721,45,3
Africa,Algeria,42228429,2020-05-18,198,6,7019,548,0.16621503963597603,0.07807379968656504,46,3
Africa,Algeria,42228429,2020-05-19,182,7,7201,555,0.1705249323861894,0.07707262880155534,47,3
Africa,Algeria,42228429,2020-05-20,176,6,7377,561,0.17469274076002211,0.07604717364782432,48,3
Africa,Algeria,42228429,2020-05-21,165,7,7542,568,0.1786000611104903,0.07531158843808008,49,3
Africa,Algeria,42228429,2020-05-22,186,7,7728,575,0.18300467677829074,0.0744047619047619,50,3
Africa,Algeria,42228429,2020-05-23,190,7,7918,582,0.18750401536367833,0.07350340995200809,51,3
Africa,Algeria,42228429,2020-05-24,195,10,8113,592,0.19212175759604982,0.07296930851719463,52,3
Africa,Algeria,42228429,2020-05-25,193,8,8306,600,0.19669213836962773,0.07223693715386467,53,3
Africa,Algeria,42228429,2020-05-26,197,9,8503,609,0.20135724206079272,0.07162178054804187,54,3
Africa,Algeria,42228429,2020-05-27,194,8,8697,617,0.20595130356376742,0.07094400367942968,55,3
America,Argentina,44494502,2020-03-31,146,4,966,24,0.02171054751888222,0.024844720496894408,0,4
America,Argentina,44494502,2020-04-01,0,0,966,24,0.02171054751888222,0.024844720496894408,1,4
America,Argentina,44494502,2020-04-02,167,7,1133,31,0.025463820226597884,0.02736098852603707,2,4
America,Argentina,44494502,2020-04-03,0,3,1133,34,0.025463820226597884,0.03000882612533098,3,4
America,Argentina,44494502,2020-04-04,132,3,1265,37,0.028430478893774338,0.02924901185770751,4,4
America,Argentina,44494502,2020-04-05,186,6,1451,43,0.032610770652068424,0.029634734665747762,5,4
America,Argentina,44494502,2020-04-06,103,3,1554,46,0.03492566339994096,0.029601029601029602,6,4
America,Argentina,44494502,2020-04-07,74,7,1628,53,0.036588790228509575,0.032555282555282554,7,4
America,Argentina,44494502,2020-04-08,87,7,1715,60,0.03854408798642133,0.03498542274052478,8,4
America,Argentina,44494502,2020-04-09,80,5,1795,65,0.04034206293622524,0.036211699164345405,9,4
America,Argentina,44494502,2020-04-10,99,14,1894,79,0.04256705693660758,0.04171066525871172,10,4
America,Argentina,44494502,2020-04-11,81,3,1975,82,0.044387506573284045,0.04151898734177215,11,4
America,Argentina,44494502,2020-04-12,162,7,2137,89,0.04802840584663696,0.0416471689284043,12,4
America,Argentina,44494502,2020-04-13,66,6,2203,95,0.04951173518022519,0.04312301407172038,13,4
America,Argentina,44494502,2020-04-14,69,3,2272,98,0.05106248857443106,0.043133802816901406,14,4
America,Argentina,44494502,2020-04-15,160,7,2432,105,0.05465843847403888,0.04317434210526316,15,4
America,Argentina,44494502,2020-04-16,0,4,2432,109,0.05465843847403888,0.04481907894736842,16,4
America,Argentina,44494502,2020-04-17,128,6,2560,115,0.05753519839372514,0.044921875,17,4
America,Argentina,44494502,2020-04-18,98,7,2658,122,0.05973771770723493,0.04589917231000752,18,4
America,Argentina,44494502,2020-04-19,170,10,2828,132,0.06355841447556823,0.04667609618104668,19,4
America,Argentina,44494502,2020-04-20,102,2,2930,134,0.06585083253656822,0.04573378839590444,20,4
America,Argentina,44494502,2020-04-21,90,8,3020,142,0.06787355435509762,0.04701986754966887,21,4
America,Argentina,44494502,2020-04-22,112,9,3132,151,0.0703907192848231,0.04821200510855683,22,4
America,Argentina,44494502,2020-04-23,144,8,3276,159,0.07362707419447014,0.048534798534798536,23,4
America,Argentina,44494502,2020-04-24,147,6,3423,165,0.07693085316473482,0.04820333041191937,24,4
America,Argentina,44494502,2020-04-25,0,2,3423,167,0.07693085316473482,0.04878761320479112,25,4
America,Argentina,44494502,2020-04-26,344,18,3767,185,0.08466214544889164,0.04911069816830369,26,4
America,Argentina,44494502,2020-04-27,0,1,3767,186,0.08466214544889164,0.04937616140164587,27,4
America,Argentina,44494502,2020-04-28,223,11,3990,197,0.08967400062147005,0.0493734335839599,28,4
America,Argentina,44494502,2020-04-29,124,10,4114,207,0.0924608617936661,0.05031599416626155,29,4
America,Argentina,44494502,2020-04-30,158,7,4272,214,0.09601186231952882,0.050093632958801496,30,4
America,Argentina,44494502,2020-05-01,143,4,4415,218,0.09922574254230332,0.049377123442808604,31,4
America,Argentina,44494502,2020-05-02,104,7,4519,225,0.1015631099770484,0.049789776499225495,32,4
America,Argentina,44494502,2020-05-03,149,12,4668,237,0.10491183832105819,0.05077120822622108,33,4
America,Argentina,44494502,2020-05-04,102,9,4770,246,0.10720425638205817,0.05157232704402516,34,4
America,Argentina,44494502,2020-05-05,104,14,4874,260,0.10954162381680325,0.053344275748871565,35,4
America,Argentina,44494502,2020-05-06,133,4,5007,264,0.11253075717085226,0.052726183343319355,36,4
America,Argentina,44494502,2020-05-07,188,9,5195,273,0.11675599830289145,0.05255052935514918,37,4
America,Argentina,44494502,2020-05-08,163,9,5358,282,0.12041937226311691,0.05263157894736842,38,4
America,Argentina,44494502,2020-05-09,240,11,5598,293,0.12581329711252864,0.05234012147195427,39,4
America,Argentina,44494502,2020-05-10,165,7,5763,300,0.1295216204464992,0.052056220718375845,40,4
America,Argentina,44494502,2020-05-11,13,0,5776,300,0.12981379137584234,0.05193905817174515,41,4
America,Argentina,44494502,2020-05-12,245,5,6021,305,0.13532008965961684,0.0506560372031224,42,4
America,Argentina,44494502,2020-05-13,529,14,6550,319,0.14720919901519516,0.04870229007633588,43,4
America,Argentina,44494502,2020-05-14,316,10,6866,329,0.15431120006692062,0.04791727352170114,44,4
America,Argentina,44494502,2020-05-15,255,24,7121,353,0.1600422452194206,0.04957168936947058,45,4
America,Argentina,44494502,2020-05-16,345,3,7466,356,0.16779601219044996,0.04768282882400214,46,4
America,Argentina,44494502,2020-05-17,326,7,7792,363,0.1751227601109009,0.04658624229979466,47,4
America,Argentina,44494502,2020-05-18,0,3,7792,366,0.1751227601109009,0.046971252566735115,48,4
America,Argentina,44494502,2020-05-19,566,16,8358,382,0.18784343288076355,0.04570471404642259,49,4
America,Argentina,44494502,2020-05-20,438,11,8796,393,0.19768734573093996,0.044679399727148704,50,4
America,Argentina,44494502,2020-05-21,474,10,9270,403,0.20834034730852813,0.04347357065803668,51,4
America,Argentina,44494502,2020-05-22,648,13,9918,416,0.2229039444019398,0.04194394031054648,52,4
America,Argentina,44494502,2020-05-23,718,17,10636,433,0.23904076957642992,0.040710793531402785,53,4
America,Argentina,44494502,2020-05-24,704,12,11340,445,0.2548629491347043,0.039241622574955906,54,4
America,Argentina,44494502,2020-05-25,723,7,12063,452,0.2711121477435572,0.03746994943214789,55,4
America,Argentina,44494502,2020-05-26,552,15,12615,467,0.28351817489720416,0.03701942132382085,56,4
America,Argentina,44494502,2020-05-27,600,17,13215,484,0.29700298702073347,0.03662504729474082,57,4
Europe,Armenia,2951776,2020-03-18,26,0,78,0,0.02642476935919257,0,0,5
Europe,Armenia,2951776,2020-03-19,37,0,115,0,0.03895959585009161,0,1,5
Europe,Armenia,2951776,2020-03-20,7,0,122,0,0.041331049510531966,0,2,5
Europe,Armenia,2951776,2020-03-21,14,0,136,0,0.04607395683141268,0,3,5
Europe,Armenia,2951776,2020-03-22,24,0,160,0,0.054204655095779625,0,4,5
Europe,Armenia,2951776,2020-03-23,30,0,190,0,0.06436802792623832,0,5,5
Europe,Armenia,2951776,2020-03-24,4,0,194,0,0.0657231443036328,0,6,5
Europe,Armenia,2951776,2020-03-25,71,0,265,0,0.08977646000238501,0,7,5
Europe,Armenia,2951776,2020-03-26,25,0,290,0,0.09824593736110057,0,8,5
Europe,Armenia,2951776,2020-03-27,39,1,329,1,0.11145832204069686,0.00303951367781155,9,5
Europe,Armenia,2951776,2020-03-28,43,0,372,1,0.12602582309768762,0.002688172043010753,10,5
Europe,Armenia,2951776,2020-03-29,52,2,424,3,0.143642336003816,0.007075471698113208,11,5
Europe,Armenia,2951776,2020-03-30,0,0,424,3,0.143642336003816,0.007075471698113208,12,5
Europe,Armenia,2951776,2020-03-31,58,0,482,3,0.16329152347603612,0.006224066390041493,13,5
Europe,Armenia,2951776,2020-04-01,50,0,532,3,0.18023047819346724,0.005639097744360902,14,5
Europe,Armenia,2951776,2020-04-02,39,0,571,3,0.19344286287306356,0.005253940455341506,15,5
Europe,Armenia,2951776,2020-04-03,92,1,663,4,0.2246105395531368,0.006033182503770739,16,5
Europe,Armenia,2951776,2020-04-04,73,3,736,7,0.24934141344058627,0.009510869565217392,17,5
Europe,Armenia,2951776,2020-04-05,34,0,770,7,0.26085990264843945,0.00909090909090909,18,5
Europe,Armenia,2951776,2020-04-06,52,0,822,7,0.2784764155545678,0.00851581508515815,19,5
Europe,Armenia,2951776,2020-04-07,11,1,833,8,0.2822029855924027,0.009603841536614645,20,5
Europe,Armenia,2951776,2020-04-08,20,0,853,8,0.2889785674793751,0.009378663540445486,21,5
Europe,Armenia,2951776,2020-04-09,28,1,881,9,0.2984643821211366,0.01021566401816118,22,5
Europe,Armenia,2951776,2020-04-10,40,1,921,10,0.31201554589508146,0.010857763300760043,23,5
Europe,Armenia,2951776,2020-04-11,16,1,937,11,0.31743601140465943,0.011739594450373533,24,5
Europe,Armenia,2951776,2020-04-12,30,2,967,13,0.3275993842351181,0.01344364012409514,25,5
Europe,Armenia,2951776,2020-04-13,46,0,1013,13,0.34318322257515477,0.012833168805528134,26,5
Europe,Armenia,2951776,2020-04-14,26,1,1039,14,0.351991479028219,0.013474494706448507,27,5
Europe,Armenia,2951776,2020-04-15,72,3,1111,17,0.37638357382131976,0.0153015301530153,28,5
Europe,Armenia,2951776,2020-04-16,48,1,1159,18,0.39264497035005363,0.015530629853321829,29,5
Europe,Armenia,2951776,2020-04-17,42,1,1201,19,0.4068736923126958,0.01582014987510408,30,5
Europe,Armenia,2951776,2020-04-18,47,1,1248,20,0.4227963097470811,0.016025641025641024,31,5
Europe,Armenia,2951776,2020-04-19,43,0,1291,20,0.43736381080407183,0.015491866769945779,32,5
Europe,Armenia,2951776,2020-04-20,48,2,1339,22,0.45362520733280576,0.016430171769977596,33,5
Europe,Armenia,2951776,2020-04-21,62,2,1401,24,0.47462951118242036,0.017130620985010708,34,5
Europe,Armenia,2951776,2020-04-22,72,0,1473,24,0.49902160597552114,0.016293279022403257,35,5
Europe,Armenia,2951776,2020-04-23,50,0,1523,24,0.5159605606929524,0.015758371634931056,36,5
Europe,Armenia,2951776,2020-04-24,73,3,1596,27,0.5406914345804018,0.016917293233082706,37,5
Europe,Armenia,2951776,2020-04-25,81,1,1677,28,0.5681325412226402,0.016696481812760882,38,5
Europe,Armenia,2951776,2020-04-26,69,0,1746,28,0.5915082987326952,0.016036655211912942,39,5
Europe,Armenia,2951776,2020-04-27,62,1,1808,29,0.6125126025823098,0.016039823008849558,40,5
Europe,Armenia,2951776,2020-04-28,59,1,1867,30,0.6325005691488785,0.016068559185859668,41,5
Europe,Armenia,2951776,2020-04-29,65,0,1932,30,0.654521210281539,0.015527950310559006,42,5
Europe,Armenia,2951776,2020-04-30,0,0,1932,30,0.654521210281539,0.015527950310559006,43,5
Europe,Armenia,2951776,2020-05-01,134,2,2066,32,0.6999176089242545,0.015488867376573089,44,5
Europe,Armenia,2951776,2020-05-02,82,1,2148,33,0.7276974946608415,0.015363128491620111,45,5
Europe,Armenia,2951776,2020-05-03,125,0,2273,33,0.7700448814544193,0.014518257809062912,46,5
Europe,Armenia,2951776,2020-05-04,113,2,2386,35,0.8083269191158137,0.014668901927912825,47,5
Europe,Armenia,2951776,2020-05-05,121,4,2507,39,0.849319189531997,0.015556441962504986,48,5
Europe,Armenia,2951776,2020-05-06,112,1,2619,40,0.8872624480990428,0.015273004963726614,49,5
Europe,Armenia,2951776,2020-05-07,163,0,2782,40,0.9424834404778681,0.014378145219266714,50,5
Europe,Armenia,2951776,2020-05-08,102,2,2884,42,0.9770389081014278,0.014563106796116505,51,5
Europe,Armenia,2951776,2020-05-09,145,1,3029,43,1.026161876781978,0.014196104324859689,52,5
Europe,Armenia,2951776,2020-05-10,146,1,3175,44,1.0756236245568769,0.013858267716535434,53,5
Europe,Armenia,2951776,2020-05-11,138,1,3313,45,1.1223751395769868,0.013582855418050106,54,5
Europe,Armenia,2951776,2020-05-12,79,1,3392,46,1.149138688030528,0.013561320754716982,55,5
Europe,Armenia,2951776,2020-05-13,146,1,3538,47,1.198600435805427,0.013284341435839458,56,5
Europe,Armenia,2951776,2020-05-14,180,1,3718,48,1.259580672788179,0.012910166756320602,57,5
Europe,Armenia,2951776,2020-05-15,142,1,3860,49,1.3076873041856834,0.012694300518134714,58,5
Europe,Armenia,2951776,2020-05-16,184,3,4044,52,1.37002265754583,0.012858555885262116,59,5
Europe,Armenia,2951776,2020-05-17,239,3,4283,55,1.4509908610951507,0.012841466261965912,60,5
Europe,Armenia,2951776,2020-05-18,189,5,4472,60,1.5150201099270406,0.013416815742397137,61,5
Europe,Armenia,2951776,2020-05-19,351,1,4823,61,1.633931572043407,0.012647729628861704,62,5
Europe,Armenia,2951776,2020-05-20,218,3,5041,64,1.7077854146114069,0.012695893671890498,63,5
Europe,Armenia,2951776,2020-05-21,230,3,5271,67,1.78570460631159,0.01271106051982546,64,5
Europe,Armenia,2951776,2020-05-22,335,3,5606,70,1.8991956029183787,0.012486621476988941,65,5
Europe,Armenia,2951776,2020-05-23,322,4,5928,74,2.008282471298635,0.012483130904183536,66,5
Europe,Armenia,2951776,2020-05-24,374,3,6302,77,2.1349858525850203,0.012218343383052999,67,5
Europe,Armenia,2951776,2020-05-25,359,4,6661,81,2.2566075474561753,0.012160336285842966,68,5
Europe,Armenia,2951776,2020-05-26,452,6,7113,87,2.4097356981017533,0.012231126107127795,69,5
Europe,Armenia,2951776,2020-05-27,289,4,7402,91,2.5076428563685047,0.012293974601459066,70,5
America,Aruba,105845,2020-03-20,2,0,4,0,0.03779110964145685,0,0,6
America,Aruba,105845,2020-03-24,8,0,12,0,0.11337332892437055,0,1,6
America,Aruba,105845,2020-03-25,5,0,17,0,0.1606122159761916,0,2,6
America,Aruba,105845,2020-03-26,2,0,19,0,0.17950777079692,0,3,6
America,Aruba,105845,2020-03-27,9,0,28,0,0.2645377674901979,0,4,6
America,Aruba,105845,2020-03-28,0,0,28,0,0.2645377674901979,0,5,6
America,Aruba,105845,2020-03-29,0,0,28,0,0.2645377674901979,0,6,6
America,Aruba,105845,2020-03-30,22,0,50,0,0.4723888705182106,0,7,6
America,Aruba,105845,2020-04-01,5,0,55,0,0.5196277575700315,0,8,6
America,Aruba,105845,2020-04-02,0,0,55,0,0.5196277575700315,0,9,6
America,Aruba,105845,2020-04-03,5,0,60,0,0.5668666446218528,0,10,6
America,Aruba,105845,2020-04-04,2,0,62,0,0.5857621994425811,0,11,6
America,Aruba,105845,2020-04-05,2,0,64,0,0.6046577542633096,0,12,6
America,Aruba,105845,2020-04-06,0,0,64,0,0.6046577542633096,0,13,6
America,Aruba,105845,2020-04-07,7,0,71,0,0.6707921961358589,0,14,6
America,Aruba,105845,2020-04-08,3,0,74,0,0.6991355283669517,0,15,6
America,Aruba,105845,2020-04-09,3,0,77,0,0.7274788605980442,0,16,6
America,Aruba,105845,2020-04-10,5,0,82,0,0.7747177476498653,0,17,6
America,Aruba,105845,2020-04-11,4,0,86,0,0.8125088572913223,0,18,6
America,Aruba,105845,2020-04-12,6,0,92,0,0.8691955217535074,0,19,6
America,Aruba,105845,2020-04-13,0,0,92,0,0.8691955217535074,0,20,6
America,Aruba,105845,2020-04-14,0,0,92,0,0.8691955217535074,0,21,6
America,Aruba,105845,2020-04-15,0,0,92,0,0.8691955217535074,0,22,6
America,Aruba,105845,2020-04-16,1,1,93,1,0.8786432991638716,0.010752688172043012,23,6
America,Aruba,105845,2020-04-17,2,0,95,1,0.8975388539846001,0.010526315789473684,24,6
America,Aruba,105845,2020-04-18,1,1,96,2,0.9069866313949644,0.020833333333333332,25,6
America,Aruba,105845,2020-04-19,0,0,96,2,0.9069866313949644,0.020833333333333332,26,6
America,Aruba,105845,2020-04-20,1,0,97,2,0.9164344088053284,0.020618556701030927,27,6
America,Aruba,105845,2020-04-21,0,0,97,2,0.9164344088053284,0.020618556701030927,28,6
America,Aruba,105845,2020-04-22,0,0,97,2,0.9164344088053284,0.020618556701030927,29,6
America,Aruba,105845,2020-04-23,3,0,100,2,0.9447777410364212,0.02,30,6
America,Aruba,105845,2020-04-24,0,0,100,2,0.9447777410364212,0.02,31,6
America,Aruba,105845,2020-04-25,0,0,100,2,0.9447777410364212,0.02,32,6
America,Aruba,105845,2020-04-26,0,0,100,2,0.9447777410364212,0.02,33,6
America,Aruba,105845,2020-04-27,0,0,100,2,0.9447777410364212,0.02,34,6
America,Aruba,105845,2020-04-28,0,0,100,2,0.9447777410364212,0.02,35,6
America,Aruba,105845,2020-04-29,0,0,100,2,0.9447777410364212,0.02,36,6
America,Aruba,105845,2020-04-30,0,0,100,2,0.9447777410364212,0.02,37,6
America,Aruba,105845,2020-05-01,0,0,100,2,0.9447777410364212,0.02,38,6
America,Aruba,105845,2020-05-02,0,0,100,2,0.9447777410364212,0.02,39,6
America,Aruba,105845,2020-05-03,0,0,100,2,0.9447777410364212,0.02,40,6
America,Aruba,105845,2020-05-04,0,0,100,2,0.9447777410364212,0.02,41,6
America,Aruba,105845,2020-05-05,0,0,100,2,0.9447777410364212,0.02,42,6
America,Aruba,105845,2020-05-06,0,0,100,2,0.9447777410364212,0.02,43,6
America,Aruba,105845,2020-05-07,1,0,101,2,0.9542255184467854,0.019801980198019802,44,6
America,Aruba,105845,2020-05-08,0,1,101,3,0.9542255184467854,0.0297029702970297,45,6
America,Aruba,105845,2020-05-09,0,0,101,3,0.9542255184467854,0.0297029702970297,46,6
America,Aruba,105845,2020-05-10,0,0,101,3,0.9542255184467854,0.0297029702970297,47,6
America,Aruba,105845,2020-05-11,0,0,101,3,0.9542255184467854,0.0297029702970297,48,6
America,Aruba,105845,2020-05-12,0,0,101,3,0.9542255184467854,0.0297029702970297,49,6
America,Aruba,105845,2020-05-13,0,0,101,3,0.9542255184467854,0.0297029702970297,50,6
America,Aruba,105845,2020-05-14,0,0,101,3,0.9542255184467854,0.0297029702970297,51,6
America,Aruba,105845,2020-05-15,0,0,101,3,0.9542255184467854,0.0297029702970297,52,6
America,Aruba,105845,2020-05-16,0,0,101,3,0.9542255184467854,0.0297029702970297,53,6
America,Aruba,105845,2020-05-17,0,0,101,3,0.9542255184467854,0.0297029702970297,54,6
America,Aruba,105845,2020-05-18,0,0,101,3,0.9542255184467854,0.0297029702970297,55,6
America,Aruba,105845,2020-05-19,0,0,101,3,0.9542255184467854,0.0297029702970297,56,6
America,Aruba,105845,2020-05-20,0,0,101,3,0.9542255184467854,0.0297029702970297,57,6
America,Aruba,105845,2020-05-21,0,0,101,3,0.9542255184467854,0.0297029702970297,58,6
America,Aruba,105845,2020-05-22,0,0,101,3,0.9542255184467854,0.0297029702970297,59,6
America,Aruba,105845,2020-05-23,0,0,101,3,0.9542255184467854,0.0297029702970297,60,6
America,Aruba,105845,2020-05-24,0,0,101,3,0.9542255184467854,0.0297029702970297,61,6
America,Aruba,105845,2020-05-25,0,0,101,3,0.9542255184467854,0.0297029702970297,62,6
America,Aruba,105845,2020-05-26,0,0,101,3,0.9542255184467854,0.0297029702970297,63,6
America,Aruba,105845,2020-05-27,0,0,101,3,0.9542255184467854,0.0297029702970297,64,6
Oceania,Australia,24992369,2020-03-19,111,1,565,6,0.022606900530317876,0.010619469026548672,0,7
Oceania,Australia,24992369,2020-03-20,144,0,709,6,0.028368659249549334,0.00846262341325811,1,7
Oceania,Australia,24992369,2020-03-21,165,1,874,7,0.034970674448668713,0.008009153318077803,2,7
Oceania,Australia,24992369,2020-03-22,224,0,1098,7,0.04393341023413987,0.006375227686703097,3,7
Oceania,Australia,24992369,2020-03-23,611,0,1709,7,0.06838087257754558,0.004095962551199532,4,7
Oceania,Australia,24992369,2020-03-24,114,0,1823,7,0.07294226489693714,0.0038398244651673065,5,7
Oceania,Australia,24992369,2020-03-25,600,1,2423,8,0.09694959289373488,0.0033016921172100704,6,7
Oceania,Australia,24992369,2020-03-26,376,3,2799,11,0.11199418510506147,0.003929974991068239,7,7
Oceania,Australia,24992369,2020-03-27,367,2,3166,13,0.1266786673964361,0.00410612760581175,8,7
Oceania,Australia,24992369,2020-03-28,212,0,3378,13,0.13516125662197132,0.0038484310242747188,9,7
Oceania,Australia,24992369,2020-03-29,431,1,3809,14,0.1524065205663377,0.0036755053819900237,10,7
Oceania,Australia,24992369,2020-03-30,284,2,4093,16,0.1637699891514886,0.003909113119960909,11,7
Oceania,Australia,24992369,2020-03-31,464,3,4557,19,0.18233565613567884,0.004169409699363616,12,7
Oceania,Australia,24992369,2020-04-01,150,1,4707,20,0.18833748813487827,0.004248990864669641,13,7
Oceania,Australia,24992369,2020-04-02,269,1,4976,21,0.19910077352010927,0.0042202572347266884,14,7
Oceania,Australia,24992369,2020-04-03,248,2,5224,23,0.20902380242545232,0.004402756508422665,15,7
Oceania,Australia,24992369,2020-04-04,324,7,5548,30,0.22198775954372313,0.005407354001441961,16,7
Oceania,Australia,24992369,2020-04-05,139,4,5687,34,0.2275494571963146,0.005978547564621066,17,7
Oceania,Australia,24992369,2020-04-06,57,2,5744,36,0.2298301533560104,0.006267409470752089,18,7
Oceania,Australia,24992369,2020-04-07,100,6,5844,42,0.23383137468881,0.007186858316221766,19,7
Oceania,Australia,24992369,2020-04-08,112,3,5956,45,0.23831274258154558,0.00755540631296172,20,7
Oceania,Australia,24992369,2020-04-09,96,5,6052,50,0.24215391506103323,0.008261731658955718,21,7
Oceania,Australia,24992369,2020-04-10,100,2,6152,52,0.24615513639383288,0.008452535760728219,22,7
Oceania,Australia,24992369,2020-04-11,86,2,6238,54,0.24959618674004053,0.008656620711766592,23,7
Oceania,Australia,24992369,2020-04-12,51,3,6289,57,0.2516368096197683,0.00906344410876133,24,7
Oceania,Australia,24992369,2020-04-13,33,4,6322,61,0.2529572126595922,0.009648845302119582,25,7
Oceania,Australia,24992369,2020-04-14,44,0,6366,61,0.25471775004602404,0.00958215519949733,26,7
Oceania,Australia,24992369,2020-04-15,50,0,6416,61,0.2567183607124239,0.009507481296758104,27,7
Oceania,Australia,24992369,2020-04-16,42,2,6458,63,0.2583988736721997,0.009755342211210901,28,7
Oceania,Australia,24992369,2020-04-17,39,0,6497,63,0.25995934999199155,0.009696783130675696,29,7
Oceania,Australia,24992369,2020-04-18,36,4,6533,67,0.2613997896717994,0.010255625287004438,30,7
Oceania,Australia,24992369,2020-04-19,53,2,6586,69,0.2635204369781832,0.010476768903735195,31,7
Oceania,Australia,24992369,2020-04-20,26,1,6612,70,0.2645607545247111,0.01058681185722928,32,7
Oceania,Australia,24992369,2020-04-21,13,1,6625,71,0.26508091329797506,0.010716981132075473,33,7
Oceania,Australia,24992369,2020-04-22,22,3,6647,74,0.265961181991191,0.011132841883556491,34,7
Oceania,Australia,24992369,2020-04-23,7,0,6654,74,0.26624126748448695,0.011121130147279832,35,7
Oceania,Australia,24992369,2020-04-24,13,1,6667,75,0.2667614262577509,0.011249437528123594,36,7
Oceania,Australia,24992369,2020-04-25,20,4,6687,79,0.26756167052431085,0.011813967399431732,37,7
Oceania,Australia,24992369,2020-04-26,16,2,6703,81,0.2682018659375588,0.012084141429210802,38,7
Oceania,Australia,24992369,2020-04-27,10,2,6713,83,0.26860198807083874,0.012364069715477433,39,7
Oceania,Australia,24992369,2020-04-28,12,1,6725,84,0.2690821346307747,0.012490706319702602,40,7
Oceania,Australia,24992369,2020-04-29,13,4,6738,88,0.2696022934040387,0.013060255268625705,41,7
Oceania,Australia,24992369,2020-04-30,8,2,6746,90,0.2699223911106626,0.013341239252890602,42,7
Oceania,Australia,24992369,2020-05-01,16,2,6762,92,0.2705625865239106,0.013605442176870748,43,7
Oceania,Australia,24992369,2020-05-02,5,1,6767,93,0.2707626475905505,0.01374316536131225,44,7
Oceania,Australia,24992369,2020-05-03,16,0,6783,93,0.27140284300379847,0.013710747456877488,45,7
Oceania,Australia,24992369,2020-05-04,18,2,6801,95,0.2721230628437024,0.013968534039111895,46,7
Oceania,Australia,24992369,2020-05-05,24,0,6825,95,0.27308335596357436,0.01391941391941392,47,7
Oceania,Australia,24992369,2020-05-06,24,1,6849,96,0.27404364908344625,0.01401664476565922,48,7
Oceania,Australia,24992369,2020-05-07,26,1,6875,97,0.2750839666299741,0.01410909090909091,49,7
Oceania,Australia,24992369,2020-05-08,21,0,6896,97,0.27592422310986203,0.014066125290023202,50,7
Oceania,Australia,24992369,2020-05-09,18,0,6914,97,0.276644442949766,0.014029505351460804,51,7
Oceania,Australia,24992369,2020-05-10,15,0,6929,97,0.2772446261496859,0.013999134074180979,52,7
Oceania,Australia,24992369,2020-05-11,12,0,6941,97,0.2777247727096219,0.013974931566056763,53,7
Oceania,Australia,24992369,2020-05-12,7,0,6948,97,0.27800485820291787,0.013960852043753599,54,7
Oceania,Australia,24992369,2020-05-13,16,0,6964,97,0.2786450536161658,0.013928776565192418,55,7
Oceania,Australia,24992369,2020-05-14,11,1,6975,98,0.27908518796277376,0.014050179211469534,56,7
Oceania,Australia,24992369,2020-05-15,14,0,6989,98,0.2796453589493657,0.014022034625840606,57,7
Oceania,Australia,24992369,2020-05-16,30,0,7019,98,0.2808457253492056,0.013962102863655792,58,7
Oceania,Australia,24992369,2020-05-17,17,0,7036,98,0.2815259329757815,0.013928368391131325,59,7
Oceania,Australia,24992369,2020-05-18,9,0,7045,98,0.2818860428957335,0.01391057487579844,60,7
Oceania,Australia,24992369,2020-05-19,15,1,7060,99,0.28248622609565344,0.014022662889518414,61,7
Oceania,Australia,24992369,2020-05-20,8,0,7068,99,0.2828063238022774,0.01400679117147708,62,7
Oceania,Australia,24992369,2020-05-21,11,1,7079,100,0.2832464581488854,0.014126289023873428,63,7
Oceania,Australia,24992369,2020-05-22,2,0,7081,100,0.2833264825755413,0.014122299110295156,64,7
Oceania,Australia,24992369,2020-05-23,14,1,7095,101,0.2838866535621333,0.0142353770260747,65,7
Oceania,Australia,24992369,2020-05-24,11,1,7106,102,0.2843267879087413,0.014354066985645933,66,7
Oceania,Australia,24992369,2020-05-25,3,0,7109,102,0.2844468245487252,0.014348009565339711,67,7
Oceania,Australia,24992369,2020-05-26,9,0,7118,102,0.2848069344686772,0.014329867940432705,68,7
Oceania,Australia,24992369,2020-05-27,15,0,7133,102,0.28540711766859717,0.01429973363241273,69,7
Europe,Austria,8847037,2020-03-11,51,0,182,0,0.020571859256381542,0,0,8
Europe,Austria,8847037,2020-03-12,64,0,246,0,0.02780591965423,0,1,8
Europe,Austria,8847037,2020-03-13,115,1,361,1,0.04080462193161394,0.002770083102493075,2,8
Europe,Austria,8847037,2020-03-14,143,0,504,1,0.056968225633056584,0.001984126984126984,3,8
Europe,Austria,8847037,2020-03-15,151,0,655,1,0.07403608688423027,0.0015267175572519084,4,8
Europe,Austria,8847037,2020-03-16,205,0,860,1,0.09720768659608861,0.0011627906976744186,5,8
Europe,Austria,8847037,2020-03-17,156,2,1016,3,0.11484070881584421,0.002952755905511811,6,8
Europe,Austria,8847037,2020-03-18,316,0,1332,3,0.15055888203022097,0.0022522522522522522,7,8
Europe,Austria,8847037,2020-03-19,314,1,1646,4,0.18605099085716495,0.002430133657351154,8,8
Europe,Austria,8847037,2020-03-20,550,2,2196,6,0.24821869740117508,0.00273224043715847,9,8
Europe,Austria,8847037,2020-03-21,453,0,2649,6,0.29942228115469616,0.0022650056625141564,10,8
Europe,Austria,8847037,2020-03-22,375,2,3024,8,0.3418093537983395,0.0026455026455026454,11,8
Europe,Austria,8847037,2020-03-23,607,8,3631,16,0.41041989538418344,0.004406499586890664,12,8
Europe,Austria,8847037,2020-03-24,855,9,4486,25,0.5070624210116901,0.005572893446277307,13,8
Europe,Austria,8847037,2020-03-25,796,5,5282,30,0.5970360472099303,0.005679666792881484,14,8
Europe,Austria,8847037,2020-03-26,606,4,5888,34,0.6655335566020578,0.00577445652173913,15,8
Europe,Austria,8847037,2020-03-27,1141,18,7029,52,0.7945032896324499,0.007397922890880637,16,8
Europe,Austria,8847037,2020-03-28,668,16,7697,68,0.8700087950349931,0.00883461088735871,17,8
Europe,Austria,8847037,2020-03-29,594,0,8291,68,0.9371499181025241,0.008201664455433603,18,8
Europe,Austria,8847037,2020-03-30,522,18,8813,86,0.9961527232224755,0.009758311585158289,19,8
Europe,Austria,8847037,2020-03-31,805,22,9618,108,1.0871436391641631,0.011228945726762321,20,8
Europe,Austria,8847037,2020-04-01,564,20,10182,128,1.1508937964202026,0.012571204085641328,21,8
Europe,Austria,8847037,2020-04-02,529,18,10711,146,1.2106878268961687,0.013630846793016524,22,8
Europe,Austria,8847037,2020-04-03,418,12,11129,158,1.2579352838696163,0.014197142600413335,23,8
Europe,Austria,8847037,2020-04-04,396,10,11525,168,1.302696032581304,0.01457700650759219,24,8
Europe,Austria,8847037,2020-04-05,241,18,11766,186,1.3299367912669517,0.01580826109127996,25,8
Europe,Austria,8847037,2020-04-06,217,18,11983,204,1.3544647773034069,0.01702411749979137,26,8
Europe,Austria,8847037,2020-04-07,314,16,12297,220,1.3899568861303506,0.017890542408717573,27,8
Europe,Austria,8847037,2020-04-08,343,23,12640,243,1.4287269285750699,0.019224683544303796,28,8
Europe,Austria,8847037,2020-04-09,329,30,12969,273,1.4659145203077595,0.021050196622715706,29,8
Europe,Austria,8847037,2020-04-10,279,22,13248,295,1.49745050235463,0.022267512077294684,30,8
Europe,Austria,8847037,2020-04-11,312,24,13560,319,1.5327165467941413,0.023525073746312686,31,8
Europe,Austria,8847037,2020-04-12,247,18,13807,337,1.5606354986420878,0.02440790903165061,32,8
Europe,Austria,8847037,2020-04-13,130,13,13937,350,1.5753296838252175,0.025113008538422903,33,8
Europe,Austria,8847037,2020-04-14,106,18,14043,368,1.587311096359154,0.02620522680338959,34,8
Europe,Austria,8847037,2020-04-15,191,16,14234,384,1.608900245358983,0.026977659126036252,35,8
Europe,Austria,8847037,2020-04-16,136,9,14370,393,1.6242726237044107,0.027348643006263048,36,8
Europe,Austria,8847037,2020-04-17,78,17,14448,410,1.6330891348142889,0.02837763012181617,37,8
Europe,Austria,8847037,2020-04-18,155,21,14603,431,1.6506091248403278,0.029514483325344107,38,8
Europe,Austria,8847037,2020-04-19,59,12,14662,443,1.6572780242695944,0.030214159050607012,39,8
Europe,Austria,8847037,2020-04-20,48,9,14710,452,1.6627035695679808,0.03072739632902787,40,8
Europe,Austria,8847037,2020-04-21,73,10,14783,462,1.6709549197092768,0.031252113914631674,41,8
Europe,Austria,8847037,2020-04-22,50,1,14833,463,1.6766065293950958,0.031214184588417716,42,8
Europe,Austria,8847037,2020-04-23,91,31,14924,494,1.6868924590232866,0.033101045296167246,43,8
Europe,Austria,8847037,2020-04-24,61,14,14985,508,1.6937874228399858,0.033900567233900565,44,8
Europe,Austria,8847037,2020-04-25,83,5,15068,513,1.7031690949184455,0.034045659676134855,45,8
Europe,Austria,8847037,2020-04-26,66,23,15134,536,1.7106292197037267,0.035416941984934586,46,8
Europe,Austria,8847037,2020-04-27,55,6,15189,542,1.716845990358128,0.03568371848047929,47,8
Europe,Austria,8847037,2020-04-28,67,7,15256,549,1.7244191473371253,0.03598584163607761,48,8
Europe,Austria,8847037,2020-04-29,58,20,15314,569,1.7309750145726757,0.03715554394671542,49,8
Europe,Austria,8847037,2020-04-30,50,11,15364,580,1.7366266242584947,0.037750585784951836,50,8
Europe,Austria,8847037,2020-05-01,60,4,15424,584,1.7434085558814776,0.037863070539419084,51,8
Europe,Austria,8847037,2020-05-02,34,5,15458,589,1.7472516504678346,0.03810324750938025,52,8
Europe,Austria,8847037,2020-05-03,12,7,15470,596,1.748608036792431,0.03852617970265029,53,8
Europe,Austria,8847037,2020-05-04,68,2,15538,598,1.756294225965145,0.03848629167202986,54,8
Europe,Austria,8847037,2020-05-05,31,2,15569,600,1.7597982239703531,0.03853812062431755,55,8
Europe,Austria,8847037,2020-05-06,17,6,15586,606,1.7617197712635315,0.03888104709354549,56,8
Europe,Austria,8847037,2020-05-07,65,2,15651,608,1.7690668638550964,0.038847357996294164,57,8
Europe,Austria,8847037,2020-05-08,22,1,15673,609,1.771553572116857,0.038856632425189816,58,8
Europe,Austria,8847037,2020-05-09,62,5,15735,614,1.7785615681272724,0.03902129011757229,59,8
Europe,Austria,8847037,2020-05-10,42,1,15777,615,1.7833089202633605,0.03898079482791405,60,8
Europe,Austria,8847037,2020-05-11,10,3,15787,618,1.7844392422005242,0.03914613289415342,61,8
Europe,Austria,8847037,2020-05-12,87,2,15874,620,1.7942730430538496,0.03905757843013733,62,8
Europe,Austria,8847037,2020-05-13,36,3,15910,623,1.7983422020276392,0.039157762413576366,63,8
Europe,Austria,8847037,2020-05-14,54,1,15964,624,1.804445940488324,0.03908794788273615,64,8
Europe,Austria,8847037,2020-05-15,41,2,16005,626,1.8090802604306957,0.039112777257107156,65,8
Europe,Austria,8847037,2020-05-16,63,2,16068,628,1.8162012886348278,0.039083893452825494,66,8
Europe,Austria,8847037,2020-05-17,72,0,16140,628,1.8243396065824073,0.03890954151177199,67,8
Europe,Austria,8847037,2020-05-18,14,1,16154,629,1.8259220572944366,0.03893772440262474,68,8
Europe,Austria,8847037,2020-05-19,25,0,16179,629,1.828747862137346,0.03887755732739972,69,8
Europe,Austria,8847037,2020-05-20,78,3,16257,632,1.837564373247224,0.038875561296672204,70,8
Europe,Austria,8847037,2020-05-21,18,1,16275,633,1.8395989527341188,0.038894009216589864,71,8
Europe,Austria,8847037,2020-05-22,57,0,16332,633,1.8460417877759527,0.0387582659808964,72,8
Europe,Austria,8847037,2020-05-23,29,2,16361,635,1.8493197213937276,0.03881180856915836,73,8
Europe,Austria,8847037,2020-05-24,46,4,16407,639,1.8545192023046813,0.038946791003839826,74,8
Europe,Austria,8847037,2020-05-25,32,1,16439,640,1.8581362325036053,0.03893180850416692,75,8
Europe,Austria,8847037,2020-05-26,20,1,16459,641,1.8603968763779333,0.0389452579136035,76,8
Europe,Austria,8847037,2020-05-27,38,2,16497,643,1.8646920997391556,0.03897678365763472,77,8
Europe,Azerbaijan,9942334,2020-03-30,27,0,209,4,0.021021220972862107,0.019138755980861243,0,9
Europe,Azerbaijan,9942334,2020-03-31,64,0,273,4,0.027458341270772034,0.014652014652014652,1,9
Europe,Azerbaijan,9942334,2020-04-01,25,1,298,5,0.029972841387143102,0.016778523489932886,2,9
Europe,Azerbaijan,9942334,2020-04-02,61,0,359,5,0.0361082216710885,0.013927576601671309,3,9
Europe,Azerbaijan,9942334,2020-04-03,41,0,400,5,0.040232001861937046,0.0125,4,9
Europe,Azerbaijan,9942334,2020-04-04,43,0,443,5,0.044556942062095276,0.011286681715575621,5,9
Europe,Azerbaijan,9942334,2020-04-05,78,0,521,5,0.052402182425173,0.009596928982725527,6,9
Europe,Azerbaijan,9942334,2020-04-06,63,2,584,7,0.05873872271842809,0.011986301369863013,7,9
Europe,Azerbaijan,9942334,2020-04-07,57,0,641,7,0.06447178298375411,0.0109204368174727,8,9
Europe,Azerbaijan,9942334,2020-04-08,76,1,717,8,0.07211586333752215,0.011157601115760111,9,9
Europe,Azerbaijan,9942334,2020-04-09,105,0,822,8,0.08267676382628063,0.009732360097323601,10,9
Europe,Azerbaijan,9942334,2020-04-10,104,1,926,9,0.09313708431038427,0.009719222462203024,11,9
Europe,Azerbaijan,9942334,2020-04-11,65,1,991,10,0.09967478461294903,0.010090817356205853,12,9
Europe,Azerbaijan,9942334,2020-04-12,67,1,1058,11,0.1064136449248235,0.010396975425330813,13,9
Europe,Azerbaijan,9942334,2020-04-13,40,0,1098,11,0.11043684511101719,0.010018214936247723,14,9
Europe,Azerbaijan,9942334,2020-04-14,50,1,1148,12,0.11546584534375932,0.010452961672473868,15,9
Europe,Azerbaijan,9942334,2020-04-15,49,1,1197,13,0.1203942655718466,0.01086048454469507,16,9
Europe,Azerbaijan,9942334,2020-04-16,56,0,1253,13,0.1260267458325178,0.010375099760574621,17,9
Europe,Azerbaijan,9942334,2020-04-17,30,2,1283,15,0.12904414597216307,0.011691348402182385,18,9
Europe,Azerbaijan,9942334,2020-04-18,57,0,1340,15,0.1347772062374891,0.011194029850746268,19,9
Europe,Azerbaijan,9942334,2020-04-19,33,3,1373,18,0.1380963463910989,0.013109978150036417,20,9
Europe,Azerbaijan,9942334,2020-04-20,25,1,1398,19,0.14061084650746997,0.013590844062947067,21,9
Europe,Azerbaijan,9942334,2020-04-21,38,0,1436,19,0.144432886684354,0.013231197771587743,22,9
Europe,Azerbaijan,9942334,2020-04-22,44,1,1480,20,0.14885840688916707,0.013513513513513514,23,9
Europe,Azerbaijan,9942334,2020-04-23,38,0,1518,20,0.1526804470660511,0.013175230566534914,24,9
Europe,Azerbaijan,9942334,2020-04-24,30,0,1548,20,0.15569784720569638,0.012919896640826873,25,9
Europe,Azerbaijan,9942334,2020-04-25,44,1,1592,21,0.16012336741050942,0.013190954773869347,26,9
Europe,Azerbaijan,9942334,2020-04-26,25,0,1617,21,0.1626378675268805,0.012987012987012988,27,9
Europe,Azerbaijan,9942334,2020-04-27,28,0,1645,21,0.1654541076572161,0.01276595744680851,28,9
Europe,Azerbaijan,9942334,2020-04-28,33,1,1678,22,0.16877324781082592,0.013110846245530394,29,9
Europe,Azerbaijan,9942334,2020-04-29,39,0,1717,22,0.17269586799236478,0.0128130460104834,30,9
Europe,Azerbaijan,9942334,2020-04-30,49,1,1766,23,0.17762428822045206,0.013023782559456399,31,9
Europe,Azerbaijan,9942334,2020-05-01,38,1,1804,24,0.18144632839733607,0.013303769401330377,32,9
Europe,Azerbaijan,9942334,2020-05-02,50,1,1854,25,0.1864753286300782,0.01348435814455232,33,9
Europe,Azerbaijan,9942334,2020-05-03,40,0,1894,25,0.1904985288162719,0.013199577613516367,34,9
Europe,Azerbaijan,9942334,2020-05-04,38,0,1932,25,0.19432056899315595,0.012939958592132506,35,9
Europe,Azerbaijan,9942334,2020-05-05,52,1,1984,26,0.19955072923520775,0.01310483870967742,36,9
Europe,Azerbaijan,9942334,2020-05-06,76,0,2060,26,0.2071948095889758,0.01262135922330097,37,9
Europe,Azerbaijan,9942334,2020-05-07,67,2,2127,28,0.21393366990085022,0.013164080865068171,38,9
Europe,Azerbaijan,9942334,2020-05-08,77,0,2204,28,0.22167833025927314,0.012704174228675136,39,9
Europe,Azerbaijan,9942334,2020-05-09,75,0,2279,28,0.22922183060838633,0.01228609039052216,40,9
Europe,Azerbaijan,9942334,2020-05-10,143,3,2422,31,0.24360477127402883,0.012799339388934764,41,9
Europe,Azerbaijan,9942334,2020-05-11,97,1,2519,32,0.2533610317255485,0.012703453751488685,42,9
Europe,Azerbaijan,9942334,2020-05-12,70,0,2589,32,0.2604016320513875,0.012359984550019312,43,9
Europe,Azerbaijan,9942334,2020-05-13,104,1,2693,33,0.2708619525354911,0.012253991830672113,44,9
Europe,Azerbaijan,9942334,2020-05-14,65,2,2758,35,0.2773996528380559,0.012690355329949238,45,9
Europe,Azerbaijan,9942334,2020-05-15,121,0,2879,35,0.2895698334012919,0.012156998957971519,46,9
Europe,Azerbaijan,9942334,2020-05-16,101,1,2980,36,0.29972841387143095,0.012080536912751677,47,9
Europe,Azerbaijan,9942334,2020-05-17,158,0,3138,36,0.31562005460689613,0.011472275334608031,48,9
Europe,Azerbaijan,9942334,2020-05-18,136,3,3274,39,0.32929893523995474,0.011912034208918754,49,9
Europe,Azerbaijan,9942334,2020-05-19,13,1,3287,40,0.33060647530046766,0.012169151201703681,50,9
Europe,Azerbaijan,9942334,2020-05-20,231,1,3518,41,0.3538404563757363,0.011654349061967027,51,9
Europe,Azerbaijan,9942334,2020-05-21,113,2,3631,43,0.36520599690173355,0.011842467639768659,52,9
Europe,Azerbaijan,9942334,2020-05-22,118,1,3749,44,0.377074437451005,0.01173646305681515,53,9
Europe,Azerbaijan,9942334,2020-05-23,106,2,3855,46,0.3877359179444183,0.011932555123216601,54,9
Europe,Azerbaijan,9942334,2020-05-24,127,3,3982,49,0.4005095785355833,0.012305374183827222,55,9
Europe,Azerbaijan,9942334,2020-05-25,140,0,4122,49,0.4145907791872613,0.011887433284813197,56,9
Europe,Azerbaijan,9942334,2020-05-26,149,2,4271,51,0.4295771998808328,0.011940997424490752,57,9
Europe,Azerbaijan,9942334,2020-05-27,132,1,4403,52,0.4428537604952721,0.011810129457188281,58,9
America,Bahamas,385640,2020-03-27,4,0,9,0,0.023337828026138367,0,0,10
America,Bahamas,385640,2020-03-28,0,0,9,0,0.023337828026138367,0,1,10
America,Bahamas,385640,2020-03-29,2,0,11,0,0.028524012031946894,0,2,10
America,Bahamas,385640,2020-03-30,3,0,14,0,0.03630328804065969,0,3,10
America,Bahamas,385640,2020-03-31,0,0,14,0,0.03630328804065969,0,4,10
America,Bahamas,385640,2020-04-01,1,0,15,0,0.038896380043563945,0,5,10
America,Bahamas,385640,2020-04-02,6,1,21,1,0.054454932060989523,0.047619047619047616,6,10
America,Bahamas,385640,2020-04-03,3,0,24,1,0.06223420806970231,0.041666666666666664,7,10
America,Bahamas,385640,2020-04-04,0,2,24,3,0.06223420806970231,0.125,8,10
America,Bahamas,385640,2020-04-05,4,1,28,4,0.07260657608131937,0.14285714285714285,9,10
America,Bahamas,385640,2020-04-06,1,1,29,5,0.07519966808422363,0.1724137931034483,10,10
America,Bahamas,385640,2020-04-07,4,0,33,5,0.08557203609584069,0.15151515151515152,11,10
America,Bahamas,385640,2020-04-08,3,1,36,6,0.09335131210455347,0.16666666666666666,12,10
America,Bahamas,385640,2020-04-09,4,1,40,7,0.10372368011617052,0.175,13,10
America,Bahamas,385640,2020-04-10,1,1,41,8,0.1063167721190748,0.1951219512195122,14,10
America,Bahamas,385640,2020-04-11,1,0,42,8,0.10890986412197905,0.19047619047619047,15,10
America,Bahamas,385640,2020-04-12,4,0,46,8,0.11928223213359611,0.17391304347826086,16,10
America,Bahamas,385640,2020-04-13,1,0,47,8,0.12187532413650036,0.1702127659574468,17,10
America,Bahamas,385640,2020-04-14,2,0,49,8,0.1270615081423089,0.16326530612244897,18,10
America,Bahamas,385640,2020-04-15,0,0,49,8,0.1270615081423089,0.16326530612244897,19,10
America,Bahamas,385640,2020-04-16,4,0,53,8,0.13743387615392594,0.1509433962264151,20,10
America,Bahamas,385640,2020-04-17,1,1,54,9,0.1400269681568302,0.16666666666666666,21,10
America,Bahamas,385640,2020-04-18,1,0,55,9,0.14262006015973447,0.16363636363636364,22,10
America,Bahamas,385640,2020-04-19,3,0,58,9,0.15039933616844725,0.15517241379310345,23,10
America,Bahamas,385640,2020-04-20,2,0,60,9,0.15558552017425578,0.15,24,10
America,Bahamas,385640,2020-04-21,4,0,64,9,0.16595788818587281,0.140625,25,10
America,Bahamas,385640,2020-04-22,1,0,65,9,0.1685509801887771,0.13846153846153847,26,10
America,Bahamas,385640,2020-04-23,5,0,70,9,0.1815164402032984,0.12857142857142856,27,10
America,Bahamas,385640,2020-04-24,2,2,72,11,0.18670262420910694,0.1527777777777778,28,10
America,Bahamas,385640,2020-04-25,1,0,73,11,0.1892957162120112,0.1506849315068493,29,10
America,Bahamas,385640,2020-04-26,5,0,78,11,0.20226117622653253,0.14102564102564102,30,10
America,Bahamas,385640,2020-04-27,2,0,80,11,0.20744736023234103,0.1375,31,10
America,Bahamas,385640,2020-04-28,0,0,80,11,0.20744736023234103,0.1375,32,10
America,Bahamas,385640,2020-04-29,0,0,80,11,0.20744736023234103,0.1375,33,10
America,Bahamas,385640,2020-04-30,0,0,80,11,0.20744736023234103,0.1375,34,10
America,Bahamas,385640,2020-05-01,1,0,81,11,0.2100404522352453,0.13580246913580246,35,10
America,Bahamas,385640,2020-05-02,1,0,82,11,0.2126335442381496,0.13414634146341464,36,10
America,Bahamas,385640,2020-05-03,1,0,83,11,0.21522663624105381,0.13253012048192772,37,10
America,Bahamas,385640,2020-05-04,0,0,83,11,0.21522663624105381,0.13253012048192772,38,10
America,Bahamas,385640,2020-05-05,0,0,83,11,0.21522663624105381,0.13253012048192772,39,10
America,Bahamas,385640,2020-05-06,6,0,89,11,0.23078518825847943,0.12359550561797752,40,10
America,Bahamas,385640,2020-05-07,3,0,92,11,0.23856446426719222,0.11956521739130435,41,10
America,Bahamas,385640,2020-05-08,0,0,92,11,0.23856446426719222,0.11956521739130435,42,10
America,Bahamas,385640,2020-05-09,0,0,92,11,0.23856446426719222,0.11956521739130435,43,10
America,Bahamas,385640,2020-05-10,0,0,92,11,0.23856446426719222,0.11956521739130435,44,10
America,Bahamas,385640,2020-05-11,0,0,92,11,0.23856446426719222,0.11956521739130435,45,10
America,Bahamas,385640,2020-05-12,1,0,93,11,0.24115755627009647,0.11827956989247312,46,10
America,Bahamas,385640,2020-05-13,0,0,93,11,0.24115755627009647,0.11827956989247312,47,10
America,Bahamas,385640,2020-05-14,1,0,94,11,0.24375064827300072,0.11702127659574468,48,10
America,Bahamas,385640,2020-05-15,2,0,96,11,0.24893683227880925,0.11458333333333333,49,10
America,Bahamas,385640,2020-05-16,0,0,96,11,0.24893683227880925,0.11458333333333333,50,10
America,Bahamas,385640,2020-05-17,0,0,96,11,0.24893683227880925,0.11458333333333333,51,10
America,Bahamas,385640,2020-05-18,0,0,96,11,0.24893683227880925,0.11458333333333333,52,10
America,Bahamas,385640,2020-05-19,0,0,96,11,0.24893683227880925,0.11458333333333333,53,10
America,Bahamas,385640,2020-05-20,0,0,96,11,0.24893683227880925,0.11458333333333333,54,10
America,Bahamas,385640,2020-05-21,1,0,97,11,0.2515299242817135,0.1134020618556701,55,10
America,Bahamas,385640,2020-05-22,0,0,97,11,0.2515299242817135,0.1134020618556701,56,10
America,Bahamas,385640,2020-05-23,0,0,97,11,0.2515299242817135,0.1134020618556701,57,10
America,Bahamas,385640,2020-05-24,3,0,100,11,0.2593092002904263,0.11,58,10
America,Bahamas,385640,2020-05-25,0,0,100,11,0.2593092002904263,0.11,59,10
America,Bahamas,385640,2020-05-26,0,0,100,11,0.2593092002904263,0.11,60,10
America,Bahamas,385640,2020-05-27,0,0,100,11,0.2593092002904263,0.11,61,10
Asia,Bahrain,1569439,2020-02-27,10,0,33,0,0.02102662161447498,0,0,11
Asia,Bahrain,1569439,2020-02-28,0,0,33,0,0.02102662161447498,0,1,11
Asia,Bahrain,1569439,2020-02-29,5,0,38,0,0.02421247337424392,0,2,11
Asia,Bahrain,1569439,2020-03-01,3,0,41,0,0.02612398443010528,0,3,11
Asia,Bahrain,1569439,2020-03-02,6,0,47,0,0.029947006541828,0,4,11
Asia,Bahrain,1569439,2020-03-04,2,0,49,0,0.031221347245735574,0,5,11
Asia,Bahrain,1569439,2020-03-05,3,0,52,0,0.033132858301596936,0,6,11
Asia,Bahrain,1569439,2020-03-06,0,0,52,0,0.033132858301596936,0,7,11
Asia,Bahrain,1569439,2020-03-07,4,0,56,0,0.03568153970941209,0,8,11
Asia,Bahrain,1569439,2020-03-08,7,0,63,0,0.0401417321730886,0,9,11
Asia,Bahrain,1569439,2020-03-09,16,0,79,0,0.0503364578043492,0,10,11
Asia,Bahrain,1569439,2020-03-10,30,0,109,0,0.0694515683629628,0,11,11
Asia,Bahrain,1569439,2020-03-11,1,0,110,0,0.0700887387149166,0,12,11
Asia,Bahrain,1569439,2020-03-12,52,0,162,0,0.10322159701651354,0,13,11
Asia,Bahrain,1569439,2020-03-13,0,0,162,0,0.10322159701651354,0,14,11
Asia,Bahrain,1569439,2020-03-14,48,0,210,0,0.13380577391029533,0,15,11
Asia,Bahrain,1569439,2020-03-15,1,0,211,0,0.13444294426224912,0,16,11
Asia,Bahrain,1569439,2020-03-16,3,0,214,0,0.1363544553181105,0,17,11
Asia,Bahrain,1569439,2020-03-17,7,1,221,1,0.14081464778178698,0.004524886877828055,18,11
Asia,Bahrain,1569439,2020-03-18,16,0,237,1,0.1510093734130476,0.004219409282700422,19,11
Asia,Bahrain,1569439,2020-03-19,19,0,256,1,0.16311561010016956,0.00390625,20,11
Asia,Bahrain,1569439,2020-03-20,13,0,269,1,0.1713988246755688,0.0037174721189591076,21,11
Asia,Bahrain,1569439,2020-03-21,16,0,285,1,0.18159355030682936,0.0035087719298245615,22,11
Asia,Bahrain,1569439,2020-03-22,21,0,306,1,0.19497412769785893,0.0032679738562091504,23,11
Asia,Bahrain,1569439,2020-03-23,28,1,334,2,0.21281489755256497,0.005988023952095809,24,11
Asia,Bahrain,1569439,2020-03-24,5,0,339,2,0.2160007493123339,0.0058997050147492625,25,11
Asia,Bahrain,1569439,2020-03-25,51,1,390,3,0.24849643726197707,0.007692307692307693,26,11
Asia,Bahrain,1569439,2020-03-26,29,0,419,3,0.2669743774686369,0.007159904534606206,27,11
Asia,Bahrain,1569439,2020-03-27,39,1,458,4,0.29182402119483464,0.008733624454148471,28,11
Asia,Bahrain,1569439,2020-03-28,8,0,466,4,0.29692138401046486,0.008583690987124463,29,11
Asia,Bahrain,1569439,2020-03-29,7,0,473,4,0.30138157647414143,0.008456659619450317,30,11
Asia,Bahrain,1569439,2020-03-30,27,0,500,4,0.3185851759768937,0.008,31,11
Asia,Bahrain,1569439,2020-03-31,15,0,515,4,0.32814273125620047,0.007766990291262136,32,11
Asia,Bahrain,1569439,2020-04-01,52,0,567,4,0.3612755895577974,0.007054673721340388,33,11
Asia,Bahrain,1569439,2020-04-02,2,0,569,4,0.362549930261705,0.007029876977152899,34,11
Asia,Bahrain,1569439,2020-04-03,74,0,643,4,0.4097005363062852,0.006220839813374806,35,11
Asia,Bahrain,1569439,2020-04-04,0,0,643,4,0.4097005363062852,0.006220839813374806,36,11
Asia,Bahrain,1569439,2020-04-05,45,0,688,4,0.43837320214420566,0.005813953488372093,37,11
Asia,Bahrain,1569439,2020-04-06,12,0,700,4,0.4460192463676511,0.005714285714285714,38,11
Asia,Bahrain,1569439,2020-04-07,56,0,756,4,0.4817007860770632,0.005291005291005291,39,11
Asia,Bahrain,1569439,2020-04-08,55,1,811,5,0.5167451554345215,0.006165228113440197,40,11
Asia,Bahrain,1569439,2020-04-09,12,0,823,5,0.524391199657967,0.006075334143377886,41,11
Asia,Bahrain,1569439,2020-04-10,64,0,887,5,0.5651701021830093,0.005636978579481398,42,11
Asia,Bahrain,1569439,2020-04-11,111,1,998,6,0.6358960112498798,0.006012024048096192,43,11
Asia,Bahrain,1569439,2020-04-12,42,0,1040,6,0.6626571660319388,0.0057692307692307696,44,11
Asia,Bahrain,1569439,2020-04-13,96,0,1136,6,0.7238255198195024,0.00528169014084507,45,11
Asia,Bahrain,1569439,2020-04-14,225,1,1361,7,0.8671888490091045,0.005143277002204262,46,11
Asia,Bahrain,1569439,2020-04-15,167,0,1528,7,0.973596297785387,0.004581151832460733,47,11
Asia,Bahrain,1569439,2020-04-16,145,0,1673,7,1.0659859988186862,0.0041841004184100415,48,11
Asia,Bahrain,1569439,2020-04-17,27,0,1700,7,1.0831895983214384,0.00411764705882353,49,11
Asia,Bahrain,1569439,2020-04-18,44,0,1744,7,1.1112250938074049,0.0040137614678899085,50,11
Asia,Bahrain,1569439,2020-04-19,29,0,1773,7,1.129703034014065,0.003948110547095319,51,11
Asia,Bahrain,1569439,2020-04-20,100,0,1873,7,1.1934200692094437,0.0037373198077949813,52,11
Asia,Bahrain,1569439,2020-04-21,34,0,1907,7,1.2150838611758723,0.0036706869428421605,53,11
Asia,Bahrain,1569439,2020-04-22,66,0,1973,7,1.2571371044048225,0.0035478966041561076,54,11
Asia,Bahrain,1569439,2020-04-23,34,0,2007,7,1.2788008963712512,0.003487792725460887,55,11
Asia,Bahrain,1569439,2020-04-24,210,1,2217,8,1.4126066702815465,0.0036084799278304014,56,11
Asia,Bahrain,1569439,2020-04-25,301,0,2518,8,1.6043949462196363,0.003177124702144559,57,11
Asia,Bahrain,1569439,2020-04-26,71,0,2589,8,1.6496340412083554,0.003089996137504828,58,11
Asia,Bahrain,1569439,2020-04-27,58,0,2647,8,1.686589921621675,0.003022289384208538,59,11
Asia,Bahrain,1569439,2020-04-28,76,0,2723,8,1.735014868370163,0.0029379360998898272,60,11
Asia,Bahrain,1569439,2020-04-29,88,0,2811,8,1.7910858593420962,0.002845962290999644,61,11
Asia,Bahrain,1569439,2020-04-30,110,0,2921,8,1.8611745980570127,0.0027387880862718246,62,11
Asia,Bahrain,1569439,2020-05-01,119,0,3040,8,1.9369978699395134,0.002631578947368421,63,11
Asia,Bahrain,1569439,2020-05-02,130,0,3170,8,2.019830015693506,0.002523659305993691,64,11
Asia,Bahrain,1569439,2020-05-03,114,0,3284,8,2.0924674358162374,0.00243605359317905,65,11
Asia,Bahrain,1569439,2020-05-04,99,0,3383,8,2.1555473006596624,0.0023647650014779783,66,11
Asia,Bahrain,1569439,2020-05-05,150,0,3533,8,2.2511228534527308,0.0022643645626945937,67,11
Asia,Bahrain,1569439,2020-05-06,187,0,3720,8,2.370273709268089,0.002150537634408602,68,11
Asia,Bahrain,1569439,2020-05-07,214,0,3934,8,2.506628164586199,0.0020335536349771225,69,11
Asia,Bahrain,1569439,2020-05-08,265,0,4199,8,2.675478307853953,0.0019052155275065491,70,11
Asia,Bahrain,1569439,2020-05-09,245,0,4444,8,2.831585044082631,0.0018001800180018,71,11
Asia,Bahrain,1569439,2020-05-10,330,0,4774,8,3.041851260227381,0.0016757436112274822,72,11
Asia,Bahrain,1569439,2020-05-11,167,0,4941,8,3.148258709003663,0.0016191054442420564,73,11
Asia,Bahrain,1569439,2020-05-12,295,0,5236,8,3.3362239628300303,0.0015278838808250573,74,11
Asia,Bahrain,1569439,2020-05-13,295,1,5531,9,3.524189216656398,0.0016271921894774905,75,11
Asia,Bahrain,1569439,2020-05-14,285,1,5816,10,3.705782766963227,0.0017193947730398899,76,11
Asia,Bahrain,1569439,2020-05-15,382,0,6198,10,3.9491818414095734,0.0016134236850596966,77,11
Asia,Bahrain,1569439,2020-05-16,385,2,6583,12,4.194492426911782,0.0018228771077016558,78,11
Asia,Bahrain,1569439,2020-05-17,164,0,6747,12,4.298988364632203,0.0017785682525566918,79,11
Asia,Bahrain,1569439,2020-05-18,209,0,6956,12,4.432156968190545,0.0017251293847038527,80,11
Asia,Bahrain,1569439,2020-05-19,228,0,7184,12,4.577431808436008,0.0016703786191536749,81,11
Asia,Bahrain,1569439,2020-05-20,348,0,7532,12,4.799167090915926,0.0015932023366967605,82,11
Asia,Bahrain,1569439,2020-05-21,356,0,7888,12,5.0259997362114746,0.0015212981744421906,83,11
Asia,Bahrain,1569439,2020-05-22,286,0,8174,12,5.2082304568702575,0.0014680694886224615,84,11
Asia,Bahrain,1569439,2020-05-23,240,0,8414,12,5.361151341339167,0.0014261944378416924,85,11
Asia,Bahrain,1569439,2020-05-24,388,1,8802,13,5.608373437897236,0.0014769370597591455,86,11
Asia,Bahrain,1569439,2020-05-25,336,1,9138,14,5.822462676153708,0.0015320639089516305,87,11
Asia,Bahrain,1569439,2020-05-26,33,0,9171,14,5.843489297768183,0.0015265510849416639,88,11
Asia,Bahrain,1569439,2020-05-27,195,0,9366,14,5.967737516399172,0.0014947683109118087,89,11
Asia,Bangladesh,161356039,2020-04-22,434,9,3382,110,0.02095986007688253,0.03252513305736251,0,12
Asia,Bangladesh,161356039,2020-04-23,390,10,3772,120,0.023376875283855972,0.031813361611876985,1,12
Asia,Bangladesh,161356039,2020-04-24,414,7,4186,127,0.025942629888181624,0.030339225991399904,2,12
Asia,Bangladesh,161356039,2020-04-25,503,4,4689,131,0.0290599597576884,0.027937726594156536,3,12
Asia,Bangladesh,161356039,2020-04-26,309,9,4998,140,0.030974979498598128,0.028011204481792718,4,12
Asia,Bangladesh,161356039,2020-04-27,418,5,5416,145,0.033565524002482486,0.026772525849335302,5,12
Asia,Bangladesh,161356039,2020-04-28,497,7,5913,152,0.036645669022651206,0.025706071368171823,6,12
Asia,Bangladesh,161356039,2020-04-29,549,3,6462,155,0.04004808273708305,0.023986381925100587,7,12
Asia,Bangladesh,161356039,2020-04-30,641,8,7103,163,0.044020664141365046,0.022948050119667746,8,12
Asia,Bangladesh,161356039,2020-05-01,564,5,7667,168,0.04751603997914202,0.021912090778661797,9,12
Asia,Bangladesh,161356039,2020-05-02,571,2,8238,170,0.05105479814114674,0.020636076717649915,10,12
Asia,Bangladesh,161356039,2020-05-03,552,5,8790,175,0.054475804280247606,0.019908987485779295,11,12
Asia,Bangladesh,161356039,2020-05-04,665,2,9455,177,0.058597125081881814,0.01872025383395029,12,12
Asia,Bangladesh,161356039,2020-05-05,688,5,10143,182,0.06286098780597855,0.017943409247757072,13,12
Asia,Bangladesh,161356039,2020-05-06,786,1,10929,183,0.06773220306926349,0.01674444139445512,14,12
Asia,Bangladesh,161356039,2020-05-07,790,3,11719,186,0.07262820823210712,0.015871661404556703,15,12
Asia,Bangladesh,161356039,2020-05-08,706,13,12425,199,0.07700362550421803,0.016016096579476863,16,12
Asia,Bangladesh,161356039,2020-05-09,709,7,13134,206,0.08139763520099796,0.01568448302116644,17,12
Asia,Bangladesh,161356039,2020-05-10,636,8,13770,214,0.08533922923083158,0.015541031227305737,18,12
Asia,Bangladesh,161356039,2020-05-11,887,14,14657,228,0.09083638945797375,0.015555707170635192,19,12
Asia,Bangladesh,161356039,2020-05-12,1034,11,15691,239,0.0972445784938982,0.015231661461984578,20,12
Asia,Bangladesh,161356039,2020-05-13,969,11,16660,250,0.10324993166199375,0.015006002400960384,21,12
Asia,Bangladesh,161356039,2020-05-14,1162,19,17822,269,0.11045139748379668,0.01509370441027943,22,12
Asia,Bangladesh,161356039,2020-05-15,1041,14,18863,283,0.11690296884394888,0.015002915761013624,23,12
Asia,Bangladesh,161356039,2020-05-16,1202,15,20065,298,0.12435233366133881,0.014851731871417893,24,12
Asia,Bangladesh,161356039,2020-05-17,930,16,20995,314,0.13011598530873703,0.014955941890926411,25,12
Asia,Bangladesh,161356039,2020-05-18,1273,14,22268,328,0.13800537084329395,0.014729656906772049,26,12
Asia,Bangladesh,161356039,2020-05-19,1602,21,23870,349,0.1479337256165541,0.014620863007959782,27,12
Asia,Bangladesh,161356039,2020-05-20,1251,21,25121,370,0.15568676670353812,0.014728713028939931,28,12
Asia,Bangladesh,161356039,2020-05-21,1617,16,26738,386,0.1657080836001434,0.014436382676340788,29,12
Asia,Bangladesh,161356039,2020-05-22,1773,22,28511,408,0.17669620657953808,0.01431026621304058,30,12
Asia,Bangladesh,161356039,2020-05-23,1694,24,30205,432,0.18719472904264836,0.01430226783645092,31,12
Asia,Bangladesh,161356039,2020-05-24,1873,20,32078,452,0.19880259951101056,0.014090654030799924,32,12
Asia,Bangladesh,161356039,2020-05-25,1532,28,33610,480,0.20829713104199343,0.01428146385004463,33,12
Asia,Bangladesh,161356039,2020-05-26,1975,21,35585,501,0.2205371439491025,0.014078965856400168,34,12
Asia,Bangladesh,161356039,2020-05-27,1166,21,36751,522,0.22776339967046413,0.014203695137547278,35,12
America,Barbados,286641,2020-03-21,4,0,6,0,0.020932106711880016,0,0,13
America,Barbados,286641,2020-03-22,8,0,14,0,0.04884158232772004,0,1,13
America,Barbados,286641,2020-03-23,3,0,17,0,0.05930763568366005,0,2,13
America,Barbados,286641,2020-03-24,0,0,17,0,0.05930763568366005,0,3,13
America,Barbados,286641,2020-03-25,1,0,18,0,0.06279632013564006,0,4,13
America,Barbados,286641,2020-03-26,0,0,18,0,0.06279632013564006,0,5,13
America,Barbados,286641,2020-03-27,6,0,24,0,0.08372842684752006,0,6,13
America,Barbados,286641,2020-03-28,0,0,24,0,0.08372842684752006,0,7,13
America,Barbados,286641,2020-03-29,2,0,26,0,0.09070579575148006,0,8,13
America,Barbados,286641,2020-03-30,7,0,33,0,0.1151265869153401,0,9,13
America,Barbados,286641,2020-03-31,1,0,34,0,0.1186152713673201,0,10,13
America,Barbados,286641,2020-04-01,0,0,34,0,0.1186152713673201,0,11,13
America,Barbados,286641,2020-04-02,11,0,45,0,0.15699080033910015,0,12,13
America,Barbados,286641,2020-04-03,0,0,45,0,0.15699080033910015,0,13,13
America,Barbados,286641,2020-04-04,0,0,45,0,0.15699080033910015,0,14,13
America,Barbados,286641,2020-04-05,6,0,51,0,0.17792290705098016,0,15,13
America,Barbados,286641,2020-04-06,5,1,56,1,0.19536632931088016,0.017857142857142856,16,13
America,Barbados,286641,2020-04-07,4,1,60,2,0.2093210671188002,0.03333333333333333,17,13
America,Barbados,286641,2020-04-08,3,1,63,3,0.21978712047474017,0.047619047619047616,18,13
America,Barbados,286641,2020-04-09,0,0,63,3,0.21978712047474017,0.047619047619047616,19,13
America,Barbados,286641,2020-04-10,3,0,66,3,0.2302531738306802,0.045454545454545456,20,13
America,Barbados,286641,2020-04-11,1,1,67,4,0.2337418582826602,0.05970149253731343,21,13
America,Barbados,286641,2020-04-12,1,0,68,4,0.2372305427346402,0.058823529411764705,22,13
America,Barbados,286641,2020-04-13,3,0,71,4,0.2476965960905802,0.056338028169014086,23,13
America,Barbados,286641,2020-04-14,1,0,72,4,0.25118528054256023,0.05555555555555555,24,13
America,Barbados,286641,2020-04-15,1,1,73,5,0.2546739649945402,0.0684931506849315,25,13
America,Barbados,286641,2020-04-16,2,0,75,5,0.2616513338985002,0.06666666666666667,26,13
America,Barbados,286641,2020-04-17,0,0,75,5,0.2616513338985002,0.06666666666666667,27,13
America,Barbados,286641,2020-04-18,0,0,75,5,0.2616513338985002,0.06666666666666667,28,13
America,Barbados,286641,2020-04-19,0,0,75,5,0.2616513338985002,0.06666666666666667,29,13
America,Barbados,286641,2020-04-20,0,0,75,5,0.2616513338985002,0.06666666666666667,30,13
America,Barbados,286641,2020-04-21,0,0,75,5,0.2616513338985002,0.06666666666666667,31,13
America,Barbados,286641,2020-04-22,0,0,75,5,0.2616513338985002,0.06666666666666667,32,13
America,Barbados,286641,2020-04-23,1,1,76,6,0.26514001835048023,0.07894736842105263,33,13
America,Barbados,286641,2020-04-24,0,0,76,6,0.26514001835048023,0.07894736842105263,34,13
America,Barbados,286641,2020-04-25,0,0,76,6,0.26514001835048023,0.07894736842105263,35,13
America,Barbados,286641,2020-04-26,3,0,79,6,0.2756060717064202,0.0759493670886076,36,13
America,Barbados,286641,2020-04-27,0,0,79,6,0.2756060717064202,0.0759493670886076,37,13
America,Barbados,286641,2020-04-28,1,0,80,6,0.27909475615840024,0.075,38,13
America,Barbados,286641,2020-04-29,0,0,80,6,0.27909475615840024,0.075,39,13
America,Barbados,286641,2020-04-30,0,1,80,7,0.27909475615840024,0.0875,40,13
America,Barbados,286641,2020-05-01,1,0,81,7,0.28258344061038027,0.08641975308641975,41,13
America,Barbados,286641,2020-05-02,0,0,81,7,0.28258344061038027,0.08641975308641975,42,13
America,Barbados,286641,2020-05-03,0,0,81,7,0.28258344061038027,0.08641975308641975,43,13
America,Barbados,286641,2020-05-04,1,0,82,7,0.28607212506236024,0.08536585365853659,44,13
America,Barbados,286641,2020-05-05,0,0,82,7,0.28607212506236024,0.08536585365853659,45,13
America,Barbados,286641,2020-05-06,0,0,82,7,0.28607212506236024,0.08536585365853659,46,13
America,Barbados,286641,2020-05-07,0,0,82,7,0.28607212506236024,0.08536585365853659,47,13
America,Barbados,286641,2020-05-08,0,0,82,7,0.28607212506236024,0.08536585365853659,48,13
America,Barbados,286641,2020-05-09,1,0,83,7,0.2895608095143402,0.08433734939759036,49,13
America,Barbados,286641,2020-05-10,1,0,84,7,0.29304949396632024,0.08333333333333333,50,13
America,Barbados,286641,2020-05-11,0,0,84,7,0.29304949396632024,0.08333333333333333,51,13
America,Barbados,286641,2020-05-12,0,0,84,7,0.29304949396632024,0.08333333333333333,52,13
America,Barbados,286641,2020-05-13,1,0,85,7,0.29653817841830027,0.08235294117647059,53,13
America,Barbados,286641,2020-05-14,0,0,85,7,0.29653817841830027,0.08235294117647059,54,13
America,Barbados,286641,2020-05-15,0,0,85,7,0.29653817841830027,0.08235294117647059,55,13
America,Barbados,286641,2020-05-16,0,0,85,7,0.29653817841830027,0.08235294117647059,56,13
America,Barbados,286641,2020-05-17,1,0,86,7,0.30002686287028024,0.08139534883720931,57,13
America,Barbados,286641,2020-05-18,2,0,88,7,0.30700423177424024,0.07954545454545454,58,13
America,Barbados,286641,2020-05-19,0,0,88,7,0.30700423177424024,0.07954545454545454,59,13
America,Barbados,286641,2020-05-20,2,0,90,7,0.3139816006782003,0.07777777777777778,60,13
America,Barbados,286641,2020-05-21,0,0,90,7,0.3139816006782003,0.07777777777777778,61,13
America,Barbados,286641,2020-05-22,0,0,90,7,0.3139816006782003,0.07777777777777778,62,13
America,Barbados,286641,2020-05-23,0,0,90,7,0.3139816006782003,0.07777777777777778,63,13
America,Barbados,286641,2020-05-24,2,0,92,7,0.32095896958216025,0.07608695652173914,64,13
America,Barbados,286641,2020-05-25,0,0,92,7,0.32095896958216025,0.07608695652173914,65,13
America,Barbados,286641,2020-05-26,0,0,92,7,0.32095896958216025,0.07608695652173914,66,13
America,Barbados,286641,2020-05-27,0,0,92,7,0.32095896958216025,0.07608695652173914,67,13
Europe,Belarus,9485386,2020-04-03,102,4,254,4,0.026778035179591004,0.015748031496062992,0,14
Europe,Belarus,9485386,2020-04-04,97,0,351,4,0.03700429270880489,0.011396011396011397,1,14
Europe,Belarus,9485386,2020-04-05,43,1,394,5,0.04153758212897187,0.012690355329949238,2,14
Europe,Belarus,9485386,2020-04-06,170,3,564,8,0.05945988913893435,0.014184397163120567,3,14
Europe,Belarus,9485386,2020-04-07,136,5,700,13,0.07379773474690435,0.018571428571428572,4,14
Europe,Belarus,9485386,2020-04-08,161,0,861,13,0.09077121373869235,0.015098722415795587,5,14
Europe,Belarus,9485386,2020-04-09,205,0,1066,13,0.11238340748600005,0.012195121951219513,6,14
Europe,Belarus,9485386,2020-04-10,420,3,1486,16,0.15666204833414263,0.010767160161507403,7,14
Europe,Belarus,9485386,2020-04-11,495,3,1981,19,0.2088475893337393,0.009591115598182737,8,14
Europe,Belarus,9485386,2020-04-12,245,4,2226,23,0.23467679649515583,0.010332434860736747,9,14
Europe,Belarus,9485386,2020-04-13,352,3,2578,26,0.27178651453931346,0.01008533747090768,10,14
Europe,Belarus,9485386,2020-04-14,341,3,2919,29,0.30773655389459115,0.009934909215484755,11,14
Europe,Belarus,9485386,2020-04-15,362,4,3281,33,0.34590052529227594,0.010057909174032308,12,14
Europe,Belarus,9485386,2020-04-16,447,3,3728,36,0.39302565019494196,0.009656652360515022,13,14
Europe,Belarus,9485386,2020-04-17,476,4,4204,40,0.4432081098228369,0.009514747859181731,14,14
Europe,Belarus,9485386,2020-04-18,575,2,4779,42,0.5038276776506512,0.008788449466415568,15,14
Europe,Belarus,9485386,2020-04-19,0,3,4779,45,0.5038276776506512,0.009416195856873822,16,14
Europe,Belarus,9485386,2020-04-20,0,2,4779,47,0.5038276776506512,0.00983469345051266,17,14
Europe,Belarus,9485386,2020-04-21,1485,4,6264,51,0.6603843006494412,0.008141762452107279,18,14
Europe,Belarus,9485386,2020-04-22,459,4,6723,55,0.7087745295763398,0.008180871634686896,19,14
Europe,Belarus,9485386,2020-04-23,558,3,7281,58,0.7676018667031579,0.00796593874467793,20,14
Europe,Belarus,9485386,2020-04-24,741,2,8022,60,0.8457220401995238,0.0074794315632011965,21,14
Europe,Belarus,9485386,2020-04-25,751,3,8773,63,0.9248964670494169,0.007181123902883848,22,14
Europe,Belarus,9485386,2020-04-26,817,4,9590,67,1.0110289660325893,0.006986444212721585,23,14
Europe,Belarus,9485386,2020-04-27,873,5,10463,72,1.1030652837955146,0.006881391570295326,24,14
Europe,Belarus,9485386,2020-04-28,826,3,11289,75,1.1901466107968617,0.006643635397289397,25,14
Europe,Belarus,9485386,2020-04-29,919,4,12208,79,1.2870324939860118,0.006471166448230668,26,14
Europe,Belarus,9485386,2020-04-30,973,5,13181,84,1.3896113452842087,0.006372809346787042,27,14
Europe,Belarus,9485386,2020-05-01,846,5,14027,89,1.4788011789926103,0.006344906252227846,28,14
Europe,Belarus,9485386,2020-05-02,890,4,14917,93,1.5726297274565315,0.006234497553127305,29,14
Europe,Belarus,9485386,2020-05-03,911,4,15828,97,1.66867220796286,0.00612838008592368,30,14
Europe,Belarus,9485386,2020-05-04,877,2,16705,99,1.7611302270671958,0.005926369350493864,31,14
Europe,Belarus,9485386,2020-05-05,784,4,17489,103,1.8437836899837288,0.005889416204471382,32,14
Europe,Belarus,9485386,2020-05-06,861,4,18350,107,1.934554903722421,0.005831062670299728,33,14
Europe,Belarus,9485386,2020-05-07,905,5,19255,112,2.029964832216633,0.0058166709945468706,34,14
Europe,Belarus,9485386,2020-05-08,913,4,20168,116,2.1262181633936668,0.005751685838952796,35,14
Europe,Belarus,9485386,2020-05-09,933,5,21101,121,2.2245800012777552,0.005734325387422397,36,14
Europe,Belarus,9485386,2020-05-10,951,5,22052,126,2.3248394951981926,0.005713767458733901,37,14
Europe,Belarus,9485386,2020-05-11,921,5,22973,131,2.4219362290580477,0.005702346232533844,38,14
Europe,Belarus,9485386,2020-05-12,933,4,23906,135,2.520298066942136,0.005647117878356898,39,14
Europe,Belarus,9485386,2020-05-13,967,7,24873,142,2.622244366228217,0.005709001728782213,40,14
Europe,Belarus,9485386,2020-05-14,952,4,25825,146,2.7226092854840065,0.005653436592449177,41,14
Europe,Belarus,9485386,2020-05-15,947,5,26772,151,2.8224470780630333,0.005640221126550127,42,14
Europe,Belarus,9485386,2020-05-16,958,5,27730,156,2.923444549330939,0.00562567616300036,43,14
Europe,Belarus,9485386,2020-05-17,951,4,28681,160,3.023704043251376,0.005578606045814302,44,14
Europe,Belarus,9485386,2020-05-18,969,5,29650,165,3.1258611932081624,0.005564924114671164,45,14
Europe,Belarus,9485386,2020-05-19,922,6,30572,171,3.2230633524033707,0.00559335339526364,46,14
Europe,Belarus,9485386,2020-05-20,936,4,31508,175,3.3217414662935174,0.005554144979052939,47,14
Europe,Belarus,9485386,2020-05-21,918,4,32426,179,3.4185219241473144,0.005520261518534509,48,14
Europe,Belarus,9485386,2020-05-22,945,6,33371,185,3.5181488660556357,0.005543735578795961,49,14
Europe,Belarus,9485386,2020-05-23,932,5,34303,190,3.616405278604371,0.005538874150948897,50,14
Europe,Belarus,9485386,2020-05-24,941,4,35244,194,3.715610519171281,0.00550448303257292,51,14
Europe,Belarus,9485386,2020-05-25,954,5,36198,199,3.816186289097776,0.005497541300624344,52,14
Europe,Belarus,9485386,2020-05-26,946,5,37144,204,3.91591865634145,0.00549213870342451,53,14
Europe,Belarus,9485386,2020-05-27,915,4,38059,208,4.012382838189189,0.005465198770330277,54,14
Europe,Belgium,11422068,2020-03-10,39,0,239,0,0.020924407033822597,0,0,15
Europe,Belgium,11422068,2020-03-11,28,0,267,0,0.023375802000128173,0,1,15
Europe,Belgium,11422068,2020-03-12,47,3,314,3,0.027490643550712533,0.009554140127388535,2,15
Europe,Belgium,11422068,2020-03-13,85,0,399,3,0.034932378269854465,0.007518796992481203,3,15
Europe,Belgium,11422068,2020-03-14,160,0,559,3,0.04894034950588633,0.005366726296958855,4,15
Europe,Belgium,11422068,2020-03-15,130,1,689,4,0.06032182613516221,0.005805515239477504,5,15
Europe,Belgium,11422068,2020-03-16,197,0,886,4,0.07756914071952645,0.004514672686230248,6,15
Europe,Belgium,11422068,2020-03-17,199,1,1085,5,0.09499155494434107,0.004608294930875576,7,15
Europe,Belgium,11422068,2020-03-18,158,0,1243,5,0.10882442653992254,0.004022526146419952,8,15
Europe,Belgium,11422068,2020-03-19,243,9,1486,14,0.1300990328546459,0.009421265141318977,9,15
Europe,Belgium,11422068,2020-03-20,309,7,1795,21,0.15715192730423247,0.0116991643454039,10,15
Europe,Belgium,11422068,2020-03-21,462,16,2257,37,0.19759994424827448,0.01639344262295082,11,15
Europe,Belgium,11422068,2020-03-22,558,30,2815,67,0.2464527439339356,0.023801065719360567,12,15
Europe,Belgium,11422068,2020-03-23,586,8,3401,75,0.2977569385859023,0.022052337547780066,13,15
Europe,Belgium,11422068,2020-03-24,342,13,3743,88,0.3276989771029204,0.02351055303232701,14,15
Europe,Belgium,11422068,2020-03-25,526,34,4269,122,0.3737501825413752,0.028578121339892248,15,15
Europe,Belgium,11422068,2020-03-26,668,56,4937,178,0.4322334624518082,0.036054283978124366,16,15
Europe,Belgium,11422068,2020-03-27,1298,42,6235,220,0.5458731291041167,0.03528468323977546,17,15
Europe,Belgium,11422068,2020-03-28,1049,69,7284,289,0.6377128905203506,0.03967600219659528,18,15
Europe,Belgium,11422068,2020-03-29,1850,64,9134,353,0.7996800579369691,0.0386468141011605,19,15
Europe,Belgium,11422068,2020-03-30,1702,78,10836,431,0.9486898519602579,0.039774824658545586,20,15
Europe,Belgium,11422068,2020-03-31,1063,82,11899,513,1.0417553108596447,0.043112866627447684,21,15
Europe,Belgium,11422068,2020-04-01,876,192,12775,705,1.118448953376919,0.05518590998043053,22,15
Europe,Belgium,11422068,2020-04-02,1189,123,13964,828,1.222545689624681,0.059295330850759095,23,15
Europe,Belgium,11422068,2020-04-03,1384,183,15348,1011,1.3437146408163565,0.06587177482408131,24,15
Europe,Belgium,11422068,2020-04-04,1422,132,16770,1143,1.4682104851765898,0.06815742397137746,25,15
Europe,Belgium,11422068,2020-04-05,1661,140,18431,1283,1.6136307365706455,0.06961098149856221,26,15
Europe,Belgium,11422068,2020-04-06,1260,164,19691,1447,1.7239435100543965,0.07348534863643288,27,15
Europe,Belgium,11422068,2020-04-07,1123,185,20814,1632,1.822261958167295,0.07840876333237244,28,15
Europe,Belgium,11422068,2020-04-08,1380,403,22194,2035,1.94308071007807,0.0916914481391367,29,15
Europe,Belgium,11422068,2020-04-09,1209,205,23403,2240,2.0489284427303356,0.0957142246720506,30,15
Europe,Belgium,11422068,2020-04-10,1580,283,24983,2523,2.1872571586861502,0.10098867229716207,31,15
Europe,Belgium,11422068,2020-04-11,1684,496,26667,3019,2.334691055945386,0.11321108486143923,32,15
Europe,Belgium,11422068,2020-04-12,1351,327,28018,3346,2.4529708630696296,0.11942322792490542,33,15
Europe,Belgium,11422068,2020-04-13,1629,254,29647,3600,2.595589520216479,0.12142881235875468,34,15
Europe,Belgium,11422068,2020-04-14,942,303,30589,3903,2.678061450868617,0.12759488705090066,35,15
Europe,Belgium,11422068,2020-04-15,530,254,31119,4157,2.7244628555879724,0.1335839840611845,36,15
Europe,Belgium,11422068,2020-04-16,2454,283,33573,4440,2.939310114420611,0.13224912876418551,37,15
Europe,Belgium,11422068,2020-04-17,1236,417,34809,4857,3.047521692218957,0.1395328794277342,38,15
Europe,Belgium,11422068,2020-04-18,1329,306,36138,5163,3.163875403298247,0.14286900215839282,39,15
Europe,Belgium,11422068,2020-04-19,1045,290,37183,5453,3.25536496543358,0.14665304036791008,40,15
Europe,Belgium,11422068,2020-04-20,1313,230,38496,5683,3.3703178793892667,0.14762572734829593,41,15
Europe,Belgium,11422068,2020-04-21,1487,145,39983,5828,3.5005044620641375,0.145761948828252,42,15
Europe,Belgium,11422068,2020-04-22,973,170,40956,5998,3.5856904371432563,0.1464498486180291,43,15
Europe,Belgium,11422068,2020-04-23,933,264,41889,6262,3.667374419413367,0.14949031965432452,44,15
Europe,Belgium,11422068,2020-04-24,908,228,42797,6490,3.7468696561778483,0.15164614342126784,45,15
Europe,Belgium,11422068,2020-04-25,1496,189,44293,6679,3.877844187234746,0.1507913214277651,46,15
Europe,Belgium,11422068,2020-04-26,1032,238,45325,6917,3.968195601707152,0.15260893546607832,47,15
Europe,Belgium,11422068,2020-04-27,809,177,46134,7094,4.0390234062693375,0.15376945419863874,48,15
Europe,Belgium,11422068,2020-04-28,553,113,46687,7207,4.087438456853873,0.1543684537451539,49,15
Europe,Belgium,11422068,2020-04-29,647,124,47334,7331,4.144083190539577,0.15487810030844637,50,15
Europe,Belgium,11422068,2020-04-30,525,170,47859,7501,4.190046846157807,0.15673123132535155,51,15
Europe,Belgium,11422068,2020-05-01,660,93,48519,7594,4.247829727506438,0.15651600403965457,52,15
Europe,Belgium,11422068,2020-05-02,513,109,49032,7703,4.292742785281965,0.15710148474465654,53,15
Europe,Belgium,11422068,2020-05-03,485,62,49517,7765,4.335204448091186,0.15681483127006887,54,15
Europe,Belgium,11422068,2020-05-04,389,79,49906,7844,4.369261328158789,0.15717548992105157,55,15
Europe,Belgium,11422068,2020-05-05,361,80,50267,7924,4.400866813260086,0.15763821194819663,56,15
Europe,Belgium,11422068,2020-05-06,242,92,50509,8016,4.422053869754584,0.15870438931675543,57,15
Europe,Belgium,11422068,2020-05-07,272,323,50781,8339,4.445867420855838,0.1642149622890451,58,15
Europe,Belgium,11422068,2020-05-08,639,76,51420,8415,4.50181175597974,0.16365227537922988,59,15
Europe,Belgium,11422068,2020-05-09,591,106,52011,8521,4.5535536997328325,0.1638307281152064,60,15
Europe,Belgium,11422068,2020-05-10,585,60,52596,8581,4.6047703445645745,0.16314928891930947,61,15
Europe,Belgium,11422068,2020-05-11,485,75,53081,8656,4.6472320073737965,0.16307153218665812,62,15
Europe,Belgium,11422068,2020-05-12,368,51,53449,8707,4.679450341216669,0.16290295421803963,63,15
Europe,Belgium,11422068,2020-05-13,330,54,53779,8761,4.708341781890985,0.16290745458264377,64,15
Europe,Belgium,11422068,2020-05-14,202,82,53981,8843,4.726026845576476,0.1638168985383746,65,15
Europe,Belgium,11422068,2020-05-15,307,60,54288,8903,4.752904640385611,0.1639957264957265,66,15
Europe,Belgium,11422068,2020-05-16,356,56,54644,8959,4.784072376385782,0.16395212649147206,67,15
Europe,Belgium,11422068,2020-05-17,345,46,54989,9005,4.814277064363476,0.16376002473221918,68,15
Europe,Belgium,11422068,2020-05-18,291,47,55280,9052,4.839754062049009,0.16374819102749638,69,15
Europe,Belgium,11422068,2020-05-19,279,28,55559,9080,4.86418046189184,0.1634298673482244,70,15
Europe,Belgium,11422068,2020-05-20,232,28,55791,9108,4.884492020184086,0.16325213744152284,71,15
Europe,Belgium,11422068,2020-05-21,192,42,55983,9150,4.901301585667324,0.16344247360805958,72,15
Europe,Belgium,11422068,2020-05-22,252,36,56235,9186,4.923364140364074,0.16335022672712723,73,15
Europe,Belgium,11422068,2020-05-23,276,26,56511,9212,4.94752789074623,0.1630125108385978,74,15
Europe,Belgium,11422068,2020-05-24,299,25,56810,9237,4.973705286993564,0.1625946136243619,75,15
Europe,Belgium,11422068,2020-05-25,282,43,57092,9280,4.9983943362970695,0.16254466475162896,76,15
Europe,Belgium,11422068,2020-05-26,250,32,57342,9312,5.020281791353369,0.16239405671235743,77,15
Europe,Belgium,11422068,2020-05-27,113,22,57455,9334,5.030174921038817,0.16245757549386478,78,15
America,Belize,383071,2020-04-09,1,0,8,1,0.020883857039556634,0.125,0,16
America,Belize,383071,2020-04-10,1,0,9,1,0.023494339169501215,0.1111111111111111,1,16
America,Belize,383071,2020-04-11,1,1,10,2,0.026104821299445795,0.2,2,16
America,Belize,383071,2020-04-12,3,0,13,2,0.03393626768927953,0.15384615384615385,3,16
America,Belize,383071,2020-04-13,1,0,14,2,0.03654674981922411,0.14285714285714285,4,16
America,Belize,383071,2020-04-14,4,0,18,2,0.04698867833900243,0.1111111111111111,5,16
America,Belize,383071,2020-04-15,0,0,18,2,0.04698867833900243,0.1111111111111111,6,16
America,Belize,383071,2020-04-16,0,0,18,2,0.04698867833900243,0.1111111111111111,7,16
America,Belize,383071,2020-04-17,0,0,18,2,0.04698867833900243,0.1111111111111111,8,16
America,Belize,383071,2020-04-18,0,0,18,2,0.04698867833900243,0.1111111111111111,9,16
America,Belize,383071,2020-04-19,0,0,18,2,0.04698867833900243,0.1111111111111111,10,16
America,Belize,383071,2020-04-20,0,0,18,2,0.04698867833900243,0.1111111111111111,11,16
America,Belize,383071,2020-04-21,0,0,18,2,0.04698867833900243,0.1111111111111111,12,16
America,Belize,383071,2020-04-22,0,0,18,2,0.04698867833900243,0.1111111111111111,13,16
America,Belize,383071,2020-04-23,0,0,18,2,0.04698867833900243,0.1111111111111111,14,16
America,Belize,383071,2020-04-24,0,0,18,2,0.04698867833900243,0.1111111111111111,15,16
America,Belize,383071,2020-04-25,0,0,18,2,0.04698867833900243,0.1111111111111111,16,16
America,Belize,383071,2020-04-26,0,0,18,2,0.04698867833900243,0.1111111111111111,17,16
America,Belize,383071,2020-04-27,0,0,18,2,0.04698867833900243,0.1111111111111111,18,16
America,Belize,383071,2020-04-28,0,0,18,2,0.04698867833900243,0.1111111111111111,19,16
America,Belize,383071,2020-04-29,0,0,18,2,0.04698867833900243,0.1111111111111111,20,16
America,Belize,383071,2020-04-30,0,0,18,2,0.04698867833900243,0.1111111111111111,21,16
America,Belize,383071,2020-05-01,0,0,18,2,0.04698867833900243,0.1111111111111111,22,16
America,Belize,383071,2020-05-02,0,0,18,2,0.04698867833900243,0.1111111111111111,23,16
America,Belize,383071,2020-05-03,0,0,18,2,0.04698867833900243,0.1111111111111111,24,16
America,Belize,383071,2020-05-04,0,0,18,2,0.04698867833900243,0.1111111111111111,25,16
America,Belize,383071,2020-05-05,0,0,18,2,0.04698867833900243,0.1111111111111111,26,16
America,Belize,383071,2020-05-06,0,0,18,2,0.04698867833900243,0.1111111111111111,27,16
America,Belize,383071,2020-05-07,0,0,18,2,0.04698867833900243,0.1111111111111111,28,16
America,Belize,383071,2020-05-08,0,0,18,2,0.04698867833900243,0.1111111111111111,29,16
America,Belize,383071,2020-05-09,0,0,18,2,0.04698867833900243,0.1111111111111111,30,16
America,Belize,383071,2020-05-10,0,0,18,2,0.04698867833900243,0.1111111111111111,31,16
America,Belize,383071,2020-05-11,0,0,18,2,0.04698867833900243,0.1111111111111111,32,16
America,Belize,383071,2020-05-12,0,0,18,2,0.04698867833900243,0.1111111111111111,33,16
America,Belize,383071,2020-05-13,0,0,18,2,0.04698867833900243,0.1111111111111111,34,16
America,Belize,383071,2020-05-14,0,0,18,2,0.04698867833900243,0.1111111111111111,35,16
America,Belize,383071,2020-05-15,0,0,18,2,0.04698867833900243,0.1111111111111111,36,16
America,Belize,383071,2020-05-16,0,0,18,2,0.04698867833900243,0.1111111111111111,37,16
America,Belize,383071,2020-05-17,0,0,18,2,0.04698867833900243,0.1111111111111111,38,16
America,Belize,383071,2020-05-18,0,0,18,2,0.04698867833900243,0.1111111111111111,39,16
America,Belize,383071,2020-05-19,0,0,18,2,0.04698867833900243,0.1111111111111111,40,16
America,Belize,383071,2020-05-20,0,0,18,2,0.04698867833900243,0.1111111111111111,41,16
America,Belize,383071,2020-05-21,0,0,18,2,0.04698867833900243,0.1111111111111111,42,16
America,Belize,383071,2020-05-22,0,0,18,2,0.04698867833900243,0.1111111111111111,43,16
America,Belize,383071,2020-05-23,0,0,18,2,0.04698867833900243,0.1111111111111111,44,16
America,Belize,383071,2020-05-24,0,0,18,2,0.04698867833900243,0.1111111111111111,45,16
America,Belize,383071,2020-05-25,0,0,18,2,0.04698867833900243,0.1111111111111111,46,16
America,Belize,383071,2020-05-26,0,0,18,2,0.04698867833900243,0.1111111111111111,47,16
America,Belize,383071,2020-05-27,0,0,18,2,0.04698867833900243,0.1111111111111111,48,16
Asia,Bhutan,754394,2020-05-15,5,0,20,0,0.0265113455303197,0,0,17
Asia,Bhutan,754394,2020-05-16,1,0,21,0,0.027836912806835683,0,1,17
Asia,Bhutan,754394,2020-05-17,0,0,21,0,0.027836912806835683,0,2,17
Asia,Bhutan,754394,2020-05-18,0,0,21,0,0.027836912806835683,0,3,17
Asia,Bhutan,754394,2020-05-19,0,0,21,0,0.027836912806835683,0,4,17
Asia,Bhutan,754394,2020-05-20,0,0,21,0,0.027836912806835683,0,5,17
Asia,Bhutan,754394,2020-05-21,0,0,21,0,0.027836912806835683,0,6,17
Asia,Bhutan,754394,2020-05-22,0,0,21,0,0.027836912806835683,0,7,17
Asia,Bhutan,754394,2020-05-23,3,0,24,0,0.03181361463638364,0,8,17
Asia,Bhutan,754394,2020-05-24,0,0,24,0,0.03181361463638364,0,9,17
Asia,Bhutan,754394,2020-05-25,3,0,27,0,0.035790316465931594,0,10,17
Asia,Bhutan,754394,2020-05-26,0,0,27,0,0.035790316465931594,0,11,17
Asia,Bhutan,754394,2020-05-27,0,0,27,0,0.035790316465931594,0,12,17
America,Bolivia,11353142,2020-04-09,54,3,264,18,0.023253474676877998,0.06818181818181818,0,18
America,Bolivia,11353142,2020-04-10,4,1,268,19,0.02360580005077009,0.0708955223880597,1,18
America,Bolivia,11353142,2020-04-11,8,1,276,20,0.02431045079855427,0.07246376811594203,2,18
America,Bolivia,11353142,2020-04-12,24,4,300,24,0.02642440304190681,0.08,3,18
America,Bolivia,11353142,2020-04-13,30,3,330,27,0.029066843346097496,0.08181818181818182,4,18
America,Bolivia,11353142,2020-04-14,24,1,354,28,0.03118079558945004,0.07909604519774012,5,18
America,Bolivia,11353142,2020-04-15,43,0,397,28,0.034968293358790016,0.07052896725440806,6,18
America,Bolivia,11353142,2020-04-16,44,1,441,29,0.038843872471603015,0.06575963718820861,7,18
America,Bolivia,11353142,2020-04-17,24,2,465,31,0.040957824714955564,0.06666666666666667,8,18
America,Bolivia,11353142,2020-04-18,28,0,493,31,0.0434241023322002,0.06288032454361055,9,18
America,Bolivia,11353142,2020-04-19,27,1,520,32,0.04580229860597181,0.06153846153846154,10,18
America,Bolivia,11353142,2020-04-20,44,1,564,33,0.04967787771878481,0.05851063829787234,11,18
America,Bolivia,11353142,2020-04-21,34,1,598,34,0.052672643396867586,0.056856187290969896,12,18
America,Bolivia,11353142,2020-04-22,11,3,609,37,0.05364153817507083,0.060755336617405585,13,18
America,Bolivia,11353142,2020-04-23,63,3,672,40,0.05919066281387126,0.05952380952380952,14,18
America,Bolivia,11353142,2020-04-24,31,3,703,43,0.06192118446153496,0.06116642958748222,15,18
America,Bolivia,11353142,2020-04-25,104,1,807,44,0.07108164418272933,0.05452292441140025,16,18
America,Bolivia,11353142,2020-04-26,59,2,866,46,0.07627844344763766,0.053117782909930716,17,18
America,Bolivia,11353142,2020-04-27,84,4,950,50,0.08367727629937158,0.05263157894736842,18,18
America,Bolivia,11353142,2020-04-28,64,3,1014,53,0.08931448228164503,0.05226824457593689,19,18
America,Bolivia,11353142,2020-04-29,39,2,1053,55,0.09274965467709291,0.052231718898385564,20,18
America,Bolivia,11353142,2020-04-30,57,4,1110,59,0.09777029125505521,0.05315315315315315,21,18
America,Bolivia,11353142,2020-05-01,57,3,1167,62,0.10279092783301749,0.05312767780634105,22,18
America,Bolivia,11353142,2020-05-02,62,4,1229,66,0.1082519711283449,0.05370219690805533,23,18
America,Bolivia,11353142,2020-05-03,241,5,1470,71,0.12947957490534337,0.04829931972789116,24,18
America,Bolivia,11353142,2020-05-04,124,5,1594,76,0.1404016614959982,0.04767879548306148,25,18
America,Bolivia,11353142,2020-05-05,87,6,1681,82,0.14806473837815118,0.04878048780487805,26,18
America,Bolivia,11353142,2020-05-06,121,4,1802,86,0.15872258093838693,0.04772475027746948,27,18
America,Bolivia,11353142,2020-05-07,84,5,1886,91,0.16612141379012083,0.048250265111346766,28,18
America,Bolivia,11353142,2020-05-08,195,11,2081,102,0.18329727576736027,0.0490148966842864,29,18
America,Bolivia,11353142,2020-05-09,185,4,2266,106,0.19959232430986948,0.04677846425419241,30,18
America,Bolivia,11353142,2020-05-10,171,8,2437,114,0.21465423404375636,0.04677882642593353,31,18
America,Bolivia,11353142,2020-05-11,119,4,2556,118,0.22513591391704604,0.04616588419405321,32,18
America,Bolivia,11353142,2020-05-12,275,4,2831,122,0.2493582833721273,0.0430943129636171,33,18
America,Bolivia,11353142,2020-05-13,133,6,2964,128,0.26107310205403933,0.043184885290148446,34,18
America,Bolivia,11353142,2020-05-14,184,14,3148,142,0.27728006925307547,0.04510800508259212,35,18
America,Bolivia,11353142,2020-05-15,224,10,3372,152,0.29701029019103253,0.045077105575326216,36,18
America,Bolivia,11353142,2020-05-16,205,12,3577,164,0.31506696560300224,0.04584847637685211,37,18
America,Bolivia,11353142,2020-05-17,249,1,3826,165,0.33699922012778494,0.04312598013591218,38,18
America,Bolivia,11353142,2020-05-18,262,4,4088,169,0.36007653211771684,0.04134050880626223,39,18
America,Bolivia,11353142,2020-05-19,175,5,4263,174,0.37549076722549585,0.04081632653061224,40,18
America,Bolivia,11353142,2020-05-20,218,15,4481,189,0.3946925001026148,0.042178085248828386,41,18
America,Bolivia,11353142,2020-05-21,438,10,4919,199,0.4332721285437987,0.04045537710916853,42,18
America,Bolivia,11353142,2020-05-22,268,16,5187,215,0.4568779285945688,0.04144977829188355,43,18
America,Bolivia,11353142,2020-05-23,392,15,5579,230,0.4914058152359937,0.04122602616956444,44,18
America,Bolivia,11353142,2020-05-24,336,10,5915,240,0.5210011466429294,0.04057480980557904,45,18
America,Bolivia,11353142,2020-05-25,348,10,6263,250,0.5516534541715412,0.039916972696790676,46,18
America,Bolivia,11353142,2020-05-26,397,11,6660,261,0.58662174753033125,0.03918918918918919,47,18
America,Bolivia,11353142,2020-05-27,476,13,7136,274,0.62854846702349,0.038396860986547085,48,18
Europe,Bosnia And Herzegovina,3323929,2020-03-22,48,1,92,1,0.02767808819021104,0.010869565217391304,0,19
Europe,Bosnia And Herzegovina,3323929,2020-03-23,33,0,125,1,0.03760609808452587,0.008,1,19
Europe,Bosnia And Herzegovina,3323929,2020-03-24,4,0,129,1,0.0388094932232307,0.007751937984496124,2,19
Europe,Bosnia And Herzegovina,3323929,2020-03-25,33,1,162,2,0.04873750311754554,0.012345679012345678,3,19
Europe,Bosnia And Herzegovina,3323929,2020-03-26,19,1,181,3,0.05445363002639347,0.016574585635359115,4,19
Europe,Bosnia And Herzegovina,3323929,2020-03-27,0,0,181,3,0.05445363002639347,0.016574585635359115,5,19
Europe,Bosnia And Herzegovina,3323929,2020-03-28,48,0,229,3,0.0688943716908514,0.013100436681222707,6,19
Europe,Bosnia And Herzegovina,3323929,2020-03-29,28,2,257,5,0.07731813766178519,0.019455252918287938,7,19
Europe,Bosnia And Herzegovina,3323929,2020-03-30,66,1,323,6,0.09717415745041486,0.018575851393188854,8,19
Europe,Bosnia And Herzegovina,3323929,2020-03-31,30,2,353,8,0.10619962099070106,0.0226628895184136,9,19
Europe,Bosnia And Herzegovina,3323929,2020-04-01,60,4,413,12,0.12425054807127349,0.029055690072639227,10,19
Europe,Bosnia And Herzegovina,3323929,2020-04-02,51,1,464,13,0.13959383608976003,0.028017241379310345,11,19
Europe,Bosnia And Herzegovina,3323929,2020-04-03,68,4,532,17,0.1600515534477421,0.03195488721804511,12,19
Europe,Bosnia And Herzegovina,3323929,2020-04-04,54,1,586,18,0.17629738782025728,0.030716723549488054,13,19
Europe,Bosnia And Herzegovina,3323929,2020-04-05,46,3,632,21,0.1901364319153628,0.03322784810126582,14,19
Europe,Bosnia And Herzegovina,3323929,2020-04-06,31,3,663,24,0.19946274424032523,0.03619909502262444,15,19
Europe,Bosnia And Herzegovina,3323929,2020-04-07,32,4,695,28,0.20908990534996386,0.04028776978417266,16,19
Europe,Bosnia And Herzegovina,3323929,2020-04-08,86,4,781,32,0.23496290083211765,0.040973111395646605,17,19
Europe,Bosnia And Herzegovina,3323929,2020-04-09,35,3,816,35,0.24549260829578487,0.0428921568627451,18,19
Europe,Bosnia And Herzegovina,3323929,2020-04-10,59,1,875,36,0.2632426865916811,0.04114285714285714,19,19
Europe,Bosnia And Herzegovina,3323929,2020-04-11,26,1,901,37,0.2710647549932625,0.041065482796892344,20,19
Europe,Bosnia And Herzegovina,3323929,2020-04-12,47,0,948,37,0.2852046478730442,0.039029535864978905,21,19
Europe,Bosnia And Herzegovina,3323929,2020-04-13,59,1,1007,38,0.3029547261689404,0.03773584905660377,22,19
Europe,Bosnia And Herzegovina,3323929,2020-04-14,21,0,1028,38,0.30927255064714076,0.03696498054474708,23,19
Europe,Bosnia And Herzegovina,3323929,2020-04-15,45,1,1073,39,0.3228107459575701,0.036346691519105315,24,19
Europe,Bosnia And Herzegovina,3323929,2020-04-16,27,1,1100,40,0.33093366314382766,0.03636363636363636,25,19
Europe,Bosnia And Herzegovina,3323929,2020-04-17,52,1,1152,41,0.34657779994699045,0.035590277777777776,26,19
Europe,Bosnia And Herzegovina,3323929,2020-04-18,58,3,1210,44,0.36402702945821047,0.03636363636363636,27,19
Europe,Bosnia And Herzegovina,3323929,2020-04-19,44,1,1254,45,0.37726437598396356,0.03588516746411483,28,19
Europe,Bosnia And Herzegovina,3323929,2020-04-20,15,1,1269,46,0.38177710775410667,0.036249014972419225,29,19
Europe,Bosnia And Herzegovina,3323929,2020-04-21,31,2,1300,48,0.39110342007906906,0.036923076923076927,30,19
Europe,Bosnia And Herzegovina,3323929,2020-04-22,40,2,1340,50,0.40313737146611733,0.03731343283582089,31,19
Europe,Bosnia And Herzegovina,3323929,2020-04-23,27,2,1367,52,0.41126028865237496,0.038039502560351136,32,19
Europe,Bosnia And Herzegovina,3323929,2020-04-24,46,1,1413,53,0.42509933274748046,0.03750884642604388,33,19
Europe,Bosnia And Herzegovina,3323929,2020-04-25,7,1,1420,54,0.42720527424021393,0.038028169014084505,34,19
Europe,Bosnia And Herzegovina,3323929,2020-04-26,65,2,1485,56,0.44676044524416736,0.03771043771043771,35,19
Europe,Bosnia And Herzegovina,3323929,2020-04-27,31,2,1516,58,0.4560867575691298,0.03825857519788918,36,19
Europe,Bosnia And Herzegovina,3323929,2020-04-28,48,2,1564,60,0.4705274992335877,0.03836317135549872,37,19
Europe,Bosnia And Herzegovina,3323929,2020-04-29,24,2,1588,62,0.4777478700658167,0.03904282115869018,38,19
Europe,Bosnia And Herzegovina,3323929,2020-04-30,0,0,1588,62,0.4777478700658167,0.03904282115869018,39,19
Europe,Bosnia And Herzegovina,3323929,2020-05-01,101,2,1689,64,0.5081335973181136,0.037892243931320305,40,19
Europe,Bosnia And Herzegovina,3323929,2020-05-02,92,6,1781,70,0.5358116855083247,0.039303761931499155,41,19
Europe,Bosnia And Herzegovina,3323929,2020-05-03,58,2,1839,72,0.5532609150195446,0.03915171288743882,42,19
Europe,Bosnia And Herzegovina,3323929,2020-05-04,18,5,1857,77,0.5586761931437163,0.041464728056004305,43,19
Europe,Bosnia And Herzegovina,3323929,2020-05-05,69,1,1926,78,0.5794347592863747,0.040498442367601244,44,19
Europe,Bosnia And Herzegovina,3323929,2020-05-06,20,1,1946,79,0.5854517349798988,0.040596094552929084,45,19
Europe,Bosnia And Herzegovina,3323929,2020-05-07,41,7,1987,86,0.5977865351516233,0.043281328636134875,46,19
Europe,Bosnia And Herzegovina,3323929,2020-05-08,40,4,2027,90,0.6098204865386715,0.04440059200789344,47,19
Europe,Bosnia And Herzegovina,3323929,2020-05-09,43,8,2070,98,0.6227569842797485,0.04734299516908213,48,19
Europe,Bosnia And Herzegovina,3323929,2020-05-10,0,0,2070,98,0.6227569842797485,0.04734299516908213,49,19
Europe,Bosnia And Herzegovina,3323929,2020-05-11,20,4,2090,102,0.6287739599732727,0.04880382775119617,50,19
Europe,Bosnia And Herzegovina,3323929,2020-05-12,52,10,2142,112,0.6444180967764354,0.05228758169934641,51,19
Europe,Bosnia And Herzegovina,3323929,2020-05-13,16,5,2158,117,0.6492316773312546,0.05421686746987952,52,19
Europe,Bosnia And Herzegovina,3323929,2020-05-14,23,3,2181,120,0.6561511993788074,0.055020632737276476,53,19
Europe,Bosnia And Herzegovina,3323929,2020-05-15,35,3,2216,123,0.6666809068424747,0.05550541516245487,54,19
Europe,Bosnia And Herzegovina,3323929,2020-05-16,21,4,2237,127,0.672998731320675,0.05677246312025033,55,19
Europe,Bosnia And Herzegovina,3323929,2020-05-17,30,2,2267,129,0.6820241948609612,0.05690339655932951,56,19
Europe,Bosnia And Herzegovina,3323929,2020-05-18,22,3,2289,132,0.6886428681238377,0.057667103538663174,57,19
Europe,Bosnia And Herzegovina,3323929,2020-05-19,14,0,2303,132,0.6928547511093046,0.057316543638732086,58,19
Europe,Bosnia And Herzegovina,3323929,2020-05-20,16,1,2319,133,0.697668331664124,0.05735230702889176,59,19
Europe,Bosnia And Herzegovina,3323929,2020-05-21,15,2,2334,135,0.7021810634342671,0.05784061696658098,60,19
Europe,Bosnia And Herzegovina,3323929,2020-05-22,18,4,2352,139,0.7075963415584389,0.059098639455782316,61,19
Europe,Bosnia And Herzegovina,3323929,2020-05-23,20,2,2372,141,0.713613317251963,0.05944350758853288,62,19
Europe,Bosnia And Herzegovina,3323929,2020-05-24,19,0,2391,141,0.7193294441608109,0.05897114178168131,63,19
Europe,Bosnia And Herzegovina,3323929,2020-05-25,10,3,2401,144,0.722337932007573,0.059975010412328195,64,19
Europe,Bosnia And Herzegovina,3323929,2020-05-26,5,2,2406,146,0.723842175930954,0.060681629260182876,65,19
Europe,Bosnia And Herzegovina,3323929,2020-05-27,10,3,2416,149,0.7268506637777161,0.06167218543046358,66,19
America,Brazil,209469333,2020-03-30,352,22,4256,136,0.020318009987648166,0.03195488721804511,0,20
America,Brazil,209469333,2020-03-31,323,23,4579,159,0.021860001817067896,0.034723738807599915,1,20
America,Brazil,209469333,2020-04-01,1138,42,5717,201,0.027292777983877956,0.035158299807591394,2,20
America,Brazil,209469333,2020-04-02,1119,40,6836,241,0.03263484874895744,0.035254534815681686,3,20
America,Brazil,209469333,2020-04-03,1074,58,7910,299,0.03776209093099084,0.037800252844500636,4,20
America,Brazil,209469333,2020-04-04,1146,60,9056,359,0.04323305884589798,0.03964222614840989,5,20
America,Brazil,209469333,2020-04-05,1222,73,10278,432,0.049066848367727414,0.04203152364273205,6,20
America,Brazil,209469333,2020-04-06,852,54,11130,486,0.05313426954006675,0.04366576819407008,7,20
America,Brazil,209469333,2020-04-07,926,67,12056,553,0.05755496438230411,0.045869276708692765,8,20
America,Brazil,209469333,2020-04-08,1661,114,13717,667,0.06548452608096098,0.048625792811839326,9,20
America,Brazil,209469333,2020-04-09,2210,133,15927,800,0.07603499649278016,0.05022917059082062,10,20
America,Brazil,209469333,2020-04-10,1930,141,17857,941,0.08524875572120144,0.05269642157137257,11,20
America,Brazil,209469333,2020-04-11,1781,115,19638,1056,0.09375119364131455,0.05377329666972197,12,20
America,Brazil,209469333,2020-04-12,1089,68,20727,1124,0.09895004535102997,0.05422878371206639,13,20
America,Brazil,209469333,2020-04-13,1442,99,22169,1223,0.1058341079455292,0.0551671252650097,14,20
America,Brazil,209469333,2020-04-14,1261,105,23430,1328,0.1118540822393319,0.05667947076397781,15,20
America,Brazil,209469333,2020-04-15,1832,204,25262,1532,0.12059999255356392,0.06064444620378434,16,20
America,Brazil,209469333,2020-04-16,3058,204,28320,1736,0.1351987882636739,0.06129943502824859,17,20
America,Brazil,209469333,2020-04-17,2105,188,30425,1924,0.14524799198171887,0.06323746918652424,18,20
America,Brazil,209469333,2020-04-18,3257,217,33682,2141,0.16079680742574382,0.06356510896027552,19,20
America,Brazil,209469333,2020-04-19,2917,206,36599,2347,0.1747224735756427,0.06412743517582448,20,20
America,Brazil,209469333,2020-04-20,2055,115,38654,2462,0.1845329788680809,0.06369327883272106,21,20
America,Brazil,209469333,2020-04-21,1927,113,40581,2575,0.19373241619096576,0.06345334023311403,22,20
America,Brazil,209469333,2020-04-22,2498,166,43079,2741,0.20565778953427996,0.06362728939854685,23,20
America,Brazil,209469333,2020-04-23,2678,165,45757,2906,0.21844247720977847,0.0635094083965295,24,20
America,Brazil,209469333,2020-04-24,3735,407,49492,3313,0.2362732496026041,0.06694011153317708,25,20
America,Brazil,209469333,2020-04-25,3503,357,52995,3670,0.2529964613006144,0.06925181620907633,26,20
America,Brazil,209469333,2020-04-26,5514,346,58509,4016,0.2793201236765288,0.06863901280144935,27,20
America,Brazil,209469333,2020-04-27,3379,189,61888,4205,0.29545136327903426,0.06794532057911065,28,20
America,Brazil,209469333,2020-04-28,4613,338,66501,4543,0.3174736800255148,0.06831476218402731,29,20
America,Brazil,209469333,2020-04-29,5385,474,71886,5017,0.34318150046336376,0.06979105806415714,30,20
America,Brazil,209469333,2020-04-30,6276,449,78162,5466,0.37314292684552536,0.06993168035618332,31,20
America,Brazil,209469333,2020-05-01,7218,435,85380,5901,0.40760143156611855,0.0691145467322558,32,20
America,Brazil,209469333,2020-05-02,6209,428,91589,6329,0.4372430020579671,0.06910218476017863,33,20
America,Brazil,209469333,2020-05-03,4970,421,96559,6750,0.4609696255632799,0.0699054464110026,34,20
America,Brazil,209469333,2020-05-04,4588,275,101147,7025,0.482872593096957,0.06945336984784521,35,20
America,Brazil,209469333,2020-05-05,6633,296,107780,7321,0.5145383262379509,0.06792540359992577,36,20
America,Brazil,209469333,2020-05-06,6935,600,114715,7921,0.5476457978696099,0.0690493832541516,37,20
America,Brazil,209469333,2020-05-07,10503,615,125218,8536,0.5977867891525678,0.06816911306681148,38,20
America,Brazil,209469333,2020-05-08,9888,610,135106,9146,0.6449917898005624,0.06769499504093082,39,20
America,Brazil,209469333,2020-05-09,10222,751,145328,9897,0.6937912959316102,0.06810112297698998,40,20
America,Brazil,209469333,2020-05-10,10611,730,155939,10627,0.7444478758138786,0.06814844266027101,41,20
America,Brazil,209469333,2020-05-11,6760,496,162699,11123,0.7767199029559139,0.06836550931474686,42,20
America,Brazil,209469333,2020-05-12,5632,396,168331,11519,0.8036068936162604,0.06843065151398138,43,20
America,Brazil,209469333,2020-05-13,9258,881,177589,12400,0.8478042941016095,0.06982414451345523,44,20
America,Brazil,209469333,2020-05-14,11385,749,188974,13149,0.902155925612271,0.06958100056092373,45,20
America,Brazil,209469333,2020-05-15,13944,844,202918,13993,0.9687241425454866,0.06895888979784938,46,20
America,Brazil,209469333,2020-05-16,15305,824,218223,14817,1.0417897306237187,0.0678984341705503,47,20
America,Brazil,209469333,2020-05-17,14919,816,233142,15633,1.1130125668562663,0.06705355534395346,48,20
America,Brazil,209469333,2020-05-18,7938,485,241080,16118,1.150908328905597,0.06685747469719595,49,20
America,Brazil,209469333,2020-05-19,13140,674,254220,16792,1.2136382751550558,0.06605302493902919,50,20
America,Brazil,209469333,2020-05-20,17408,1179,271628,17971,1.2967435190143084,0.06616033693139146,51,20
America,Brazil,209469333,2020-05-21,19951,888,291579,18859,1.3919889647999215,0.06467886919153985,52,20
America,Brazil,209469333,2020-05-22,18508,1188,310087,20047,1.4803455740225229,0.0646495983385308,53,20
America,Brazil,209469333,2020-05-23,20803,1001,330890,21048,1.579658440980475,0.06361026322947202,54,20
America,Brazil,209469333,2020-05-24,16508,965,347398,22013,1.658467113178806,0.06336536191918203,55,20
America,Brazil,209469333,2020-05-25,15813,653,363211,22666,1.7339578772612025,0.06240449766113912,56,20
America,Brazil,209469333,2020-05-26,11687,807,374898,23473,1.7897512472625288,0.06261169704826379,57,20
America,Brazil,209469333,2020-05-27,16324,1039,391222,24512,1.8676815092546266,0.06265496316669308,58,20
Asia,Brunei Darussalam,428962,2020-03-12,10,0,11,0,0.025643297075265407,0,0,21
Asia,Brunei Darussalam,428962,2020-03-13,14,0,25,0,0.0582802206256032,0,1,21
Asia,Brunei Darussalam,428962,2020-03-14,12,0,37,0,0.08625472652589274,0,2,21
Asia,Brunei Darussalam,428962,2020-03-15,3,0,40,0,0.09324835300096511,0,3,21
Asia,Brunei Darussalam,428962,2020-03-16,10,0,50,0,0.1165604412512064,0,4,21
Asia,Brunei Darussalam,428962,2020-03-17,4,0,54,0,0.1258852765513029,0,5,21
Asia,Brunei Darussalam,428962,2020-03-18,2,0,56,0,0.13054769420135118,0,6,21
Asia,Brunei Darussalam,428962,2020-03-19,12,0,68,0,0.15852220010164073,0,7,21
Asia,Brunei Darussalam,428962,2020-03-20,5,0,73,0,0.17017824422676134,0,8,21
Asia,Brunei Darussalam,428962,2020-03-21,5,0,78,0,0.181834288351882,0,9,21
Asia,Brunei Darussalam,428962,2020-03-22,5,0,83,0,0.19349033247700262,0,10,21
Asia,Brunei Darussalam,428962,2020-03-23,5,0,88,0,0.20514637660212326,0,11,21
Asia,Brunei Darussalam,428962,2020-03-24,3,0,91,0,0.21214000307719566,0,12,21
Asia,Brunei Darussalam,428962,2020-03-25,13,0,104,0,0.24244571780250931,0,13,21
Asia,Brunei Darussalam,428962,2020-03-26,3,0,107,0,0.24943934427758171,0,14,21
Asia,Brunei Darussalam,428962,2020-03-27,7,0,114,0,0.26575780605275057,0,15,21
Asia,Brunei Darussalam,428962,2020-03-28,1,0,115,0,0.26808901487777476,0,16,21
Asia,Brunei Darussalam,428962,2020-03-29,5,1,120,1,0.27974505900289537,0.008333333333333333,17,21
Asia,Brunei Darussalam,428962,2020-03-30,6,0,126,1,0.2937323119530401,0.007936507936507936,18,21
Asia,Brunei Darussalam,428962,2020-03-31,1,0,127,1,0.2960635207780643,0.007874015748031496,19,21
Asia,Brunei Darussalam,428962,2020-04-01,2,0,129,1,0.3007259384281125,0.007751937984496124,20,21
Asia,Brunei Darussalam,428962,2020-04-02,2,0,131,1,0.3053883560781608,0.007633587786259542,21,21
Asia,Brunei Darussalam,428962,2020-04-03,2,0,133,1,0.31005077372820905,0.007518796992481203,22,21
Asia,Brunei Darussalam,428962,2020-04-04,0,0,133,1,0.31005077372820905,0.007518796992481203,23,21
Asia,Brunei Darussalam,428962,2020-04-05,2,0,135,1,0.31471319137825726,0.007407407407407408,24,21
Asia,Brunei Darussalam,428962,2020-04-06,0,0,135,1,0.31471319137825726,0.007407407407407408,25,21
Asia,Brunei Darussalam,428962,2020-04-07,0,0,135,1,0.31471319137825726,0.007407407407407408,26,21
Asia,Brunei Darussalam,428962,2020-04-08,0,0,135,1,0.31471319137825726,0.007407407407407408,27,21
Asia,Brunei Darussalam,428962,2020-04-09,0,0,135,1,0.31471319137825726,0.007407407407407408,28,21
Asia,Brunei Darussalam,428962,2020-04-10,0,0,135,1,0.31471319137825726,0.007407407407407408,29,21
Asia,Brunei Darussalam,428962,2020-04-11,1,0,136,1,0.31704440020328145,0.007352941176470588,30,21
Asia,Brunei Darussalam,428962,2020-04-12,0,0,136,1,0.31704440020328145,0.007352941176470588,31,21
Asia,Brunei Darussalam,428962,2020-04-13,0,0,136,1,0.31704440020328145,0.007352941176470588,32,21
Asia,Brunei Darussalam,428962,2020-04-14,0,0,136,1,0.31704440020328145,0.007352941176470588,33,21
Asia,Brunei Darussalam,428962,2020-04-15,0,0,136,1,0.31704440020328145,0.007352941176470588,34,21
Asia,Brunei Darussalam,428962,2020-04-16,0,0,136,1,0.31704440020328145,0.007352941176470588,35,21
Asia,Brunei Darussalam,428962,2020-04-17,0,0,136,1,0.31704440020328145,0.007352941176470588,36,21
Asia,Brunei Darussalam,428962,2020-04-18,0,0,136,1,0.31704440020328145,0.007352941176470588,37,21
Asia,Brunei Darussalam,428962,2020-04-19,1,0,137,1,0.31937560902830553,0.0072992700729927005,38,21
Asia,Brunei Darussalam,428962,2020-04-20,1,0,138,1,0.32170681785332966,0.007246376811594203,39,21
Asia,Brunei Darussalam,428962,2020-04-21,0,0,138,1,0.32170681785332966,0.007246376811594203,40,21
Asia,Brunei Darussalam,428962,2020-04-22,0,0,138,1,0.32170681785332966,0.007246376811594203,41,21
Asia,Brunei Darussalam,428962,2020-04-23,0,0,138,1,0.32170681785332966,0.007246376811594203,42,21
Asia,Brunei Darussalam,428962,2020-04-24,0,0,138,1,0.32170681785332966,0.007246376811594203,43,21
Asia,Brunei Darussalam,428962,2020-04-25,0,0,138,1,0.32170681785332966,0.007246376811594203,44,21
Asia,Brunei Darussalam,428962,2020-04-26,0,0,138,1,0.32170681785332966,0.007246376811594203,45,21
Asia,Brunei Darussalam,428962,2020-04-27,0,0,138,1,0.32170681785332966,0.007246376811594203,46,21
Asia,Brunei Darussalam,428962,2020-04-28,0,0,138,1,0.32170681785332966,0.007246376811594203,47,21
Asia,Brunei Darussalam,428962,2020-04-29,0,0,138,1,0.32170681785332966,0.007246376811594203,48,21
Asia,Brunei Darussalam,428962,2020-04-30,0,0,138,1,0.32170681785332966,0.007246376811594203,49,21
Asia,Brunei Darussalam,428962,2020-05-01,0,0,138,1,0.32170681785332966,0.007246376811594203,50,21
Asia,Brunei Darussalam,428962,2020-05-02,0,0,138,1,0.32170681785332966,0.007246376811594203,51,21
Asia,Brunei Darussalam,428962,2020-05-03,0,0,138,1,0.32170681785332966,0.007246376811594203,52,21
Asia,Brunei Darussalam,428962,2020-05-04,0,0,138,1,0.32170681785332966,0.007246376811594203,53,21
Asia,Brunei Darussalam,428962,2020-05-05,0,0,138,1,0.32170681785332966,0.007246376811594203,54,21
Asia,Brunei Darussalam,428962,2020-05-06,0,0,138,1,0.32170681785332966,0.007246376811594203,55,21
Asia,Brunei Darussalam,428962,2020-05-07,1,0,139,1,0.3240380266783538,0.007194244604316547,56,21
Asia,Brunei Darussalam,428962,2020-05-08,2,0,141,1,0.32870044432840206,0.0070921985815602835,57,21
Asia,Brunei Darussalam,428962,2020-05-09,0,0,141,1,0.32870044432840206,0.0070921985815602835,58,21
Asia,Brunei Darussalam,428962,2020-05-10,0,0,141,1,0.32870044432840206,0.0070921985815602835,59,21
Asia,Brunei Darussalam,428962,2020-05-11,0,0,141,1,0.32870044432840206,0.0070921985815602835,60,21
Asia,Brunei Darussalam,428962,2020-05-12,0,0,141,1,0.32870044432840206,0.0070921985815602835,61,21
Asia,Brunei Darussalam,428962,2020-05-13,0,0,141,1,0.32870044432840206,0.0070921985815602835,62,21
Asia,Brunei Darussalam,428962,2020-05-14,0,0,141,1,0.32870044432840206,0.0070921985815602835,63,21
Asia,Brunei Darussalam,428962,2020-05-15,0,0,141,1,0.32870044432840206,0.0070921985815602835,64,21
Asia,Brunei Darussalam,428962,2020-05-16,0,0,141,1,0.32870044432840206,0.0070921985815602835,65,21
Asia,Brunei Darussalam,428962,2020-05-17,0,0,141,1,0.32870044432840206,0.0070921985815602835,66,21
Asia,Brunei Darussalam,428962,2020-05-18,0,0,141,1,0.32870044432840206,0.0070921985815602835,67,21
Asia,Brunei Darussalam,428962,2020-05-19,0,0,141,1,0.32870044432840206,0.0070921985815602835,68,21
Asia,Brunei Darussalam,428962,2020-05-20,0,0,141,1,0.32870044432840206,0.0070921985815602835,69,21
Asia,Brunei Darussalam,428962,2020-05-21,0,0,141,1,0.32870044432840206,0.0070921985815602835,70,21
Asia,Brunei Darussalam,428962,2020-05-22,0,0,141,1,0.32870044432840206,0.0070921985815602835,71,21
Asia,Brunei Darussalam,428962,2020-05-23,0,0,141,1,0.32870044432840206,0.0070921985815602835,72,21
Asia,Brunei Darussalam,428962,2020-05-24,0,0,141,1,0.32870044432840206,0.0070921985815602835,73,21
Asia,Brunei Darussalam,428962,2020-05-25,0,0,141,1,0.32870044432840206,0.0070921985815602835,74,21
Asia,Brunei Darussalam,428962,2020-05-26,0,0,141,1,0.32870044432840206,0.0070921985815602835,75,21
Asia,Brunei Darussalam,428962,2020-05-27,0,0,141,1,0.32870044432840206,0.0070921985815602835,76,21
Europe,Bulgaria,7024216,2020-03-22,36,0,163,3,0.02320543673486123,0.018404907975460124,0,22
Europe,Bulgaria,7024216,2020-03-23,22,0,185,3,0.026337458870854768,0.016216216216216217,1,22
Europe,Bulgaria,7024216,2020-03-24,16,0,201,3,0.028615293151577344,0.014925373134328358,2,22
Europe,Bulgaria,7024216,2020-03-25,19,0,220,3,0.031320221359935396,0.013636363636363636,3,22
Europe,Bulgaria,7024216,2020-03-26,22,0,242,3,0.03445224349592894,0.012396694214876033,4,22
Europe,Bulgaria,7024216,2020-03-27,22,0,264,3,0.037584265631922485,0.011363636363636364,5,22
Europe,Bulgaria,7024216,2020-03-28,29,0,293,3,0.041712840265732146,0.010238907849829351,6,22
Europe,Bulgaria,7024216,2020-03-29,38,4,331,7,0.04712269668244826,0.021148036253776436,7,22
Europe,Bulgaria,7024216,2020-03-30,15,1,346,8,0.04925816632062568,0.023121387283236993,8,22
Europe,Bulgaria,7024216,2020-03-31,13,0,359,8,0.05110890667371276,0.022284122562674095,9,22
Europe,Bulgaria,7024216,2020-04-01,40,0,399,8,0.05680349237551921,0.020050125313283207,10,22
Europe,Bulgaria,7024216,2020-04-02,23,2,422,10,0.060077879154057906,0.023696682464454975,11,22
Europe,Bulgaria,7024216,2020-04-03,35,0,457,10,0.06506064164313854,0.02188183807439825,12,22
Europe,Bulgaria,7024216,2020-04-04,28,4,485,14,0.06904685163440304,0.0288659793814433,13,22
Europe,Bulgaria,7024216,2020-04-05,18,3,503,17,0.07160941520021594,0.033797216699801194,14,22
Europe,Bulgaria,7024216,2020-04-06,28,3,531,20,0.07559562519148044,0.03766478342749529,15,22
Europe,Bulgaria,7024216,2020-04-07,18,2,549,22,0.07815818875729334,0.04007285974499089,16,22
Europe,Bulgaria,7024216,2020-04-08,28,1,577,23,0.08214439874855785,0.03986135181975736,17,22
Europe,Bulgaria,7024216,2020-04-09,16,1,593,24,0.08442223302928041,0.04047217537942664,18,22
Europe,Bulgaria,7024216,2020-04-10,31,0,624,24,0.0888355369481804,0.038461538461538464,19,22
Europe,Bulgaria,7024216,2020-04-11,11,1,635,25,0.09040154801617717,0.03937007874015748,20,22
Europe,Bulgaria,7024216,2020-04-12,26,3,661,28,0.09410302872235136,0.04236006051437216,21,22
Europe,Bulgaria,7024216,2020-04-13,14,1,675,29,0.09609613371798362,0.04296296296296296,22,22
Europe,Bulgaria,7024216,2020-04-14,10,3,685,32,0.09751978014343524,0.04671532846715328,23,22
Europe,Bulgaria,7024216,2020-04-15,28,3,713,35,0.10150599013469973,0.04908835904628331,24,22
Europe,Bulgaria,7024216,2020-04-16,34,1,747,36,0.1063463879812352,0.04819277108433735,25,22
Europe,Bulgaria,7024216,2020-04-17,53,2,800,38,0.11389171403612873,0.0475,26,22
Europe,Bulgaria,7024216,2020-04-18,46,3,846,41,0.12044048759320614,0.04846335697399527,27,22
Europe,Bulgaria,7024216,2020-04-19,32,0,878,41,0.12499615615465128,0.04669703872437358,28,22
Europe,Bulgaria,7024216,2020-04-20,37,2,915,43,0.13026364792882222,0.046994535519125684,29,22
Europe,Bulgaria,7024216,2020-04-21,14,0,929,43,0.13225675292445446,0.04628632938643703,30,22
Europe,Bulgaria,7024216,2020-04-22,46,2,975,45,0.13880552648153188,0.046153846153846156,31,22
Europe,Bulgaria,7024216,2020-04-23,49,4,1024,49,0.14578139396624476,0.0478515625,32,22
Europe,Bulgaria,7024216,2020-04-24,73,3,1097,52,0.15617401287204152,0.04740200546946217,33,22
Europe,Bulgaria,7024216,2020-04-25,91,2,1188,54,0.16912919534365115,0.045454545454545456,34,22
Europe,Bulgaria,7024216,2020-04-26,59,1,1247,55,0.17752870925381567,0.044105854049719326,35,22
Europe,Bulgaria,7024216,2020-04-27,53,1,1300,56,0.1850740353087092,0.043076923076923075,36,22
Europe,Bulgaria,7024216,2020-04-28,63,2,1363,58,0.1940430077890543,0.0425531914893617,37,22
Europe,Bulgaria,7024216,2020-04-29,36,0,1399,58,0.1991681349206801,0.04145818441744103,38,22
Europe,Bulgaria,7024216,2020-04-30,48,6,1447,64,0.20600163776284783,0.0442294402211472,39,22
Europe,Bulgaria,7024216,2020-05-01,59,2,1506,66,0.21440115167301232,0.043824701195219126,40,22
Europe,Bulgaria,7024216,2020-05-02,82,3,1588,69,0.22607505236171552,0.04345088161209068,41,22
Europe,Bulgaria,7024216,2020-05-03,6,3,1594,72,0.2269292402169865,0.0451693851944793,42,22
Europe,Bulgaria,7024216,2020-05-04,24,1,1618,73,0.23034599163807037,0.04511742892459827,43,22
Europe,Bulgaria,7024216,2020-05-05,34,5,1652,78,0.23518638948460582,0.04721549636803874,44,22
Europe,Bulgaria,7024216,2020-05-06,37,0,1689,78,0.24045388125877679,0.046181172291296625,45,22
Europe,Bulgaria,7024216,2020-05-07,89,6,1778,84,0.2531243344452961,0.047244094488188976,46,22
Europe,Bulgaria,7024216,2020-05-08,51,0,1829,84,0.2603849312150993,0.045926735921268454,47,22
Europe,Bulgaria,7024216,2020-05-09,82,4,1911,88,0.27205883190380253,0.046049188906331764,48,22
Europe,Bulgaria,7024216,2020-05-10,44,2,1955,90,0.2783228761757896,0.04603580562659847,49,22
Europe,Bulgaria,7024216,2020-05-11,10,1,1965,91,0.27974652260124117,0.04631043256997455,50,22
Europe,Bulgaria,7024216,2020-05-12,25,2,1990,93,0.2833056386648702,0.04673366834170854,51,22
Europe,Bulgaria,7024216,2020-05-13,33,2,2023,95,0.2880036718688605,0.04695996045477014,52,22
Europe,Bulgaria,7024216,2020-05-14,46,1,2069,96,0.29455244542593795,0.04639922667955534,53,22
Europe,Bulgaria,7024216,2020-05-15,31,3,2100,99,0.2989657493448379,0.047142857142857146,54,22
Europe,Bulgaria,7024216,2020-05-16,38,3,2138,102,0.30437560576155404,0.047708138447146865,55,22
Europe,Bulgaria,7024216,2020-05-17,73,6,2211,108,0.31476822466735077,0.048846675712347354,56,22
Europe,Bulgaria,7024216,2020-05-18,24,2,2235,110,0.31818497608843466,0.049217002237136466,57,22
Europe,Bulgaria,7024216,2020-05-19,24,2,2259,112,0.3216017275095185,0.04957945993802568,58,22
Europe,Bulgaria,7024216,2020-05-20,33,4,2292,116,0.3262997607135088,0.0506108202443281,59,22
Europe,Bulgaria,7024216,2020-05-21,39,4,2331,120,0.3318519817727701,0.05148005148005148,60,22
Europe,Bulgaria,7024216,2020-05-22,41,5,2372,125,0.33768893211712164,0.05269814502529511,61,22
Europe,Bulgaria,7024216,2020-05-23,36,1,2408,126,0.34281405924874747,0.05232558139534884,62,22
Europe,Bulgaria,7024216,2020-05-24,0,0,2408,126,0.34281405924874747,0.05232558139534884,63,22
Europe,Bulgaria,7024216,2020-05-25,25,4,2433,130,0.3463731753123765,0.053431976983148374,64,22
Europe,Bulgaria,7024216,2020-05-26,0,0,2433,130,0.3463731753123765,0.053431976983148374,65,22
Europe,Bulgaria,7024216,2020-05-27,27,3,2460,133,0.35021702066109583,0.0540650406504065,66,22
Africa,Burkina Faso,19751535,2020-04-09,30,4,414,23,0.02096039624262114,0.05555555555555555,0,23
Africa,Burkina Faso,19751535,2020-04-10,29,1,443,24,0.022428636559133252,0.05417607223476298,1,23
Africa,Burkina Faso,19751535,2020-04-11,5,2,448,26,0.022681781441290513,0.05803571428571429,2,23
Africa,Burkina Faso,19751535,2020-04-12,36,1,484,27,0.024504424592822784,0.05578512396694215,3,23
Africa,Burkina Faso,19751535,2020-04-13,13,0,497,27,0.025162601286431663,0.05432595573440644,4,23
Africa,Burkina Faso,19751535,2020-04-14,18,1,515,28,0.0260739228621978,0.05436893203883495,5,23
Africa,Burkina Faso,19751535,2020-04-15,13,2,528,30,0.026732099555806674,0.056818181818181816,6,23
Africa,Burkina Faso,19751535,2020-04-16,14,2,542,32,0.027440905225847002,0.05904059040590406,7,23
Africa,Burkina Faso,19751535,2020-04-17,1,0,543,32,0.027491534202278456,0.058931860036832415,8,23
Africa,Burkina Faso,19751535,2020-04-18,14,3,557,35,0.028200339872318785,0.06283662477558348,9,23
Africa,Burkina Faso,19751535,2020-04-19,8,1,565,36,0.0286053716837704,0.06371681415929203,10,23
Africa,Burkina Faso,19751535,2020-04-20,11,0,576,36,0.02916229042451637,0.0625,11,23
Africa,Burkina Faso,19751535,2020-04-21,5,2,581,38,0.029415435306673635,0.06540447504302926,12,23
Africa,Burkina Faso,19751535,2020-04-22,19,0,600,38,0.030377385858871224,0.06333333333333334,13,23
Africa,Burkina Faso,19751535,2020-04-23,9,1,609,39,0.030833046646754292,0.06403940886699508,14,23
Africa,Burkina Faso,19751535,2020-04-24,7,2,616,41,0.031187449481774456,0.06655844155844155,15,23
Africa,Burkina Faso,19751535,2020-04-25,10,0,626,41,0.031693739246088974,0.06549520766773163,16,23
Africa,Burkina Faso,19751535,2020-04-26,3,0,629,41,0.031845626175383335,0.06518282988871224,17,23
Africa,Burkina Faso,19751535,2020-04-27,3,1,632,42,0.03199751310467769,0.06645569620253164,18,23
Africa,Burkina Faso,19751535,2020-04-28,3,0,635,42,0.03214940003397205,0.06614173228346457,19,23
Africa,Burkina Faso,19751535,2020-04-29,3,0,638,42,0.032301286963266396,0.06583072100313479,20,23
Africa,Burkina Faso,19751535,2020-04-30,3,1,641,43,0.032453173892560756,0.06708268330733229,21,23
Africa,Burkina Faso,19751535,2020-05-01,4,0,645,43,0.032655689798286563,0.06666666666666667,22,23
Africa,Burkina Faso,19751535,2020-05-02,4,1,649,44,0.03285820570401237,0.06779661016949153,23,23
Africa,Burkina Faso,19751535,2020-05-03,3,0,652,44,0.03301009263330673,0.06748466257668712,24,23
Africa,Burkina Faso,19751535,2020-05-04,10,1,662,45,0.033516382397621246,0.06797583081570997,25,23
Africa,Burkina Faso,19751535,2020-05-05,10,1,672,46,0.034022672161935774,0.06845238095238096,26,23
Africa,Burkina Faso,19751535,2020-05-06,16,2,688,48,0.034832735784839,0.06976744186046512,27,23
Africa,Burkina Faso,19751535,2020-05-07,41,0,729,48,0.036908523818528535,0.06584362139917696,28,23
Africa,Burkina Faso,19751535,2020-05-08,7,0,736,48,0.037262926653548696,0.06521739130434782,29,23
Africa,Burkina Faso,19751535,2020-05-09,8,0,744,48,0.03766795846500032,0.06451612903225806,30,23
Africa,Burkina Faso,19751535,2020-05-10,4,0,748,48,0.037870474370726125,0.06417112299465241,31,23
Africa,Burkina Faso,19751535,2020-05-11,3,1,751,49,0.03802236130002048,0.06524633821571238,32,23
Africa,Burkina Faso,19751535,2020-05-12,9,1,760,50,0.038478022087903546,0.06578947368421052,33,23
Africa,Burkina Faso,19751535,2020-05-13,6,1,766,51,0.03878179594649226,0.06657963446475196,34,23
Africa,Burkina Faso,19751535,2020-05-14,7,0,773,51,0.03913619878151242,0.06597671410090557,35,23
Africa,Burkina Faso,19751535,2020-05-15,0,0,773,51,0.03913619878151242,0.06597671410090557,36,23
Africa,Burkina Faso,19751535,2020-05-16,9,0,782,51,0.039591859569395496,0.06521739130434782,37,23
Africa,Burkina Faso,19751535,2020-05-17,0,0,782,51,0.039591859569395496,0.06521739130434782,38,23
Africa,Burkina Faso,19751535,2020-05-18,14,0,796,51,0.04030066523943582,0.06407035175879397,39,23
Africa,Burkina Faso,19751535,2020-05-19,0,0,796,51,0.04030066523943582,0.06407035175879397,40,23
Africa,Burkina Faso,19751535,2020-05-20,10,1,806,52,0.040806955003750346,0.06451612903225806,41,23
Africa,Burkina Faso,19751535,2020-05-21,3,0,809,52,0.04095884193304469,0.06427688504326329,42,23
Africa,Burkina Faso,19751535,2020-05-22,3,0,812,52,0.041110728862339053,0.06403940886699508,43,23
Africa,Burkina Faso,19751535,2020-05-23,2,0,814,52,0.041211986815201954,0.06388206388206388,44,23
Africa,Burkina Faso,19751535,2020-05-24,0,0,814,52,0.041211986815201954,0.06388206388206388,45,23
Africa,Burkina Faso,19751535,2020-05-25,18,0,832,52,0.042123308390968096,0.0625,46,23
Africa,Burkina Faso,19751535,2020-05-26,9,0,841,52,0.042578969178851164,0.06183115338882283,47,23
Africa,Burkina Faso,19751535,2020-05-27,4,1,845,53,0.04278148508457697,0.06272189349112427,48,23
Africa,Cameroon,25216237,2020-04-04,238,1,509,8,0.020185406728212462,0.015717092337917484,0,24
Africa,Cameroon,25216237,2020-04-05,46,1,555,9,0.022009628161410444,0.016216216216216217,1,24
Africa,Cameroon,25216237,2020-04-06,95,0,650,9,0.02577704199084106,0.013846153846153847,2,24
Africa,Cameroon,25216237,2020-04-07,8,0,658,9,0.026094297892266798,0.013677811550151976,3,24
Africa,Cameroon,25216237,2020-04-08,27,0,685,9,0.027165036559578654,0.013138686131386862,4,24
Africa,Cameroon,25216237,2020-04-09,45,1,730,10,0.02894960100509842,0.0136986301369863,5,24
Africa,Cameroon,25216237,2020-04-10,0,0,730,10,0.02894960100509842,0.0136986301369863,6,24
Africa,Cameroon,25216237,2020-04-11,73,0,803,10,0.03184456110560826,0.012453300124533,7,24
Africa,Cameroon,25216237,2020-04-12,17,1,820,11,0.03251872989613795,0.013414634146341463,8,24
Africa,Cameroon,25216237,2020-04-13,0,1,820,12,0.03251872989613795,0.014634146341463415,9,24
Africa,Cameroon,25216237,2020-04-14,0,0,820,12,0.03251872989613795,0.014634146341463415,10,24
Africa,Cameroon,25216237,2020-04-15,35,5,855,17,0.03390672446487555,0.019883040935672516,11,24
Africa,Cameroon,25216237,2020-04-16,0,0,855,17,0.03390672446487555,0.019883040935672516,12,24
Africa,Cameroon,25216237,2020-04-17,0,4,855,21,0.03390672446487555,0.02456140350877193,13,24
Africa,Cameroon,25216237,2020-04-18,161,0,1016,21,0.04029149948106849,0.02066929133858268,14,24
Africa,Cameroon,25216237,2020-04-19,0,0,1016,21,0.04029149948106849,0.02066929133858268,15,24
Africa,Cameroon,25216237,2020-04-20,0,21,1016,42,0.04029149948106849,0.04133858267716536,16,24
Africa,Cameroon,25216237,2020-04-21,1,0,1017,42,0.0403311564687467,0.04129793510324484,17,24
Africa,Cameroon,25216237,2020-04-22,146,0,1163,42,0.04612107666976639,0.03611349957007739,18,24
Africa,Cameroon,25216237,2020-04-23,0,1,1163,43,0.04612107666976639,0.03697334479793637,19,24
Africa,Cameroon,25216237,2020-04-24,238,6,1401,49,0.05555943973718204,0.03497501784439686,20,24
Africa,Cameroon,25216237,2020-04-25,2,0,1403,49,0.05563875371253847,0.03492516037063435,21,24
Africa,Cameroon,25216237,2020-04-26,115,4,1518,53,0.06019930729553343,0.03491436100131752,22,24
Africa,Cameroon,25216237,2020-04-27,103,3,1621,56,0.06428397702638979,0.03454657618753856,23,24
Africa,Cameroon,25216237,2020-04-28,0,2,1621,58,0.06428397702638979,0.03578038247995065,24,24
Africa,Cameroon,25216237,2020-04-29,185,1,1806,59,0.07162051974685993,0.032668881506090805,25,24
Africa,Cameroon,25216237,2020-04-30,26,2,1832,61,0.07265160142649357,0.03329694323144105,26,24
Africa,Cameroon,25216237,2020-05-01,0,0,1832,61,0.07265160142649357,0.03329694323144105,27,24
Africa,Cameroon,25216237,2020-05-02,237,0,2069,61,0.08205030750623102,0.029482841952634124,28,24
Africa,Cameroon,25216237,2020-05-03,8,3,2077,64,0.08236756340765675,0.030813673567645642,29,24
Africa,Cameroon,25216237,2020-05-04,0,0,2077,64,0.08236756340765675,0.030813673567645642,30,24
Africa,Cameroon,25216237,2020-05-05,27,0,2104,64,0.0834383020749686,0.030418250950570342,31,24
Africa,Cameroon,25216237,2020-05-06,0,0,2104,64,0.0834383020749686,0.030418250950570342,32,24
Africa,Cameroon,25216237,2020-05-07,161,44,2265,108,0.08982307709116154,0.04768211920529802,33,24
Africa,Cameroon,25216237,2020-05-08,0,0,2265,108,0.08982307709116154,0.04768211920529802,34,24
Africa,Cameroon,25216237,2020-05-09,0,0,2265,108,0.08982307709116154,0.04768211920529802,35,24
Africa,Cameroon,25216237,2020-05-10,9,0,2274,108,0.0901799899802655,0.047493403693931395,36,24
Africa,Cameroon,25216237,2020-05-11,305,6,2579,114,0.10227537122212167,0.04420317952694843,37,24
Africa,Cameroon,25216237,2020-05-12,110,11,2689,125,0.10663763986672556,0.04648568240981778,38,24
Africa,Cameroon,25216237,2020-05-13,0,0,2689,125,0.10663763986672556,0.04648568240981778,39,24
Africa,Cameroon,25216237,2020-05-14,111,11,2800,136,0.11103956549900763,0.04857142857142857,40,24
Africa,Cameroon,25216237,2020-05-15,154,3,2954,139,0.11714674160145307,0.04705484089370345,41,24
Africa,Cameroon,25216237,2020-05-16,151,1,3105,140,0.12313494674086382,0.04508856682769726,42,24
Africa,Cameroon,25216237,2020-05-17,187,0,3292,140,0.13055080343669043,0.0425273390036452,43,24
Africa,Cameroon,25216237,2020-05-18,0,0,3292,140,0.13055080343669043,0.0425273390036452,44,24
Africa,Cameroon,25216237,2020-05-19,0,0,3292,140,0.13055080343669043,0.0425273390036452,45,24
Africa,Cameroon,25216237,2020-05-20,237,0,3529,140,0.13994950951642784,0.03967129498441485,46,24
Africa,Cameroon,25216237,2020-05-21,204,6,3733,146,0.1480395350027841,0.039110634878114114,47,24
Africa,Cameroon,25216237,2020-05-22,555,10,4288,156,0.17004916316419455,0.036380597014925374,48,24
Africa,Cameroon,25216237,2020-05-23,112,3,4400,159,0.17449074578415485,0.03613636363636363,49,24
Africa,Cameroon,25216237,2020-05-24,197,0,4597,159,0.18230317235676363,0.03458777463563193,50,24
Africa,Cameroon,25216237,2020-05-25,293,6,4890,165,0.1939226697464812,0.03374233128834356,51,24
Africa,Cameroon,25216237,2020-05-26,154,6,5044,171,0.20002984584892664,0.03390166534496431,52,24
Africa,Cameroon,25216237,2020-05-27,318,4,5362,175,0.21264076793059963,0.03263707571801567,53,24
America,Canada,37058856,2020-03-20,156,1,846,10,0.022828551426412082,0.01182033096926714,0,25
America,Canada,37058856,2020-03-21,125,2,971,12,0.026201564344026162,0.012358393408856848,1,25
America,Canada,37058856,2020-03-22,331,6,1302,18,0.03513330254986824,0.013824884792626729,2,25
America,Canada,37058856,2020-03-23,128,2,1430,20,0.03858726777750506,0.013986013986013986,3,25
America,Canada,37058856,2020-03-24,216,4,1646,24,0.04441583409914219,0.014580801944106925,4,25
America,Canada,37058856,2020-03-25,313,3,1959,27,0.052861858444847844,0.013782542113323124,5,25
America,Canada,37058856,2020-03-26,1426,8,3385,35,0.09134118980898925,0.0103397341211226,6,25
America,Canada,37058856,2020-03-27,633,4,4018,39,0.10842212722378694,0.009706321553011448,7,25
America,Canada,37058856,2020-03-28,657,14,4675,53,0.12615068311876654,0.011336898395721925,8,25
America,Canada,37058856,2020-03-29,711,7,5386,60,0.14533638059415543,0.011139992573338284,9,25
America,Canada,37058856,2020-03-30,869,1,6255,61,0.1687855663974085,0.009752198241406874,10,25
America,Canada,37058856,2020-03-31,1169,28,7424,89,0.20032998320293535,0.011988146551724138,11,25
America,Canada,37058856,2020-04-01,1112,7,8536,96,0.2303363061180302,0.011246485473289597,12,25
America,Canada,37058856,2020-04-02,1059,13,9595,109,0.2589124715560567,0.011360083376758728,13,25
America,Canada,37058856,2020-04-03,1673,29,11268,138,0.30405687644540347,0.012247071352502662,14,25
America,Canada,37058856,2020-04-04,1251,49,12519,187,0.3378139897248852,0.014937295311127087,15,25
America,Canada,37058856,2020-04-05,1363,44,13882,231,0.3745933225785491,0.01664025356576862,16,25
America,Canada,37058856,2020-04-06,1614,49,15496,280,0.4181456653707821,0.018069179143004648,17,25
America,Canada,37058856,2020-04-07,1157,43,16653,323,0.449366272936218,0.01939590464180628,18,25
America,Canada,37058856,2020-04-08,1230,57,17883,380,0.4825567200455405,0.021249231113347873,19,25
America,Canada,37058856,2020-04-09,1391,55,19274,435,0.52009160779275,0.022569264293867387,20,25
America,Canada,37058856,2020-04-10,1474,74,20748,509,0.5598661761172552,0.02453248505880085,21,25
America,Canada,37058856,2020-04-11,1385,60,22133,569,0.5972391592444193,0.025708218497266525,22,25
America,Canada,37058856,2020-04-12,1168,84,23301,653,0.6287565919466052,0.028024548302647955,23,25
America,Canada,37058856,2020-04-13,1064,64,24365,717,0.6574676779013362,0.029427457418428074,24,25
America,Canada,37058856,2020-04-14,1298,63,25663,780,0.6924930440378407,0.030393952382807933,25,25
America,Canada,37058856,2020-04-15,1383,123,27046,903,0.729812058958323,0.03338756193152407,26,25
America,Canada,37058856,2020-04-16,1318,107,28364,1010,0.7653771071616458,0.03560851783951488,27,25
America,Canada,37058856,2020-04-17,1717,183,30081,1193,0.8117088125979928,0.03965958578504704,28,25
America,Canada,37058856,2020-04-18,1791,116,31872,1309,0.8600373416815673,0.04107053212851405,29,25
America,Canada,37058856,2020-04-19,1469,158,33341,1467,0.8996769894893679,0.043999880027593655,30,25
America,Canada,37058856,2020-04-20,1436,113,34777,1580,0.9384261618869185,0.045432325962561464,31,25
America,Canada,37058856,2020-04-21,2046,110,36823,1690,0.9936356373224257,0.04589522852564973,32,25
America,Canada,37058856,2020-04-22,1590,144,38413,1834,1.0365403616344768,0.04774425324759847,33,25
America,Canada,37058856,2020-04-23,1766,140,40179,1974,1.0841942881345286,0.04913014261181214,34,25
America,Canada,37058856,2020-04-24,1920,172,42099,2146,1.1360037665490808,0.05097508254352835,35,25
America,Canada,37058856,2020-04-25,1778,156,43877,2302,1.1839815022892235,0.05246484490735465,36,25
America,Canada,37058856,2020-04-26,1464,163,45341,2465,1.2234862295803195,0.05436580578284555,37,25
America,Canada,37058856,2020-04-27,1543,95,46884,2560,1.2651227010353476,0.05460284958621278,38,25
America,Canada,37058856,2020-04-28,1605,147,48489,2707,1.3084321868975124,0.05582709480500732,39,25
America,Canada,37058856,2020-04-29,1526,152,50015,2859,1.349609928595745,0.0571628511446566,40,25
America,Canada,37058856,2020-04-30,1572,137,51587,2996,1.3920289390476597,0.0580766472173222,41,25
America,Canada,37058856,2020-05-01,1649,188,53236,3184,1.4365257254568247,0.059809151701855884,42,25
America,Canada,37058856,2020-05-02,1825,207,55061,3391,1.4857717140539903,0.06158624071484354,43,25
America,Canada,37058856,2020-05-03,1653,175,56714,3566,1.530376436876519,0.06287689106746129,44,25
America,Canada,37058856,2020-05-04,2760,116,59474,3682,1.6048525620974377,0.06190940579076571,45,25
America,Canada,37058856,2020-05-05,1298,172,60772,3854,1.6398779282339422,0.06341736325939577,46,25
America,Canada,37058856,2020-05-06,1274,189,62046,4043,1.674255675890265,0.06516133191503079,47,25
America,Canada,37058856,2020-05-07,1450,189,63496,4232,1.7133826257345883,0.0666498677082021,48,25
America,Canada,37058856,2020-05-08,1426,176,64922,4408,1.7518619570987297,0.0678968608484027,49,25
America,Canada,37058856,2020-05-09,1512,161,66434,4569,1.7926619213501895,0.06877502483668001,50,25
America,Canada,37058856,2020-05-10,1268,124,67702,4693,1.8268777643864669,0.06931848394434434,51,25
America,Canada,37058856,2020-05-11,1146,178,68848,4871,1.8578015468151527,0.0707500580990007,52,25
America,Canada,37058856,2020-05-12,1133,122,69981,4993,1.8883745359004067,0.0713479372972664,53,25
America,Canada,37058856,2020-05-13,1176,176,71157,5169,1.92010784142932,0.0726421855896117,54,25
America,Canada,37058856,2020-05-14,1121,135,72278,5304,1.950357021274483,0.07338332549323445,55,25
America,Canada,37058856,2020-05-15,1123,168,73401,5472,1.9806601693263277,0.07454939306004005,56,25
America,Canada,37058856,2020-05-16,1201,90,74602,5562,2.013068077438764,0.07455564193989438,57,25
America,Canada,37058856,2020-05-17,1251,117,75853,5679,2.0468251907182453,0.07486849564288822,58,25
America,Canada,37058856,2020-05-18,1138,103,76991,5782,2.0775331003202044,0.07509968697639983,59,25
America,Canada,37058856,2020-05-19,1070,60,78061,5842,2.1064060908949807,0.07483890803346101,60,25
America,Canada,37058856,2020-05-20,1040,70,79101,5912,2.13446955836953,0.07473988950835009,61,25
America,Canada,37058856,2020-05-21,990,118,80091,6030,2.1611838206770333,0.07528935835487133,62,25
America,Canada,37058856,2020-05-22,1222,122,81313,6152,2.194158394959629,0.07565825882700183,63,25
America,Canada,37058856,2020-05-23,1156,98,82469,6250,2.2253520184217237,0.07578605294110514,64,25
America,Canada,37058856,2020-05-24,1141,105,83610,6355,2.256140880333705,0.07600765458677192,65,25
America,Canada,37058856,2020-05-25,1078,69,84688,6424,2.2852297437352087,0.07585490270168146,66,25
America,Canada,37058856,2020-05-26,1012,121,85700,6545,2.3125376563162123,0.0763710618436406,67,25
America,Canada,37058856,2020-05-27,936,94,86636,6639,2.3377947770433067,0.07663096172491805,68,25
Africa,Cape Verde,543767,2020-04-15,1,0,11,1,0.020229252602677248,0.09090909090909091,0,26
Africa,Cape Verde,543767,2020-04-16,44,0,55,1,0.10114626301338625,0.01818181818181818,1,26
Africa,Cape Verde,543767,2020-04-17,0,0,55,1,0.10114626301338625,0.01818181818181818,2,26
Africa,Cape Verde,543767,2020-04-18,1,0,56,1,0.102985285977266,0.017857142857142856,3,26
Africa,Cape Verde,543767,2020-04-19,2,0,58,1,0.1066633319050255,0.017241379310344827,4,26
Africa,Cape Verde,543767,2020-04-20,3,0,61,1,0.11218040079666475,0.01639344262295082,5,26
Africa,Cape Verde,543767,2020-04-21,6,0,67,1,0.12321453857994324,0.014925373134328358,6,26
Africa,Cape Verde,543767,2020-04-22,0,0,67,1,0.12321453857994324,0.014925373134328358,7,26
Africa,Cape Verde,543767,2020-04-23,6,0,73,1,0.13424867636322177,0.0136986301369863,8,26
Africa,Cape Verde,543767,2020-04-24,9,0,82,1,0.15079988303813952,0.012195121951219513,9,26
Africa,Cape Verde,543767,2020-04-25,6,0,88,1,0.16183402082141798,0.011363636363636364,10,26
Africa,Cape Verde,543767,2020-04-26,2,0,90,1,0.16551206674917748,0.011111111111111112,11,26
Africa,Cape Verde,543767,2020-04-27,16,0,106,1,0.1949364341712535,0.009433962264150943,12,26
Africa,Cape Verde,543767,2020-04-28,3,0,109,1,0.20045350306289272,0.009174311926605505,13,26
Africa,Cape Verde,543767,2020-04-29,4,0,113,1,0.20780959491841175,0.008849557522123894,14,26
Africa,Cape Verde,543767,2020-04-30,0,0,113,1,0.20780959491841175,0.008849557522123894,15,26
Africa,Cape Verde,543767,2020-05-01,8,0,121,1,0.22252177862944975,0.008264462809917356,16,26
Africa,Cape Verde,543767,2020-05-02,2,1,123,2,0.22619982455720924,0.016260162601626018,17,26
Africa,Cape Verde,543767,2020-05-03,29,0,152,2,0.279531490509722,0.013157894736842105,18,26
Africa,Cape Verde,543767,2020-05-04,13,0,165,2,0.30343878904015875,0.012121212121212121,19,26
Africa,Cape Verde,543767,2020-05-05,10,0,175,2,0.32182901867895625,0.011428571428571429,20,26
Africa,Cape Verde,543767,2020-05-06,11,0,186,2,0.3420582712816335,0.010752688172043012,21,26
Africa,Cape Verde,543767,2020-05-07,5,0,191,2,0.3512533861010323,0.010471204188481676,22,26
Africa,Cape Verde,543767,2020-05-08,27,0,218,2,0.40090700612578545,0.009174311926605505,23,26
Africa,Cape Verde,543767,2020-05-09,12,0,230,2,0.4229752816923425,0.008695652173913044,24,26
Africa,Cape Verde,543767,2020-05-10,6,0,236,2,0.434009419475621,0.00847457627118644,25,26
Africa,Cape Verde,543767,2020-05-11,10,0,246,2,0.4523996491144185,0.008130081300813009,26,26
Africa,Cape Verde,543767,2020-05-12,14,0,260,2,0.478145970608735,0.007692307692307693,27,26
Africa,Cape Verde,543767,2020-05-13,10,0,270,2,0.49653620024753253,0.007407407407407408,28,26
Africa,Cape Verde,543767,2020-05-14,19,0,289,2,0.5314776365612478,0.006920415224913495,29,26
Africa,Cape Verde,543767,2020-05-15,26,0,315,2,0.5792922336221212,0.006349206349206349,30,26
Africa,Cape Verde,543767,2020-05-16,11,0,326,2,0.5995214862247985,0.006134969325153374,31,26
Africa,Cape Verde,543767,2020-05-17,2,1,328,3,0.6031995321525581,0.009146341463414634,32,26
Africa,Cape Verde,543767,2020-05-18,0,0,328,3,0.6031995321525581,0.009146341463414634,33,26
Africa,Cape Verde,543767,2020-05-19,0,0,328,3,0.6031995321525581,0.009146341463414634,34,26
Africa,Cape Verde,543767,2020-05-20,7,0,335,3,0.6160726928997163,0.008955223880597015,35,26
Africa,Cape Verde,543767,2020-05-21,14,0,349,3,0.6418190143940327,0.008595988538681949,36,26
Africa,Cape Verde,543767,2020-05-22,7,0,356,3,0.6546921751411909,0.008426966292134831,37,26
Africa,Cape Verde,543767,2020-05-23,6,0,362,3,0.6657263129244695,0.008287292817679558,38,26
Africa,Cape Verde,543767,2020-05-24,9,0,371,3,0.6822775195993872,0.008086253369272238,39,26
Africa,Cape Verde,543767,2020-05-25,9,0,380,3,0.698828726274305,0.007894736842105263,40,26
Africa,Cape Verde,543767,2020-05-26,10,0,390,3,0.7172189559131025,0.007692307692307693,41,26
Africa,Cape Verde,543767,2020-05-27,0,1,390,4,0.7172189559131025,0.010256410256410256,42,26
Africa,Central African Republic,4666377,2020-05-05,22,0,94,0,0.020144107516387982,0,0,27
Africa,Central African Republic,4666377,2020-05-06,0,0,94,0,0.020144107516387982,0,1,27
Africa,Central African Republic,4666377,2020-05-07,0,0,94,0,0.020144107516387982,0,2,27
Africa,Central African Republic,4666377,2020-05-08,0,0,94,0,0.020144107516387982,0,3,27
Africa,Central African Republic,4666377,2020-05-09,49,0,143,0,0.03064475930684555,0,4,27
Africa,Central African Republic,4666377,2020-05-10,0,0,143,0,0.03064475930684555,0,5,27
Africa,Central African Republic,4666377,2020-05-11,36,0,179,0,0.03835952388758988,0,6,27
Africa,Central African Republic,4666377,2020-05-12,0,0,179,0,0.03835952388758988,0,7,27
Africa,Central African Republic,4666377,2020-05-13,0,0,179,0,0.03835952388758988,0,8,27
Africa,Central African Republic,4666377,2020-05-14,18,0,197,0,0.042216906177962046,0,9,27
Africa,Central African Republic,4666377,2020-05-15,24,0,221,0,0.04736008256512494,0,10,27
Africa,Central African Republic,4666377,2020-05-16,80,0,301,0,0.06450400385566789,0,11,27
Africa,Central African Republic,4666377,2020-05-17,26,0,327,0,0.07007577827509437,0,12,27
Africa,Central African Republic,4666377,2020-05-18,0,0,327,0,0.07007577827509437,0,13,27
Africa,Central African Republic,4666377,2020-05-19,9,0,336,0,0.07200446942028045,0,14,27
Africa,Central African Republic,4666377,2020-05-20,75,0,411,0,0.08807689563016448,0,15,27
Africa,Central African Republic,4666377,2020-05-21,0,0,411,0,0.08807689563016448,0,16,27
Africa,Central African Republic,4666377,2020-05-22,25,0,436,0,0.09343437103345915,0,17,27
Africa,Central African Republic,4666377,2020-05-23,43,0,479,0,0.102649228727126,0,18,27
Africa,Central African Republic,4666377,2020-05-24,73,1,552,1,0.11829305690474645,0.0018115942028985507,19,27
Africa,Central African Republic,4666377,2020-05-25,52,0,604,1,0.1294366057435994,0.0016556291390728477,20,27
Africa,Central African Republic,4666377,2020-05-26,48,0,652,1,0.13972295851792513,0.0015337423312883436,21,27
Africa,Central African Republic,4666377,2020-05-27,19,0,671,1,0.1437946398244291,0.0014903129657228018,22,27
Africa,Chad,15477751,2020-05-10,62,3,322,31,0.02080405609316237,0.09627329192546584,0,28
Africa,Chad,15477751,2020-05-11,0,0,322,31,0.02080405609316237,0.09627329192546584,1,28
Africa,Chad,15477751,2020-05-12,0,0,322,31,0.02080405609316237,0.09627329192546584,2,28
Africa,Chad,15477751,2020-05-13,35,9,357,40,0.023065366538071324,0.11204481792717087,3,28
Africa,Chad,15477751,2020-05-14,15,2,372,42,0.02403449958588945,0.11290322580645161,4,28
Africa,Chad,15477751,2020-05-15,27,4,399,46,0.025778939071962072,0.11528822055137844,5,28
Africa,Chad,15477751,2020-05-16,29,2,428,48,0.027652596297743772,0.11214953271028037,6,28
Africa,Chad,15477751,2020-05-17,46,2,474,50,0.030624604311052687,0.10548523206751055,7,28
Africa,Chad,15477751,2020-05-18,29,3,503,53,0.03249826153683439,0.10536779324055666,8,28
Africa,Chad,15477751,2020-05-19,16,0,519,53,0.033532003454507055,0.10211946050096339,9,28
Africa,Chad,15477751,2020-05-20,26,3,545,56,0.03521183407072513,0.10275229357798166,10,28
Africa,Chad,15477751,2020-05-21,20,1,565,57,0.03650401146781596,0.10088495575221239,11,28
Africa,Chad,15477751,2020-05-22,23,1,588,58,0.037990015474470416,0.09863945578231292,12,28
Africa,Chad,15477751,2020-05-23,23,1,611,59,0.03947601948112488,0.09656301145662848,13,28
Africa,Chad,15477751,2020-05-24,37,1,648,60,0.04186654766574291,0.09259259259259259,14,28
Africa,Chad,15477751,2020-05-25,27,0,675,60,0.04361098715181553,0.08888888888888889,15,28
Africa,Chad,15477751,2020-05-26,12,1,687,61,0.044386293590070035,0.08879184861717612,16,28
Africa,Chad,15477751,2020-05-27,13,1,700,62,0.04522620889817907,0.08857142857142856,17,28
America,Chile,18729160,2020-03-21,92,0,434,0,0.023172422041351563,0,0,29
America,Chile,18729160,2020-03-22,103,0,537,0,0.02867186782535896,0,1,29
America,Chile,18729160,2020-03-23,95,1,632,1,0.03374417218924928,0.0015822784810126582,2,29
America,Chile,18729160,2020-03-24,114,1,746,2,0.039830937425917666,0.002680965147453083,3,29
America,Chile,18729160,2020-03-25,176,0,922,2,0.0492280486684934,0.0021691973969631237,4,29
America,Chile,18729160,2020-03-26,220,1,1142,3,0.06097443772171309,0.002626970227670753,5,29
America,Chile,18729160,2020-03-27,164,1,1306,4,0.06973083683411321,0.0030627871362940277,6,29
America,Chile,18729160,2020-03-28,304,1,1610,5,0.08596221079856224,0.003105590062111801,7,29
America,Chile,18729160,2020-03-29,299,1,1909,6,0.10192662137543808,0.003143006809848088,8,29
America,Chile,18729160,2020-03-30,230,1,2139,7,0.11420693720380412,0.0032725572697522207,9,29
America,Chile,18729160,2020-03-31,310,1,2449,8,0.13075866723334095,0.0032666394446712946,10,29
America,Chile,18729160,2020-04-01,289,4,2738,12,0.14618915103507046,0.004382761139517896,11,29
America,Chile,18729160,2020-04-02,293,4,3031,16,0.16183320554685848,0.005278785879247773,12,29
America,Chile,18729160,2020-04-03,373,2,3404,18,0.1817486742598173,0.005287896592244419,13,29
America,Chile,18729160,2020-04-04,333,4,3737,22,0.19952843587219074,0.005887075194005887,14,29
America,Chile,18729160,2020-04-05,424,5,4161,27,0.22216693113839595,0.006488824801730353,15,29
America,Chile,18729160,2020-04-06,310,7,4471,34,0.23871866116793278,0.0076045627376425855,16,29
America,Chile,18729160,2020-04-07,344,3,4815,37,0.2570857422329672,0.0076843198338525445,17,29
America,Chile,18729160,2020-04-08,301,6,5116,43,0.2731569381648723,0.008405003909304144,18,29
America,Chile,18729160,2020-04-09,430,5,5546,48,0.29611578949616535,0.00865488640461594,19,29
America,Chile,18729160,2020-04-10,426,9,5972,57,0.31886107011739984,0.009544541192230409,20,29
America,Chile,18729160,2020-04-11,529,8,6501,65,0.3471057965226417,0.009998461775111522,21,29
America,Chile,18729160,2020-04-12,426,8,6927,73,0.36985107714387616,0.010538472643279919,22,29
America,Chile,18729160,2020-04-13,286,7,7213,80,0.38512138291306175,0.011091085539997228,23,29
America,Chile,18729160,2020-04-14,312,2,7525,82,0.40177989829762784,0.010897009966777409,24,29
America,Chile,18729160,2020-04-15,392,10,7917,92,0.4227098278833648,0.011620563344701275,25,29
America,Chile,18729160,2020-04-16,356,2,8273,94,0.4417176210785748,0.01136226278254563,26,29
America,Chile,18729160,2020-04-17,534,11,8807,105,0.47022931087138986,0.011922334506642443,27,29
America,Chile,18729160,2020-04-18,445,11,9252,116,0.4939890523654024,0.012537829658452227,28,29
America,Chile,18729160,2020-04-19,478,10,9730,126,0.519510752217398,0.012949640287769784,29,29
America,Chile,18729160,2020-04-20,358,7,10088,133,0.5386253307676372,0.013183980967486122,30,29
America,Chile,18729160,2020-04-21,419,6,10507,139,0.5609968626462692,0.013229275720947939,31,29
America,Chile,18729160,2020-04-22,325,8,10832,147,0.5783494828385256,0.013570901033973412,32,29
America,Chile,18729160,2020-04-23,464,13,11296,160,0.6031236852053162,0.014164305949008499,33,29
America,Chile,18729160,2020-04-24,516,8,11812,168,0.6306743068028678,0.014222824246528954,34,29
America,Chile,18729160,2020-04-25,494,6,12306,174,0.6570502894950975,0.014139444173573866,35,29
America,Chile,18729160,2020-04-26,552,7,12858,181,0.686523047483176,0.014076839321822989,36,29
America,Chile,18729160,2020-04-27,473,8,13331,189,0.7117777839475983,0.014177481059185357,37,29
America,Chile,18729160,2020-04-28,482,9,13813,198,0.7375130545096523,0.014334322739448346,38,29
America,Chile,18729160,2020-04-29,552,9,14365,207,0.7669858124977309,0.014410024364775497,39,29
America,Chile,18729160,2020-04-30,520,9,14885,216,0.794750004805341,0.014511252939200537,40,29
America,Chile,18729160,2020-05-01,1138,11,16023,227,0.8555108718169955,0.014167134743805779,41,29
America,Chile,18729160,2020-05-02,985,7,17008,234,0.9081026591689109,0.013758231420507996,42,29
America,Chile,18729160,2020-05-03,1427,13,18435,247,0.9842940099822951,0.013398426905343097,43,29
America,Chile,18729160,2020-05-04,1228,13,19663,260,1.0498602179702667,0.013222804251640137,44,29
America,Chile,18729160,2020-05-05,980,10,20643,270,1.1021850419346089,0.013079494259555298,45,29
America,Chile,18729160,2020-05-06,1373,5,22016,275,1.1754931881622028,0.012490915697674418,46,29
America,Chile,18729160,2020-05-07,1032,6,23048,281,1.230594431357306,0.012191947240541479,47,29
America,Chile,18729160,2020-05-08,1533,4,24581,285,1.3124454059872412,0.011594320816891095,48,29
America,Chile,18729160,2020-05-09,1391,9,25972,294,1.3867146204100986,0.011319882950870167,49,29
America,Chile,18729160,2020-05-10,1247,10,27219,304,1.4532952892708482,0.011168668944487307,50,29
America,Chile,18729160,2020-05-11,1647,8,28866,312,1.5412330291374519,0.010808563708168779,51,29
America,Chile,18729160,2020-05-12,1197,11,30063,323,1.60514406412247,0.01074410404816552,52,29
America,Chile,18729160,2020-05-13,1658,12,31721,335,1.6936691234417347,0.010560827212256865,53,29
America,Chile,18729160,2020-05-14,2660,11,34381,346,1.8356936456306638,0.01006369797271749,54,29
America,Chile,18729160,2020-05-15,2659,12,37040,358,1.9776647751420777,0.009665226781857451,55,29
America,Chile,18729160,2020-05-16,2502,36,39542,394,2.111253254283694,0.009964088816954125,56,29
America,Chile,18729160,2020-05-17,1886,27,41428,421,2.211951844076296,0.010162209133919088,57,29
America,Chile,18729160,2020-05-18,2353,29,43781,450,2.337584814268232,0.010278431282976635,58,29
America,Chile,18729160,2020-05-19,2278,28,46059,478,2.4592133336465705,0.010377993443192427,59,29
America,Chile,18729160,2020-05-20,3520,31,49579,509,2.6471555584980853,0.010266443453881684,60,29
America,Chile,18729160,2020-05-21,4038,35,53617,544,2.8627551903021815,0.010146035772236418,61,29
America,Chile,18729160,2020-05-22,3964,45,57581,589,3.0744037639701944,0.010229068616383877,62,29
America,Chile,18729160,2020-05-23,4276,41,61857,630,3.302710853022773,0.010184781027207915,63,29
America,Chile,18729160,2020-05-24,3536,43,65393,673,3.491507360714522,0.010291621427369902,64,29
America,Chile,18729160,2020-05-25,3709,45,69102,718,3.689540801616303,0.010390437324534745,65,29
America,Chile,18729160,2020-05-26,4895,43,73997,761,3.950897958050441,0.010284200710839629,66,29
America,Chile,18729160,2020-05-27,3964,45,77961,806,4.162546531718454,0.010338502584625646,67,29
America,Colombia,49648685,2020-04-02,159,1,1065,17,0.021450719188232277,0.01596244131455399,0,30
America,Colombia,49648685,2020-04-03,96,2,1161,19,0.023384305143227865,0.01636520241171404,1,30
America,Colombia,49648685,2020-04-04,106,6,1267,25,0.02551930630186882,0.01973164956590371,2,30
America,Colombia,49648685,2020-04-05,139,7,1406,32,0.028318977632539512,0.02275960170697013,3,30
America,Colombia,49648685,2020-04-06,79,3,1485,35,0.029910157741337963,0.02356902356902357,4,30
America,Colombia,49648685,2020-04-07,94,11,1579,46,0.03180346065560447,0.029132362254591513,5,30
America,Colombia,49648685,2020-04-08,201,4,1780,50,0.03585190624887648,0.028089887640449437,6,30
America,Colombia,49648685,2020-04-09,274,5,2054,55,0.04137068282875971,0.026777020447906523,7,30
America,Colombia,49648685,2020-04-10,169,14,2223,69,0.044774599770366526,0.0310391363022942,8,30
America,Colombia,49648685,2020-04-11,250,11,2473,80,0.04980997986150086,0.03234937323089365,9,30
America,Colombia,49648685,2020-04-12,236,20,2709,100,0.05456337866753168,0.0369139904023625,10,30
America,Colombia,49648685,2020-04-13,67,9,2776,109,0.05591286053195568,0.03926512968299712,11,30
America,Colombia,49648685,2020-04-14,76,3,2852,112,0.05744361607966052,0.03927068723702665,12,30
America,Colombia,49648685,2020-04-15,127,15,2979,127,0.06000158916595676,0.042631755622692176,13,30
America,Colombia,49648685,2020-04-16,126,4,3105,131,0.06253942073188846,0.04219001610305958,14,30
America,Colombia,49648685,2020-04-17,128,13,3233,144,0.06511753533854925,0.04454067429631921,15,30
America,Colombia,49648685,2020-04-18,206,9,3439,153,0.06926668853364394,0.04448967723175341,16,30
America,Colombia,49648685,2020-04-19,182,13,3621,166,0.07293244523998975,0.04584368958851146,17,30
America,Colombia,49648685,2020-04-20,171,13,3792,179,0.07637664522232562,0.04720464135021097,18,30
America,Colombia,49648685,2020-04-21,185,10,3977,189,0.08010282648976504,0.04752325873774202,19,30
America,Colombia,49648685,2020-04-22,172,7,4149,196,0.08356716799246545,0.04724029886719691,20,30
America,Colombia,49648685,2020-04-23,207,10,4356,206,0.08773646270792469,0.0472910927456382,21,30
America,Colombia,49648685,2020-04-24,205,9,4561,215,0.09186547438265485,0.04713878535408902,22,30
America,Colombia,49648685,2020-04-25,320,10,4881,225,0.0983107608993068,0.046097111247695145,23,30
America,Colombia,49648685,2020-04-26,261,8,5142,233,0.10356769771445105,0.045313107740178916,24,30
America,Colombia,49648685,2020-04-27,237,10,5379,243,0.1083412380408464,0.04517568321249303,25,30
America,Colombia,49648685,2020-04-28,218,10,5597,253,0.11273208948031553,0.04520278720743255,26,30
America,Colombia,49648685,2020-04-29,352,16,5949,269,0.11982190464863268,0.04521768364430997,27,30
America,Colombia,49648685,2020-04-30,262,9,6211,278,0.1250989829841415,0.04475929801964257,28,30
America,Colombia,49648685,2020-05-01,296,15,6507,293,0.13106087301204453,0.045028430920547105,29,30
America,Colombia,49648685,2020-05-02,499,21,7006,314,0.14111149167394868,0.044818726805595205,30,30
America,Colombia,49648685,2020-05-03,279,10,7285,324,0.1467309758556546,0.044474948524365135,31,30
America,Colombia,49648685,2020-05-04,383,16,7668,340,0.1544451781552724,0.04434011476264997,32,30
America,Colombia,49648685,2020-05-05,305,18,7973,358,0.1605883418664563,0.04490154270663489,33,30
America,Colombia,49648685,2020-05-06,640,20,8613,378,0.1734789148997602,0.0438871473354232,34,30
America,Colombia,49648685,2020-05-07,346,19,8959,397,0.1804478809458901,0.044312981359526736,35,30
America,Colombia,49648685,2020-05-08,497,10,9456,407,0.19045821656706519,0.0430414551607445,36,30
America,Colombia,49648685,2020-05-09,595,21,10051,428,0.2024424211839649,0.04258282757934534,37,30
America,Colombia,49648685,2020-05-10,444,17,10495,445,0.21138525622581947,0.042401143401619816,38,30
America,Colombia,49648685,2020-05-11,568,18,11063,463,0.2228256397928767,0.04185121576425924,39,30
America,Colombia,49648685,2020-05-12,550,16,11613,479,0.23390347599337222,0.04124687849823474,40,30
America,Colombia,49648685,2020-05-13,659,14,12272,493,0.24717673791360234,0.04017275097783572,41,30
America,Colombia,49648685,2020-05-14,658,16,12930,509,0.26042985831346793,0.039365815931941224,42,30
America,Colombia,49648685,2020-05-15,680,16,13610,525,0.2741260921613533,0.03857457751653196,43,30
America,Colombia,49648685,2020-05-16,606,21,14216,546,0.286331853502263,0.038407428249859314,44,30
America,Colombia,49648685,2020-05-17,723,16,14939,562,0.30089417272582347,0.03761965325657675,45,30
America,Colombia,49648685,2020-05-18,635,12,15574,574,0.31368403815730467,0.0368562989598048,46,30
America,Colombia,49648685,2020-05-19,721,18,16295,592,0.3282060743401361,0.03633016262657257,47,30
America,Colombia,49648685,2020-05-20,640,21,16935,613,0.34109664737344,0.03619722468260998,48,30
America,Colombia,49648685,2020-05-21,752,17,17687,630,0.35624307068757205,0.0356193814666139,49,30
America,Colombia,49648685,2020-05-22,643,22,18330,652,0.3691940682819696,0.03557010365521004,50,30
America,Colombia,49648685,2020-05-23,801,30,19131,682,0.38532742609396403,0.03564894673566463,51,30
America,Colombia,49648685,2020-05-24,1046,23,20177,705,0.4063954563952701,0.03494077414878327,52,30
America,Colombia,49648685,2020-05-25,998,22,21175,727,0.42649669371907833,0.034332939787485243,53,30
America,Colombia,49648685,2020-05-26,806,23,21981,750,0.44273075913289545,0.03412037668895865,54,30
America,Colombia,49648685,2020-05-27,1022,26,23003,776,0.46331539294545265,0.03373473025257575,55,30
Africa,Congo,84068091,2020-04-16,43,0,117,5,0.02230966849548744,0.042735042735042736,0,31
Africa,Congo,84068091,2020-04-17,0,0,117,5,0.02230966849548744,0.042735042735042736,1,31
Africa,Congo,84068091,2020-04-18,26,1,143,6,0.02726737260559576,0.04195804195804196,2,31
Africa,Congo,84068091,2020-04-19,0,0,143,6,0.02726737260559576,0.04195804195804196,3,31
Africa,Congo,84068091,2020-04-20,17,0,160,6,0.030508948369897353,0.0375,4,31
Africa,Congo,84068091,2020-04-21,0,0,160,6,0.030508948369897353,0.0375,5,31
Africa,Congo,84068091,2020-04-22,5,0,165,6,0.031462353006456646,0.03636363636363636,6,31
Africa,Congo,84068091,2020-04-23,21,0,186,6,0.035466652480005675,0.03225806451612903,7,31
Africa,Congo,84068091,2020-04-24,0,0,186,6,0.035466652480005675,0.03225806451612903,8,31
Africa,Congo,84068091,2020-04-25,14,0,200,6,0.03813618546237169,0.03,9,31
Africa,Congo,84068091,2020-04-26,0,2,200,8,0.03813618546237169,0.04,10,31
Africa,Congo,84068091,2020-04-27,0,0,200,8,0.03813618546237169,0.04,11,31
Africa,Congo,84068091,2020-04-28,7,0,207,8,0.0394709519535547,0.03864734299516908,12,31
Africa,Congo,84068091,2020-04-29,0,0,207,8,0.0394709519535547,0.03864734299516908,13,31
Africa,Congo,84068091,2020-04-30,13,1,220,9,0.041949804008608864,0.04090909090909091,14,31
Africa,Congo,84068091,2020-05-01,0,0,220,9,0.041949804008608864,0.04090909090909091,15,31
Africa,Congo,84068091,2020-05-02,9,1,229,10,0.043665932354415585,0.043668122270742356,16,31
Africa,Congo,84068091,2020-05-03,0,0,229,10,0.043665932354415585,0.043668122270742356,17,31
Africa,Congo,84068091,2020-05-04,0,0,229,10,0.043665932354415585,0.043668122270742356,18,31
Africa,Congo,84068091,2020-05-05,7,0,236,10,0.045000698845598604,0.0423728813559322,19,31
Africa,Congo,84068091,2020-05-06,0,0,236,10,0.045000698845598604,0.0423728813559322,20,31
Africa,Congo,84068091,2020-05-07,28,0,264,10,0.05033976481033063,0.03787878787878788,21,31
Africa,Congo,84068091,2020-05-08,10,0,274,10,0.052246574083449224,0.0364963503649635,22,31
Africa,Congo,84068091,2020-05-09,13,0,287,10,0.054725426138503376,0.03484320557491289,23,31
Africa,Congo,84068091,2020-05-10,0,0,287,10,0.054725426138503376,0.03484320557491289,24,31
Africa,Congo,84068091,2020-05-11,0,0,287,10,0.054725426138503376,0.03484320557491289,25,31
Africa,Congo,84068091,2020-05-12,46,1,333,11,0.06349674879484887,0.03303303303303303,26,31
Africa,Congo,84068091,2020-05-13,0,0,333,11,0.06349674879484887,0.03303303303303303,27,31
Africa,Congo,84068091,2020-05-14,8,0,341,11,0.06502219621334374,0.03225806451612903,28,31
Africa,Congo,84068091,2020-05-15,50,4,391,15,0.07455624257893666,0.03836317135549872,29,31
Africa,Congo,84068091,2020-05-16,0,0,391,15,0.07455624257893666,0.03836317135549872,30,31
Africa,Congo,84068091,2020-05-17,21,0,412,15,0.0785605420524857,0.03640776699029126,31,31
Africa,Congo,84068091,2020-05-18,0,0,412,15,0.0785605420524857,0.03640776699029126,32,31
Africa,Congo,84068091,2020-05-19,0,0,412,15,0.0785605420524857,0.03640776699029126,33,31
Africa,Congo,84068091,2020-05-20,8,0,420,15,0.08008598947098056,0.03571428571428571,34,31
Africa,Congo,84068091,2020-05-21,0,0,420,15,0.08008598947098056,0.03571428571428571,35,31
Africa,Congo,84068091,2020-05-22,49,1,469,16,0.08942935490926163,0.03411513859275053,36,31
Africa,Congo,84068091,2020-05-23,0,0,469,16,0.08942935490926163,0.03411513859275053,37,31
Africa,Congo,84068091,2020-05-24,18,0,487,16,0.09286161160087508,0.03285420944558522,38,31
Africa,Congo,84068091,2020-05-25,0,0,487,16,0.09286161160087508,0.03285420944558522,39,31
Africa,Congo,84068091,2020-05-26,44,1,531,17,0.10125157240259684,0.032015065913371,40,31
Africa,Congo,84068091,2020-05-27,38,2,569,19,0.10849744764044747,0.033391915641476276,41,31
America,Costa Rica,4999441,2020-03-21,26,1,113,2,0.022602526962514406,0.017699115044247787,0,32
America,Costa Rica,4999441,2020-03-22,4,0,117,2,0.02340261641251492,0.017094017094017096,1,32
America,Costa Rica,4999441,2020-03-23,17,0,134,2,0.02680299657501709,0.014925373134328358,2,32
America,Costa Rica,4999441,2020-03-24,24,0,158,2,0.03160353327502015,0.012658227848101266,3,32
America,Costa Rica,4999441,2020-03-25,19,0,177,2,0.03540395816252257,0.011299435028248588,4,32
America,Costa Rica,4999441,2020-03-26,24,0,201,2,0.04020449486252563,0.009950248756218905,5,32
America,Costa Rica,4999441,2020-03-27,30,0,231,2,0.046205165737529454,0.008658008658008658,6,32
America,Costa Rica,4999441,2020-03-28,32,0,263,2,0.052605881337533536,0.0076045627376425855,7,32
America,Costa Rica,4999441,2020-03-29,32,0,295,2,0.05900659693753762,0.006779661016949152,8,32
America,Costa Rica,4999441,2020-03-30,19,0,314,2,0.06280702182504004,0.006369426751592357,9,32
America,Costa Rica,4999441,2020-03-31,16,0,330,2,0.06600737962504208,0.006060606060606061,10,32
America,Costa Rica,4999441,2020-04-01,17,0,347,2,0.06940775978754425,0.005763688760806916,11,32
America,Costa Rica,4999441,2020-04-02,28,0,375,2,0.07500838593754781,0.005333333333333333,12,32
America,Costa Rica,4999441,2020-04-03,21,0,396,2,0.0792088555500505,0.005050505050505051,13,32
America,Costa Rica,4999441,2020-04-04,20,0,416,2,0.08320930280005304,0.004807692307692308,14,32
America,Costa Rica,4999441,2020-04-05,19,0,435,2,0.08700972768755547,0.004597701149425287,15,32
America,Costa Rica,4999441,2020-04-06,19,0,454,2,0.09081015257505788,0.004405286343612335,16,32
America,Costa Rica,4999441,2020-04-07,13,0,467,2,0.09341044328755954,0.004282655246252677,17,32
America,Costa Rica,4999441,2020-04-08,16,0,483,2,0.09661080108756159,0.004140786749482402,18,32
America,Costa Rica,4999441,2020-04-09,19,0,502,2,0.10041122597506402,0.00398406374501992,19,32
America,Costa Rica,4999441,2020-04-10,37,1,539,3,0.10781205338756873,0.0055658627087198514,20,32
America,Costa Rica,4999441,2020-04-11,19,0,558,3,0.11161247827507115,0.005376344086021506,21,32
America,Costa Rica,4999441,2020-04-12,19,0,577,3,0.11541290316257358,0.005199306759098787,22,32
America,Costa Rica,4999441,2020-04-13,18,0,595,3,0.11901330568757587,0.005042016806722689,23,32
America,Costa Rica,4999441,2020-04-14,17,0,612,3,0.12241368585007804,0.004901960784313725,24,32
America,Costa Rica,4999441,2020-04-15,6,0,618,3,0.1236138200250788,0.0048543689320388345,25,32
America,Costa Rica,4999441,2020-04-16,8,1,626,4,0.12521399892507984,0.006389776357827476,26,32
America,Costa Rica,4999441,2020-04-17,16,0,642,4,0.12841435672508186,0.006230529595015576,27,32
America,Costa Rica,4999441,2020-04-18,7,0,649,4,0.12981451326258275,0.0061633281972265025,28,32
America,Costa Rica,4999441,2020-04-19,6,0,655,4,0.1310146474375835,0.0061068702290076335,29,32
America,Costa Rica,4999441,2020-04-20,5,0,660,4,0.13201475925008416,0.006060606060606061,30,32
America,Costa Rica,4999441,2020-04-21,2,2,662,6,0.13241480397508443,0.00906344410876133,31,32
America,Costa Rica,4999441,2020-04-22,7,0,669,6,0.1338149605125853,0.008968609865470852,32,32
America,Costa Rica,4999441,2020-04-23,12,0,681,6,0.13621522886258683,0.00881057268722467,33,32
America,Costa Rica,4999441,2020-04-24,6,0,687,6,0.13741536303758758,0.008733624454148471,34,32
America,Costa Rica,4999441,2020-04-25,0,0,687,6,0.13741536303758758,0.008733624454148471,35,32
America,Costa Rica,4999441,2020-04-26,6,0,693,6,0.13861549721258837,0.008658008658008658,36,32
America,Costa Rica,4999441,2020-04-27,2,0,695,6,0.1390155419375886,0.008633093525179856,37,32
America,Costa Rica,4999441,2020-04-28,2,0,697,6,0.13941558666258888,0.00860832137733142,38,32
America,Costa Rica,4999441,2020-04-29,8,0,705,6,0.14101576556258988,0.00851063829787234,39,32
America,Costa Rica,4999441,2020-04-30,8,0,713,6,0.1426159444625909,0.008415147265077139,40,32
America,Costa Rica,4999441,2020-05-01,6,0,719,6,0.14381607863759166,0.008344923504867872,41,32
America,Costa Rica,4999441,2020-05-02,6,0,725,6,0.14501621281259244,0.008275862068965517,42,32
America,Costa Rica,4999441,2020-05-03,8,0,733,6,0.14661639171259347,0.008185538881309686,43,32
America,Costa Rica,4999441,2020-05-04,6,0,739,6,0.14781652588759422,0.008119079837618403,44,32
America,Costa Rica,4999441,2020-05-05,3,0,742,6,0.14841659297509463,0.008086253369272238,45,32
America,Costa Rica,4999441,2020-05-06,13,0,755,6,0.15101688368759625,0.007947019867549669,46,32
America,Costa Rica,4999441,2020-05-07,6,0,761,6,0.15221701786259703,0.00788436268068331,47,32
America,Costa Rica,4999441,2020-05-08,4,0,765,6,0.15301710731259754,0.00784313725490196,48,32
America,Costa Rica,4999441,2020-05-09,8,0,773,6,0.15461728621259857,0.007761966364812419,49,32
America,Costa Rica,4999441,2020-05-10,7,0,780,6,0.15601744275009946,0.007692307692307693,50,32
America,Costa Rica,4999441,2020-05-11,12,0,792,6,0.158417711100101,0.007575757575757576,51,32
America,Costa Rica,4999441,2020-05-12,9,1,801,7,0.16021791236260216,0.008739076154806492,52,32
America,Costa Rica,4999441,2020-05-13,3,0,804,7,0.1608179794501025,0.008706467661691543,53,32
America,Costa Rica,4999441,2020-05-14,11,0,815,7,0.16301822543760394,0.008588957055214725,54,32
America,Costa Rica,4999441,2020-05-15,15,1,830,8,0.16601856087510583,0.00963855421686747,55,32
America,Costa Rica,4999441,2020-05-16,13,0,843,8,0.1686188515876075,0.009489916963226572,56,32
America,Costa Rica,4999441,2020-05-17,10,2,853,10,0.17061907521260877,0.011723329425556858,57,32
America,Costa Rica,4999441,2020-05-18,10,0,863,10,0.17261929883761004,0.011587485515643106,58,32
America,Costa Rica,4999441,2020-05-19,3,0,866,10,0.17321936592511042,0.011547344110854504,59,32
America,Costa Rica,4999441,2020-05-20,16,0,882,10,0.17641972372511247,0.011337868480725623,60,32
America,Costa Rica,4999441,2020-05-21,15,0,897,10,0.1794200591626144,0.011148272017837236,61,32
America,Costa Rica,4999441,2020-05-22,6,0,903,10,0.18062019333761514,0.01107419712070875,62,32
America,Costa Rica,4999441,2020-05-23,8,0,911,10,0.18222037223761617,0.010976948408342482,63,32
America,Costa Rica,4999441,2020-05-24,7,0,918,10,0.18362052877511706,0.010893246187363835,64,32
America,Costa Rica,4999441,2020-05-25,12,0,930,10,0.18602079712511857,0.010752688172043012,65,32
America,Costa Rica,4999441,2020-05-26,21,0,951,10,0.19022126673762127,0.010515247108307046,66,32
America,Costa Rica,4999441,2020-05-27,5,0,956,10,0.1912213785501219,0.010460251046025104,67,32
Africa,Cote Divoire,25069229,2020-04-12,53,1,533,4,0.02126112454435675,0.0075046904315197,0,33
Africa,Cote Divoire,25069229,2020-04-13,41,1,574,5,0.02289659566315342,0.008710801393728223,1,33
Africa,Cote Divoire,25069229,2020-04-14,52,1,626,6,0.0249708517162614,0.009584664536741214,2,33
Africa,Cote Divoire,25069229,2020-04-15,0,0,626,6,0.0249708517162614,0.009584664536741214,3,33
Africa,Cote Divoire,25069229,2020-04-16,28,0,654,6,0.026087758821781076,0.009174311926605505,4,33
Africa,Cote Divoire,25069229,2020-04-17,34,0,688,6,0.02744400316419783,0.00872093023255814,5,33
Africa,Cote Divoire,25069229,2020-04-18,54,0,742,6,0.029598038296271497,0.008086253369272238,6,33
Africa,Cote Divoire,25069229,2020-04-19,59,2,801,8,0.03195152112575939,0.009987515605493134,7,33
Africa,Cote Divoire,25069229,2020-04-20,46,1,847,9,0.033786439941970295,0.010625737898465172,8,33
Africa,Cote Divoire,25069229,2020-04-21,32,1,879,10,0.03506290520542135,0.011376564277588168,9,33
Africa,Cote Divoire,25069229,2020-04-22,37,3,916,13,0.036538818166286645,0.014192139737991267,10,33
Africa,Cote Divoire,25069229,2020-04-23,36,1,952,14,0.03797484158766909,0.014705882352941176,11,33
Africa,Cote Divoire,25069229,2020-04-24,52,0,1004,14,0.04004909764077706,0.013944223107569721,12,33
Africa,Cote Divoire,25069229,2020-04-25,73,0,1077,14,0.0429610340230248,0.012999071494893221,13,33
Africa,Cote Divoire,25069229,2020-04-26,34,0,1111,14,0.044317278365441554,0.012601260126012601,14,33
Africa,Cote Divoire,25069229,2020-04-27,39,0,1150,14,0.04587297040527253,0.01217391304347826,15,33
Africa,Cote Divoire,25069229,2020-04-28,14,0,1164,14,0.046431423958032375,0.012027491408934709,16,33
Africa,Cote Divoire,25069229,2020-04-29,19,0,1183,14,0.04718932520820644,0.011834319526627219,17,33
Africa,Cote Divoire,25069229,2020-04-30,55,0,1238,14,0.049383249879762954,0.011308562197092083,18,33
Africa,Cote Divoire,25069229,2020-05-01,37,0,1275,14,0.05085916284062825,0.010980392156862745,19,33
Africa,Cote Divoire,25069229,2020-05-02,58,1,1333,15,0.0531727561306333,0.011252813203300824,20,33
Africa,Cote Divoire,25069229,2020-05-03,29,0,1362,15,0.05432955277563582,0.011013215859030838,21,33
Africa,Cote Divoire,25069229,2020-05-04,36,2,1398,17,0.05576557619701827,0.012160228898426323,22,33
Africa,Cote Divoire,25069229,2020-05-05,34,0,1432,17,0.05712182053943502,0.011871508379888268,23,33
Africa,Cote Divoire,25069229,2020-05-06,32,1,1464,18,0.058398285802886085,0.012295081967213115,24,33
Africa,Cote Divoire,25069229,2020-05-07,52,0,1516,18,0.06047254185599405,0.011873350923482849,25,33
Africa,Cote Divoire,25069229,2020-05-08,55,2,1571,20,0.06266646652755058,0.012730744748567792,26,33
Africa,Cote Divoire,25069229,2020-05-09,31,0,1602,20,0.06390304225151879,0.012484394506866416,27,33
Africa,Cote Divoire,25069229,2020-05-10,65,1,1667,21,0.06649586231790375,0.01259748050389922,28,33
Africa,Cote Divoire,25069229,2020-05-11,33,0,1700,21,0.06781221712083765,0.012352941176470587,29,33
Africa,Cote Divoire,25069229,2020-05-12,30,0,1730,21,0.06900890330532303,0.012138728323699421,30,33
Africa,Cote Divoire,25069229,2020-05-13,127,0,1857,21,0.07407487481964443,0.011308562197092083,31,33
Africa,Cote Divoire,25069229,2020-05-14,55,3,1912,24,0.07626879949120094,0.012552301255230125,32,33
Africa,Cote Divoire,25069229,2020-05-15,59,0,1971,24,0.07862228232068885,0.0121765601217656,33,33
Africa,Cote Divoire,25069229,2020-05-16,46,0,2017,24,0.08045720113689975,0.011898859692612791,34,33
Africa,Cote Divoire,25069229,2020-05-17,44,1,2061,25,0.08221234087414496,0.012130033964095099,35,33
Africa,Cote Divoire,25069229,2020-05-18,48,2,2109,27,0.08412703876932155,0.012802275960170697,36,33
Africa,Cote Divoire,25069229,2020-05-19,10,1,2119,28,0.08452593416415,0.013213780084945729,37,33
Africa,Cote Divoire,25069229,2020-05-20,34,0,2153,28,0.08588217850656676,0.013005109150023224,38,33
Africa,Cote Divoire,25069229,2020-05-21,78,1,2231,29,0.08899356258622872,0.012998655311519497,39,33
Africa,Cote Divoire,25069229,2020-05-22,0,0,2231,29,0.08899356258622872,0.012998655311519497,40,33
Africa,Cote Divoire,25069229,2020-05-23,70,0,2301,29,0.09178583035002792,0.012603215993046502,41,33
Africa,Cote Divoire,25069229,2020-05-24,65,1,2366,30,0.09437865041641288,0.01267962806424345,42,33
Africa,Cote Divoire,25069229,2020-05-25,10,0,2376,30,0.09477754581124134,0.012626262626262626,43,33
Africa,Cote Divoire,25069229,2020-05-26,47,0,2423,30,0.09665235416693509,0.012381345439537762,44,33
Africa,Cote Divoire,25069229,2020-05-27,54,0,2477,30,0.09880638929900876,0.012111425111021397,45,33
Europe,Croatia,4089400,2020-03-20,23,0,104,0,0.025431603658238374,0,0,34
Europe,Croatia,4089400,2020-03-21,22,0,126,0,0.03081136597055803,0,1,34
Europe,Croatia,4089400,2020-03-22,80,0,206,0,0.05037413801535678,0,2,34
Europe,Croatia,4089400,2020-03-23,29,0,235,0,0.05746564288159632,0,3,34
Europe,Croatia,4089400,2020-03-24,71,0,306,0,0.07482760307135522,0,4,34
Europe,Croatia,4089400,2020-03-25,76,1,382,1,0.09341223651391402,0.002617801047120419,5,34
Europe,Croatia,4089400,2020-03-26,36,0,418,1,0.10221548393407347,0.0023923444976076554,6,34
Europe,Croatia,4089400,2020-03-27,77,1,495,2,0.12104465202719225,0.00404040404040404,7,34
Europe,Croatia,4089400,2020-03-28,91,1,586,3,0.14329730522815082,0.005119453924914676,8,34
Europe,Croatia,4089400,2020-03-29,71,2,657,5,0.16065926541790973,0.0076103500761035,9,34
Europe,Croatia,4089400,2020-03-30,56,1,713,6,0.17435320584926883,0.008415147265077139,10,34
Europe,Croatia,4089400,2020-03-31,77,0,790,6,0.19318237394238763,0.007594936708860759,11,34
Europe,Croatia,4089400,2020-04-01,77,0,867,6,0.21201154203550643,0.006920415224913495,12,34
Europe,Croatia,4089400,2020-04-02,96,0,963,6,0.23548686848926492,0.006230529595015576,13,34
Europe,Croatia,4089400,2020-04-03,48,1,1011,7,0.2472245317161442,0.006923837784371909,14,34
Europe,Croatia,4089400,2020-04-04,68,1,1079,8,0.2638528879542231,0.0074142724745134385,15,34
Europe,Croatia,4089400,2020-04-05,47,4,1126,12,0.27534601653054236,0.010657193605683837,16,34
Europe,Croatia,4089400,2020-04-06,56,3,1182,15,0.2890399569619015,0.012690355329949238,17,34
Europe,Croatia,4089400,2020-04-07,40,1,1222,16,0.29882134298430085,0.01309328968903437,18,34
Europe,Croatia,4089400,2020-04-08,60,2,1282,18,0.3134934220178999,0.014040561622464899,19,34
Europe,Croatia,4089400,2020-04-09,61,1,1343,19,0.328410035702059,0.014147431124348473,20,34
Europe,Croatia,4089400,2020-04-10,64,1,1407,20,0.344060253337898,0.014214641080312722,21,34
Europe,Croatia,4089400,2020-04-11,88,1,1495,21,0.3655793025871766,0.014046822742474917,22,34
Europe,Croatia,4089400,2020-04-12,39,0,1534,21,0.375116153959016,0.013689700130378096,23,34
Europe,Croatia,4089400,2020-04-13,66,2,1600,23,0.39125544089597497,0.014375,24,34
Europe,Croatia,4089400,2020-04-14,50,2,1650,25,0.4034821734239742,0.015151515151515152,25,34
Europe,Croatia,4089400,2020-04-15,54,6,1704,31,0.41668704455421335,0.018192488262910797,26,34
Europe,Croatia,4089400,2020-04-16,37,3,1741,34,0.4257348266249328,0.019529006318207927,27,34
Europe,Croatia,4089400,2020-04-17,50,1,1791,35,0.43796155915293195,0.01954215522054718,28,34
Europe,Croatia,4089400,2020-04-18,23,1,1814,36,0.44358585611581164,0.019845644983461964,29,34
Europe,Croatia,4089400,2020-04-19,18,3,1832,39,0.4479874798258913,0.0212882096069869,30,34
Europe,Croatia,4089400,2020-04-20,39,8,1871,47,0.4575243311977307,0.02512025654730091,31,34
Europe,Croatia,4089400,2020-04-21,10,0,1881,47,0.4599696777033306,0.024986709197235512,32,34
Europe,Croatia,4089400,2020-04-22,27,1,1908,48,0.4665721132684501,0.025157232704402517,33,34
Europe,Croatia,4089400,2020-04-23,42,0,1950,48,0.47684256859196944,0.024615384615384615,34,34
Europe,Croatia,4089400,2020-04-24,31,2,1981,50,0.48442314275932896,0.02523977788995457,35,34
Europe,Croatia,4089400,2020-04-25,28,1,2009,51,0.4912701129750086,0.02538576406172225,36,34
Europe,Croatia,4089400,2020-04-26,7,3,2016,54,0.4929818555289285,0.026785714285714284,37,34
Europe,Croatia,4089400,2020-04-27,14,1,2030,55,0.4964053406367683,0.027093596059113302,38,34
Europe,Croatia,4089400,2020-04-28,9,4,2039,59,0.4986061524918081,0.02893575282000981,39,34
Europe,Croatia,4089400,2020-04-29,8,4,2047,63,0.500562429696288,0.030776746458231558,40,34
Europe,Croatia,4089400,2020-04-30,15,4,2062,67,0.5042304494546878,0.03249272550921436,41,34
Europe,Croatia,4089400,2020-05-01,14,2,2076,69,0.5076539345625275,0.033236994219653176,42,34
Europe,Croatia,4089400,2020-05-02,9,6,2085,75,0.5098547464175675,0.03597122302158273,43,34
Europe,Croatia,4089400,2020-05-03,3,2,2088,77,0.5105883503692473,0.036877394636015325,44,34
Europe,Croatia,4089400,2020-05-04,8,2,2096,79,0.5125446275737272,0.03769083969465649,45,34
Europe,Croatia,4089400,2020-05-05,5,1,2101,80,0.5137673008265271,0.03807710613993336,46,34
Europe,Croatia,4089400,2020-05-06,11,3,2112,83,0.516457181982687,0.039299242424242424,47,34
Europe,Croatia,4089400,2020-05-07,7,2,2119,85,0.5181689245366068,0.04011326097215668,48,34
Europe,Croatia,4089400,2020-05-08,6,1,2125,86,0.5196361324399668,0.04047058823529412,49,34
Europe,Croatia,4089400,2020-05-09,36,0,2161,86,0.5284393798601262,0.03979639055992596,50,34
Europe,Croatia,4089400,2020-05-10,15,1,2176,87,0.5321073996185259,0.03998161764705882,51,34
Europe,Croatia,4089400,2020-05-11,11,3,2187,90,0.5347972807746858,0.0411522633744856,52,34
Europe,Croatia,4089400,2020-05-12,9,1,2196,91,0.5369980926297256,0.04143897996357013,53,34
Europe,Croatia,4089400,2020-05-13,11,0,2207,91,0.5396879737858854,0.0412324422292705,54,34
Europe,Croatia,4089400,2020-05-14,6,3,2213,94,0.5411551816892454,0.042476276547672845,55,34
Europe,Croatia,4089400,2020-05-15,8,0,2221,94,0.5431114588937251,0.042323277802791534,56,34
Europe,Croatia,4089400,2020-05-16,1,1,2222,95,0.5433559935442852,0.04275427542754275,57,34
Europe,Croatia,4089400,2020-05-17,2,0,2224,95,0.5438450628454051,0.042715827338129495,58,34
Europe,Croatia,4089400,2020-05-18,2,0,2226,95,0.5443341321465252,0.0426774483378257,59,34
Europe,Croatia,4089400,2020-05-19,2,0,2228,95,0.5448232014476452,0.042639138240574505,60,34
Europe,Croatia,4089400,2020-05-20,4,1,2232,96,0.5458013400498851,0.043010752688172046,61,34
Europe,Croatia,4089400,2020-05-21,2,0,2234,96,0.546290409351005,0.04297224709042077,62,34
Europe,Croatia,4089400,2020-05-22,3,1,2237,97,0.547024013302685,0.04336164506034868,63,34
Europe,Croatia,4089400,2020-05-23,6,2,2243,99,0.5484912212060449,0.04413731609451627,64,34
Europe,Croatia,4089400,2020-05-24,0,0,2243,99,0.5484912212060449,0.04413731609451627,65,34
Europe,Croatia,4089400,2020-05-25,1,0,2244,99,0.548735755856605,0.04411764705882353,66,34
Europe,Croatia,4089400,2020-05-26,0,1,2244,100,0.548735755856605,0.044563279857397504,67,34
Europe,Croatia,4089400,2020-05-27,0,1,2244,101,0.548735755856605,0.04500891265597148,68,34
America,Cuba,11338138,2020-04-03,21,0,233,6,0.02055011149096968,0.02575107296137339,0,35
America,Cuba,11338138,2020-04-04,36,0,269,6,0.02372523601317959,0.022304832713754646,1,35
America,Cuba,11338138,2020-04-05,19,0,288,6,0.025400996177679266,0.020833333333333332,2,35
America,Cuba,11338138,2020-04-06,32,2,320,8,0.028223329086310294,0.025,3,35
America,Cuba,11338138,2020-04-07,30,1,350,9,0.030869266188151882,0.025714285714285714,4,35
America,Cuba,11338138,2020-04-08,46,2,396,11,0.03492636974430899,0.027777777777777776,5,35
America,Cuba,11338138,2020-04-09,61,1,457,12,0.04030644185138688,0.0262582056892779,6,35
America,Cuba,11338138,2020-04-10,58,3,515,15,0.04542192024828062,0.02912621359223301,7,35
America,Cuba,11338138,2020-04-11,49,0,564,15,0.04974361751462189,0.026595744680851064,8,35
America,Cuba,11338138,2020-04-12,56,1,620,16,0.05468270010472619,0.025806451612903226,9,35
America,Cuba,11338138,2020-04-13,49,2,669,18,0.059004397371067455,0.026905829596412557,10,35
America,Cuba,11338138,2020-04-14,57,3,726,21,0.06403167786456648,0.028925619834710745,11,35
America,Cuba,11338138,2020-04-15,40,0,766,21,0.06755959400035526,0.02741514360313316,12,35
America,Cuba,11338138,2020-04-16,48,3,814,24,0.0717930933633018,0.029484029484029485,13,35
America,Cuba,11338138,2020-04-17,48,3,862,27,0.07602659272624836,0.031322505800464036,14,35
America,Cuba,11338138,2020-04-18,61,4,923,31,0.08140666483332624,0.03358613217768147,15,35
America,Cuba,11338138,2020-04-19,63,1,986,32,0.08696313274719358,0.032454361054766734,16,35
America,Cuba,11338138,2020-04-20,49,2,1035,34,0.09128483001353485,0.03285024154589372,17,35
America,Cuba,11338138,2020-04-21,52,2,1087,36,0.09587112099006027,0.03311867525298988,18,35
America,Cuba,11338138,2020-04-22,50,2,1137,38,0.10028101615979625,0.03342128408091469,19,35
America,Cuba,11338138,2020-04-23,52,2,1189,40,0.10486730713632168,0.0336417157275021,20,35
America,Cuba,11338138,2020-04-24,46,3,1235,43,0.10892441069247878,0.034817813765182185,21,35
America,Cuba,11338138,2020-04-25,50,6,1285,49,0.11333430586221477,0.03813229571984436,22,35
America,Cuba,11338138,2020-04-26,52,2,1337,51,0.11792059683874018,0.0381451009723261,23,35
America,Cuba,11338138,2020-04-27,32,3,1369,54,0.12074292974737122,0.039444850255661065,24,35
America,Cuba,11338138,2020-04-28,20,2,1389,56,0.12250688781526563,0.040316774658027354,25,35
America,Cuba,11338138,2020-04-29,48,2,1437,58,0.12674038717821215,0.04036186499652053,26,35
America,Cuba,11338138,2020-04-30,30,0,1467,58,0.12938632428005373,0.03953646898432175,27,35
America,Cuba,11338138,2020-05-01,34,3,1501,61,0.13238505299547423,0.04063957361758828,28,35
America,Cuba,11338138,2020-05-02,36,3,1537,64,0.13556017751768412,0.04163955757970072,29,35
America,Cuba,11338138,2020-05-03,74,2,1611,66,0.14208682236889336,0.040968342644320296,30,35
America,Cuba,11338138,2020-05-04,38,1,1649,67,0.14543834269789271,0.04063068526379624,31,35
America,Cuba,11338138,2020-05-05,19,2,1668,69,0.1471141028623924,0.04136690647482014,32,35
America,Cuba,11338138,2020-05-06,17,0,1685,69,0.14861346722010263,0.04094955489614243,33,35
America,Cuba,11338138,2020-05-07,18,0,1703,69,0.1502010294812076,0.040516735173223725,34,35
America,Cuba,11338138,2020-05-08,26,4,1729,73,0.1524941749694703,0.042220936957779065,35,35
America,Cuba,11338138,2020-05-09,12,1,1741,74,0.15355254981020694,0.04250430786904078,36,35
America,Cuba,11338138,2020-05-10,13,0,1754,74,0.1546991225543383,0.04218928164196123,37,35
America,Cuba,11338138,2020-05-11,12,3,1766,77,0.15575749739507494,0.04360135900339751,38,35
America,Cuba,11338138,2020-05-12,17,0,1783,77,0.15725686175278517,0.04318564217610768,39,35
America,Cuba,11338138,2020-05-13,21,1,1804,78,0.15910901772407426,0.043237250554323724,40,35
America,Cuba,11338138,2020-05-14,6,1,1810,79,0.1596382051444426,0.04364640883977901,41,35
America,Cuba,11338138,2020-05-15,20,0,1830,79,0.16140216321233697,0.04316939890710383,42,35
America,Cuba,11338138,2020-05-16,10,0,1840,79,0.16228414224628418,0.042934782608695654,43,35
America,Cuba,11338138,2020-05-17,22,0,1862,79,0.164224496120968,0.04242749731471536,44,35
America,Cuba,11338138,2020-05-18,10,0,1872,79,0.16510647515491522,0.042200854700854704,45,35
America,Cuba,11338138,2020-05-19,9,0,1881,79,0.1659002562854677,0.04199893673577884,46,35
America,Cuba,11338138,2020-05-20,6,0,1887,79,0.16642944370583598,0.041865394806571275,47,35
America,Cuba,11338138,2020-05-21,13,0,1900,79,0.16757601644996734,0.041578947368421056,48,35
America,Cuba,11338138,2020-05-22,8,1,1908,80,0.1682815996771251,0.041928721174004195,49,35
America,Cuba,11338138,2020-05-23,8,1,1916,81,0.16898718290428286,0.042275574112734866,50,35
America,Cuba,11338138,2020-05-24,15,0,1931,81,0.17031015145520367,0.04194717762817193,51,35
America,Cuba,11338138,2020-05-25,10,1,1941,82,0.17119213048915086,0.0422462648119526,52,35
America,Cuba,11338138,2020-05-26,6,0,1947,82,0.1717213179095192,0.042116076014381096,53,35
America,Cuba,11338138,2020-05-27,16,0,1963,82,0.17313248436383472,0.041772796739684155,54,35
America,Curaçao,159849,2020-03-24,3,0,6,0,0.037535424056453284,0,0,36
America,Curaçao,159849,2020-03-26,0,1,6,1,0.037535424056453284,0.16666666666666666,1,36
America,Curaçao,159849,2020-03-27,1,0,7,1,0.04379132806586215,0.14285714285714285,2,36
America,Curaçao,159849,2020-03-28,1,0,8,1,0.050047232075271036,0.125,3,36
America,Curaçao,159849,2020-03-29,0,0,8,1,0.050047232075271036,0.125,4,36
America,Curaçao,159849,2020-03-30,1,0,9,1,0.05630313608467991,0.1111111111111111,5,36
America,Curaçao,159849,2020-04-01,2,0,11,1,0.06881494410349767,0.09090909090909091,6,36
America,Curaçao,159849,2020-04-02,0,0,11,1,0.06881494410349767,0.09090909090909091,7,36
America,Curaçao,159849,2020-04-03,0,0,11,1,0.06881494410349767,0.09090909090909091,8,36
America,Curaçao,159849,2020-04-04,0,0,11,1,0.06881494410349767,0.09090909090909091,9,36
America,Curaçao,159849,2020-04-05,0,0,11,1,0.06881494410349767,0.09090909090909091,10,36
America,Curaçao,159849,2020-04-06,0,0,11,1,0.06881494410349767,0.09090909090909091,11,36
America,Curaçao,159849,2020-04-07,2,0,13,1,0.08132675212231544,0.07692307692307693,12,36
America,Curaçao,159849,2020-04-08,0,0,13,1,0.08132675212231544,0.07692307692307693,13,36
America,Curaçao,159849,2020-04-09,1,0,14,1,0.0875826561317243,0.07142857142857142,14,36
America,Curaçao,159849,2020-04-10,0,0,14,1,0.0875826561317243,0.07142857142857142,15,36
America,Curaçao,159849,2020-04-11,0,0,14,1,0.0875826561317243,0.07142857142857142,16,36
America,Curaçao,159849,2020-04-12,0,0,14,1,0.0875826561317243,0.07142857142857142,17,36
America,Curaçao,159849,2020-04-13,0,0,14,1,0.0875826561317243,0.07142857142857142,18,36
America,Curaçao,159849,2020-04-14,0,0,14,1,0.0875826561317243,0.07142857142857142,19,36
America,Curaçao,159849,2020-04-15,0,0,14,1,0.0875826561317243,0.07142857142857142,20,36
America,Curaçao,159849,2020-04-16,0,0,14,1,0.0875826561317243,0.07142857142857142,21,36
America,Curaçao,159849,2020-04-17,0,0,14,1,0.0875826561317243,0.07142857142857142,22,36
America,Curaçao,159849,2020-04-18,0,0,14,1,0.0875826561317243,0.07142857142857142,23,36
America,Curaçao,159849,2020-04-19,0,0,14,1,0.0875826561317243,0.07142857142857142,24,36
America,Curaçao,159849,2020-04-20,0,0,14,1,0.0875826561317243,0.07142857142857142,25,36
America,Curaçao,159849,2020-04-21,0,0,14,1,0.0875826561317243,0.07142857142857142,26,36
America,Curaçao,159849,2020-04-22,0,0,14,1,0.0875826561317243,0.07142857142857142,27,36
America,Curaçao,159849,2020-04-23,0,0,14,1,0.0875826561317243,0.07142857142857142,28,36
America,Curaçao,159849,2020-04-24,0,0,14,1,0.0875826561317243,0.07142857142857142,29,36
America,Curaçao,159849,2020-04-25,2,0,16,1,0.10009446415054207,0.0625,30,36
America,Curaçao,159849,2020-04-26,0,0,16,1,0.10009446415054207,0.0625,31,36
America,Curaçao,159849,2020-04-27,0,0,16,1,0.10009446415054207,0.0625,32,36
America,Curaçao,159849,2020-04-28,0,0,16,1,0.10009446415054207,0.0625,33,36
America,Curaçao,159849,2020-04-29,0,0,16,1,0.10009446415054207,0.0625,34,36
America,Curaçao,159849,2020-04-30,0,0,16,1,0.10009446415054207,0.0625,35,36
America,Curaçao,159849,2020-05-01,0,0,16,1,0.10009446415054207,0.0625,36,36
America,Curaçao,159849,2020-05-02,0,0,16,1,0.10009446415054207,0.0625,37,36
America,Curaçao,159849,2020-05-03,0,0,16,1,0.10009446415054207,0.0625,38,36
America,Curaçao,159849,2020-05-04,0,0,16,1,0.10009446415054207,0.0625,39,36
America,Curaçao,159849,2020-05-05,0,0,16,1,0.10009446415054207,0.0625,40,36
America,Curaçao,159849,2020-05-06,0,0,16,1,0.10009446415054207,0.0625,41,36
America,Curaçao,159849,2020-05-07,0,0,16,1,0.10009446415054207,0.0625,42,36
America,Curaçao,159849,2020-05-08,0,0,16,1,0.10009446415054207,0.0625,43,36
America,Curaçao,159849,2020-05-09,0,0,16,1,0.10009446415054207,0.0625,44,36
America,Curaçao,159849,2020-05-10,0,0,16,1,0.10009446415054207,0.0625,45,36
America,Curaçao,159849,2020-05-11,0,0,16,1,0.10009446415054207,0.0625,46,36
America,Curaçao,159849,2020-05-12,0,0,16,1,0.10009446415054207,0.0625,47,36
America,Curaçao,159849,2020-05-13,0,0,16,1,0.10009446415054207,0.0625,48,36
America,Curaçao,159849,2020-05-14,0,0,16,1,0.10009446415054207,0.0625,49,36
America,Curaçao,159849,2020-05-15,0,0,16,1,0.10009446415054207,0.0625,50,36
America,Curaçao,159849,2020-05-16,0,0,16,1,0.10009446415054207,0.0625,51,36
America,Curaçao,159849,2020-05-17,0,0,16,1,0.10009446415054207,0.0625,52,36
America,Curaçao,159849,2020-05-18,0,0,16,1,0.10009446415054207,0.0625,53,36
America,Curaçao,159849,2020-05-19,0,0,16,1,0.10009446415054207,0.0625,54,36
America,Curaçao,159849,2020-05-20,0,0,16,1,0.10009446415054207,0.0625,55,36
America,Curaçao,159849,2020-05-21,0,0,16,1,0.10009446415054207,0.0625,56,36
America,Curaçao,159849,2020-05-22,0,0,16,1,0.10009446415054207,0.0625,57,36
America,Curaçao,159849,2020-05-23,0,0,16,1,0.10009446415054207,0.0625,58,36
America,Curaçao,159849,2020-05-24,0,0,16,1,0.10009446415054207,0.0625,59,36
America,Curaçao,159849,2020-05-25,1,0,17,1,0.10635036815995096,0.058823529411764705,60,36
America,Curaçao,159849,2020-05-26,1,0,18,1,0.11260627216935983,0.05555555555555555,61,36
America,Curaçao,159849,2020-05-27,0,0,18,1,0.11260627216935983,0.05555555555555555,62,36
Europe,Cyprus,1189265,2020-03-16,9,0,30,0,0.02522566459115504,0,0,37
Europe,Cyprus,1189265,2020-03-17,10,0,40,0,0.03363421945487338,0,1,37
Europe,Cyprus,1189265,2020-03-18,0,0,40,0,0.03363421945487338,0,2,37
Europe,Cyprus,1189265,2020-03-19,18,0,58,0,0.048769618209566414,0,3,37
Europe,Cyprus,1189265,2020-03-20,0,0,58,0,0.048769618209566414,0,4,37
Europe,Cyprus,1189265,2020-03-21,9,0,67,0,0.056337317586912926,0,5,37
Europe,Cyprus,1189265,2020-03-22,17,0,84,0,0.07063186085523411,0,6,37
Europe,Cyprus,1189265,2020-03-23,11,0,95,0,0.0798812712053243,0,7,37
Europe,Cyprus,1189265,2020-03-24,21,0,116,0,0.09753923641913283,0,8,37
Europe,Cyprus,1189265,2020-03-25,8,3,124,3,0.1042660803101075,0.024193548387096774,9,37
Europe,Cyprus,1189265,2020-03-26,8,0,132,3,0.11099292420108219,0.022727272727272728,10,37
Europe,Cyprus,1189265,2020-03-27,14,0,146,3,0.12276490101028786,0.02054794520547945,11,37
Europe,Cyprus,1189265,2020-03-28,16,2,162,5,0.13621858879223722,0.030864197530864196,12,37
Europe,Cyprus,1189265,2020-03-29,17,0,179,5,0.1505131320605584,0.027932960893854747,13,37
Europe,Cyprus,1189265,2020-03-30,35,1,214,6,0.17994307408357263,0.028037383177570093,14,37
Europe,Cyprus,1189265,2020-03-31,16,1,230,7,0.193396761865522,0.030434782608695653,15,37
Europe,Cyprus,1189265,2020-04-01,32,1,262,8,0.2203041374294207,0.030534351145038167,16,37
Europe,Cyprus,1189265,2020-04-02,58,1,320,9,0.26907375563898706,0.028125,17,37
Europe,Cyprus,1189265,2020-04-03,36,0,356,9,0.29934455314837316,0.025280898876404494,18,37
Europe,Cyprus,1189265,2020-04-04,40,0,396,9,0.33297877260324654,0.022727272727272728,19,37
Europe,Cyprus,1189265,2020-04-05,30,0,426,9,0.3582044371944016,0.02112676056338028,20,37
Europe,Cyprus,1189265,2020-04-06,20,0,446,9,0.3750215469218383,0.020179372197309416,21,37
Europe,Cyprus,1189265,2020-04-07,19,0,465,9,0.3909978011629031,0.01935483870967742,22,37
Europe,Cyprus,1189265,2020-04-08,29,0,494,9,0.4153826102676863,0.018218623481781375,23,37
Europe,Cyprus,1189265,2020-04-09,32,0,526,9,0.442289985831585,0.017110266159695818,24,37
Europe,Cyprus,1189265,2020-04-10,38,1,564,10,0.4742424943137148,0.01773049645390071,25,37
Europe,Cyprus,1189265,2020-04-11,31,0,595,10,0.5003090143912416,0.01680672268907563,26,37
Europe,Cyprus,1189265,2020-04-12,21,0,616,10,0.5179669796050502,0.016233766233766232,27,37
Europe,Cyprus,1189265,2020-04-13,17,1,633,11,0.5322615228733714,0.017377567140600316,28,37
Europe,Cyprus,1189265,2020-04-14,29,1,662,12,0.5566463319781545,0.01812688821752266,29,37
Europe,Cyprus,1189265,2020-04-15,33,0,695,12,0.5843945630284251,0.017266187050359712,30,37
Europe,Cyprus,1189265,2020-04-16,20,0,715,12,0.6012116727558618,0.016783216783216783,31,37
Europe,Cyprus,1189265,2020-04-17,20,0,735,12,0.6180287824832985,0.0163265306122449,32,37
Europe,Cyprus,1189265,2020-04-18,0,0,735,12,0.6180287824832985,0.0163265306122449,33,37
Europe,Cyprus,1189265,2020-04-19,26,0,761,12,0.6398910251289662,0.01576872536136662,34,37
Europe,Cyprus,1189265,2020-04-20,6,0,767,12,0.6449361580471972,0.01564537157757497,35,37
Europe,Cyprus,1189265,2020-04-21,5,0,772,12,0.6491404354790564,0.015544041450777202,36,37
Europe,Cyprus,1189265,2020-04-22,12,0,784,12,0.6592307013155184,0.015306122448979591,37,37
Europe,Cyprus,1189265,2020-04-23,6,2,790,14,0.6642758342337495,0.017721518987341773,38,37
Europe,Cyprus,1189265,2020-04-24,5,0,795,14,0.6684801116656086,0.01761006289308176,39,37
Europe,Cyprus,1189265,2020-04-25,9,0,804,14,0.6760478110429551,0.017412935323383085,40,37
Europe,Cyprus,1189265,2020-04-26,6,0,810,14,0.6810929439611861,0.01728395061728395,41,37
Europe,Cyprus,1189265,2020-04-27,7,0,817,14,0.6869789323657889,0.017135862913096694,42,37
Europe,Cyprus,1189265,2020-04-28,5,1,822,15,0.6911832097976481,0.01824817518248175,43,37
Europe,Cyprus,1189265,2020-04-29,15,0,837,15,0.7037960420932257,0.017921146953405017,44,37
Europe,Cyprus,1189265,2020-04-30,6,0,843,15,0.7088411750114567,0.017793594306049824,45,37
Europe,Cyprus,1189265,2020-05-01,7,0,850,15,0.7147271634160595,0.01764705882352941,46,37
Europe,Cyprus,1189265,2020-05-02,7,0,857,15,0.7206131518206623,0.01750291715285881,47,37
Europe,Cyprus,1189265,2020-05-03,7,0,864,15,0.7264991402252652,0.017361111111111112,48,37
Europe,Cyprus,1189265,2020-05-04,8,0,872,15,0.7332259841162398,0.017201834862385322,49,37
Europe,Cyprus,1189265,2020-05-05,2,0,874,15,0.7349076950889836,0.017162471395881007,50,37
Europe,Cyprus,1189265,2020-05-06,4,0,878,15,0.7382711170344709,0.017084282460136675,51,37
Europe,Cyprus,1189265,2020-05-07,5,0,883,15,0.74247539446633,0.01698754246885617,52,37
Europe,Cyprus,1189265,2020-05-08,6,0,889,15,0.7475205273845611,0.01687289088863892,53,37
Europe,Cyprus,1189265,2020-05-09,2,0,891,15,0.7492022383573047,0.016835016835016835,54,37
Europe,Cyprus,1189265,2020-05-10,1,0,892,15,0.7500430938436766,0.016816143497757848,55,37
Europe,Cyprus,1189265,2020-05-11,6,1,898,16,0.7550882267619076,0.017817371937639197,56,37
Europe,Cyprus,1189265,2020-05-12,3,0,901,16,0.7576107932210231,0.017758046614872364,57,37
Europe,Cyprus,1189265,2020-05-13,2,0,903,16,0.7592925041937668,0.017718715393133997,58,37
Europe,Cyprus,1189265,2020-05-14,2,1,905,17,0.7609742151665104,0.01878453038674033,59,37
Europe,Cyprus,1189265,2020-05-15,2,0,907,17,0.762655926139254,0.018743109151047408,60,37
Europe,Cyprus,1189265,2020-05-16,3,0,910,17,0.7651784925983696,0.01868131868131868,61,37
Europe,Cyprus,1189265,2020-05-17,4,0,914,17,0.768541914543857,0.018599562363238512,62,37
Europe,Cyprus,1189265,2020-05-18,2,0,916,17,0.7702236255166005,0.018558951965065504,63,37
Europe,Cyprus,1189265,2020-05-19,1,0,917,17,0.7710644810029724,0.018538713195201745,64,37
Europe,Cyprus,1189265,2020-05-20,1,0,918,17,0.7719053364893442,0.018518518518518517,65,37
Europe,Cyprus,1189265,2020-05-21,4,0,922,17,0.7752687584348316,0.01843817787418655,66,37
Europe,Cyprus,1189265,2020-05-22,1,0,923,17,0.7761096139212035,0.018418201516793065,67,37
Europe,Cyprus,1189265,2020-05-23,4,0,927,17,0.7794730358666907,0.018338727076591153,68,37
Europe,Cyprus,1189265,2020-05-24,0,0,927,17,0.7794730358666907,0.018338727076591153,69,37
Europe,Cyprus,1189265,2020-05-25,8,0,935,17,0.7861998797576655,0.01818181818181818,70,37
Europe,Cyprus,1189265,2020-05-26,2,0,937,17,0.7878815907304091,0.01814300960512273,71,37
Europe,Cyprus,1189265,2020-05-27,2,0,939,17,0.7895633017031528,0.01810436634717785,72,37
Europe,Czechia,10625695,2020-03-15,64,0,214,0,0.020139859086864435,0,0,38
Europe,Czechia,10625695,2020-03-16,84,0,298,0,0.02804522433591403,0,1,38
Europe,Czechia,10625695,2020-03-17,46,0,344,0,0.03237435292467928,0,2,38
Europe,Czechia,10625695,2020-03-18,90,0,434,0,0.04084438712008955,0,3,38
Europe,Czechia,10625695,2020-03-19,88,0,522,0,0.049126198333379605,0,4,38
Europe,Czechia,10625695,2020-03-20,172,0,694,0,0.06531337479571925,0,5,38
Europe,Czechia,10625695,2020-03-21,210,0,904,0,0.08507678791834322,0,6,38
Europe,Czechia,10625695,2020-03-22,91,0,995,0,0.09364093360481363,0,7,38
Europe,Czechia,10625695,2020-03-23,170,1,1165,1,0.10963988708503303,8.583690987124463e-4,8,38
Europe,Czechia,10625695,2020-03-24,71,0,1236,1,0.11632180295030113,8.090614886731392e-4,9,38
Europe,Czechia,10625695,2020-03-25,158,2,1394,3,0.13119141853779917,0.002152080344332855,10,38
Europe,Czechia,10625695,2020-03-26,260,3,1654,6,0.15566040621342886,0.0036275695284159614,11,38
Europe,Czechia,10625695,2020-03-27,408,3,2062,9,0.19405789456595543,0.004364694471387003,12,38
Europe,Czechia,10625695,2020-03-28,217,0,2279,9,0.21448008812600022,0.003949100482667837,13,38
Europe,Czechia,10625695,2020-03-29,384,2,2663,11,0.25061890069308407,0.004130679684566279,14,38
Europe,Czechia,10625695,2020-03-30,166,5,2829,16,0.266241408209063,0.005655708731000354,15,38
Europe,Czechia,10625695,2020-03-31,173,8,3002,24,0.2825226961624628,0.007994670219853431,16,38
Europe,Czechia,10625695,2020-04-01,306,7,3308,31,0.3113208124268577,0.009371221281741234,17,38
Europe,Czechia,10625695,2020-04-02,281,8,3589,39,0.3377661414147498,0.010866536639732517,18,38
Europe,Czechia,10625695,2020-04-03,269,5,3858,44,0.36308213250992055,0.011404872991187144,19,38
Europe,Czechia,10625695,2020-04-04,332,9,4190,53,0.3943271475418784,0.012649164677804296,20,38
Europe,Czechia,10625695,2020-04-05,282,6,4472,59,0.42086658802083066,0.013193202146690518,21,38
Europe,Czechia,10625695,2020-04-06,115,8,4587,67,0.43168940949274376,0.01460649662088511,22,38
Europe,Czechia,10625695,2020-04-07,235,11,4822,78,0.45380560989187063,0.016175860638739114,23,38
Europe,Czechia,10625695,2020-04-08,195,10,5017,88,0.4721573506485929,0.01754036276659358,24,38
Europe,Czechia,10625695,2020-04-09,295,11,5312,99,0.4999202405113265,0.018637048192771084,25,38
Europe,Czechia,10625695,2020-04-10,257,13,5569,112,0.524106893713776,0.02011133057999641,26,38
Europe,Czechia,10625695,2020-04-11,163,7,5732,119,0.5394470667565745,0.020760642009769716,27,38
Europe,Czechia,10625695,2020-04-12,170,10,5902,129,0.5554460202367939,0.021856997627922738,28,38
Europe,Czechia,10625695,2020-04-13,89,9,5991,138,0.5638219429411441,0.02303455182774161,29,38
Europe,Czechia,10625695,2020-04-14,68,5,6059,143,0.5702215243332319,0.023601254332398087,30,38
Europe,Czechia,10625695,2020-04-15,82,18,6141,161,0.5779386666001612,0.026217228464419477,31,38
Europe,Czechia,10625695,2020-04-16,162,5,6303,166,0.5931847281518997,0.02633666508012058,32,38
Europe,Czechia,10625695,2020-04-17,130,3,6433,169,0.6054192219897145,0.02627079123270636,33,38
Europe,Czechia,10625695,2020-04-18,116,4,6549,173,0.6163361549526878,0.026416246755229807,34,38
Europe,Czechia,10625695,2020-04-19,105,8,6654,181,0.6262178615139997,0.027201683198076344,35,38
Europe,Czechia,10625695,2020-04-20,133,7,6787,188,0.6387346898249949,0.027700014734050392,36,38
Europe,Czechia,10625695,2020-04-21,127,8,6914,196,0.6506868491896295,0.02834827885449812,37,38
Europe,Czechia,10625695,2020-04-22,127,5,7041,201,0.6626390085542639,0.028547081380485728,38,38
Europe,Czechia,10625695,2020-04-23,95,9,7136,210,0.6715796002049749,0.029428251121076235,39,38
Europe,Czechia,10625695,2020-04-24,52,3,7188,213,0.6764733977401007,0.02963272120200334,40,38
Europe,Czechia,10625695,2020-04-25,85,2,7273,215,0.6844728744802104,0.029561391447820707,41,38
Europe,Czechia,10625695,2020-04-26,79,3,7352,218,0.6919076822739595,0.029651795429815015,42,38
Europe,Czechia,10625695,2020-04-27,52,3,7404,221,0.6968014798090854,0.029848730415991356,43,38
Europe,Czechia,10625695,2020-04-28,45,2,7449,223,0.7010364969067906,0.029936904282454022,44,38
Europe,Czechia,10625695,2020-04-29,55,4,7504,227,0.7062126289150968,0.03025053304904051,45,38
Europe,Czechia,10625695,2020-04-30,75,0,7579,227,0.7132709907446054,0.02995118089457712,46,38
Europe,Czechia,10625695,2020-05-01,103,9,7682,236,0.7229644743237972,0.030721166362926322,47,38
Europe,Czechia,10625695,2020-05-02,55,4,7737,240,0.7281406063321034,0.031019775106630478,48,38
Europe,Czechia,10625695,2020-05-03,18,5,7755,245,0.7298346131711856,0.03159252095422308,49,38
Europe,Czechia,10625695,2020-05-04,26,3,7781,248,0.7322815119387485,0.03187250996015936,50,38
Europe,Czechia,10625695,2020-05-05,38,4,7819,252,0.7358577485990329,0.03222918531781558,51,38
Europe,Czechia,10625695,2020-05-06,77,5,7896,257,0.7431043334106615,0.03254812563323202,52,38
Europe,Czechia,10625695,2020-05-07,78,5,7974,262,0.7504450297133505,0.032856784549786806,53,38
Europe,Czechia,10625695,2020-05-08,57,8,8031,270,0.755809384703777,0.03361972357116175,54,38
Europe,Czechia,10625695,2020-05-09,46,3,8077,273,0.7601385132925423,0.03379967809830382,55,38
Europe,Czechia,10625695,2020-05-10,18,3,8095,276,0.7618325201316244,0.03409512044471896,56,38
Europe,Czechia,10625695,2020-05-11,28,4,8123,280,0.7644676418813076,0.034470023390373014,57,38
Europe,Czechia,10625695,2020-05-12,53,2,8176,282,0.7694555509074936,0.03449119373776908,58,38
Europe,Czechia,10625695,2020-05-13,45,1,8221,283,0.7736905680051988,0.03442403600535215,59,38
Europe,Czechia,10625695,2020-05-14,48,7,8269,290,0.7782079195760842,0.03507074616035796,60,38
Europe,Czechia,10625695,2020-05-15,82,3,8351,293,0.7859250618430136,0.03508561848880374,61,38
Europe,Czechia,10625695,2020-05-16,55,2,8406,295,0.7911011938513198,0.0350939804901261,62,38
Europe,Czechia,10625695,2020-05-17,49,1,8455,296,0.7957126569132654,0.03500887049083383,63,38
Europe,Czechia,10625695,2020-05-18,20,1,8475,297,0.7975948867344678,0.035044247787610616,64,38
Europe,Czechia,10625695,2020-05-19,111,0,8586,297,0.8080412622421405,0.03459119496855346,65,38
Europe,Czechia,10625695,2020-05-20,61,5,8647,302,0.8137820631968073,0.03492540765583439,66,38
Europe,Czechia,10625695,2020-05-21,74,2,8721,304,0.8207463135352558,0.034858387799564274,67,38
Europe,Czechia,10625695,2020-05-22,33,2,8754,306,0.8238519927402397,0.03495544893762851,68,38
Europe,Czechia,10625695,2020-05-23,59,6,8813,312,0.8294045707127863,0.035402246681039376,69,38
Europe,Czechia,10625695,2020-05-24,77,2,8890,314,0.836651155524415,0.03532058492688414,70,38
Europe,Czechia,10625695,2020-05-25,67,1,8957,315,0.8429566254254427,0.03516802500837334,71,38
Europe,Czechia,10625695,2020-05-26,47,2,9004,317,0.8473798655052681,0.035206574855619725,72,38
Europe,Czechia,10625695,2020-05-27,46,0,9050,317,0.8517089940940334,0.03502762430939226,73,38
Africa,Congo,84068091,2020-05-20,102,0,1731,61,0.020590452089604368,0.035239745811669554,42,31
Africa,Congo,84068091,2020-05-21,104,0,1835,61,0.021827544531729644,0.0332425068119891,43,31
Africa,Congo,84068091,2020-05-22,110,2,1945,63,0.02313600769166984,0.032390745501285345,44,31
Africa,Congo,84068091,2020-05-23,80,0,2025,63,0.024087617262535437,0.03111111111111111,45,31
Africa,Congo,84068091,2020-05-24,116,0,2141,63,0.025467451140290552,0.029425502101821578,46,31
Africa,Congo,84068091,2020-05-25,156,4,2297,67,0.02732308980347847,0.029168480626904657,47,31
Africa,Congo,84068091,2020-05-26,0,0,2297,67,0.02732308980347847,0.029168480626904657,48,31
Africa,Congo,84068091,2020-05-27,248,0,2545,67,0.03027307947316182,0.026326129666011788,49,31
Europe,Denmark,5797446,2020-03-11,151,0,264,0,0.04553729349096137,0,0,39
Europe,Denmark,5797446,2020-03-12,252,0,516,0,0.08900471000506086,0,1,39
Europe,Denmark,5797446,2020-03-13,160,0,676,0,0.11660306969655258,0,2,39
Europe,Denmark,5797446,2020-03-14,128,0,804,0,0.13868175744974598,0,3,39
Europe,Denmark,5797446,2020-03-15,23,0,827,0,0.14264902165539792,0,4,39
Europe,Denmark,5797446,2020-03-16,48,1,875,1,0.15092852956284544,0.001142857142857143,5,39
Europe,Denmark,5797446,2020-03-17,57,0,932,1,0.16076044520293936,0.001072961373390558,6,39
Europe,Denmark,5797446,2020-03-18,92,3,1024,4,0.1766295020255471,0.00390625,7,39
Europe,Denmark,5797446,2020-03-19,91,0,1115,4,0.19232606910008304,0.003587443946188341,8,39
Europe,Denmark,5797446,2020-03-20,36,2,1151,6,0.19853570003066867,0.005212858384013901,9,39
Europe,Denmark,5797446,2020-03-21,104,3,1255,9,0.21647463383013832,0.007171314741035857,10,39
Europe,Denmark,5797446,2020-03-22,71,4,1326,13,0.22872140594323778,0.00980392156862745,11,39
Europe,Denmark,5797446,2020-03-23,69,0,1395,13,0.24062319856019357,0.00931899641577061,12,39
Europe,Denmark,5797446,2020-03-24,65,11,1460,24,0.2518350321848621,0.01643835616438356,13,39
Europe,Denmark,5797446,2020-03-25,131,8,1591,32,0.27443118918227094,0.02011313639220616,14,39
Europe,Denmark,5797446,2020-03-26,133,2,1724,34,0.29737232567582345,0.019721577726218097,15,39
Europe,Denmark,5797446,2020-03-27,153,7,1877,41,0.32376325713081244,0.02184336707511987,16,39
Europe,Denmark,5797446,2020-03-28,169,11,2046,52,0.3529140245549506,0.02541544477028348,17,39
Europe,Denmark,5797446,2020-03-29,155,13,2201,65,0.3796499355060832,0.029532030895047707,18,39
Europe,Denmark,5797446,2020-03-30,194,7,2395,72,0.413112946632017,0.030062630480167014,19,39
Europe,Denmark,5797446,2020-03-31,182,5,2577,77,0.4445060807810888,0.029879705083430345,20,39
Europe,Denmark,5797446,2020-04-01,283,13,2860,90,0.49332067948541475,0.03146853146853147,21,39
Europe,Denmark,5797446,2020-04-02,247,14,3107,104,0.5359256472591551,0.03347280334728033,22,39
Europe,Denmark,5797446,2020-04-03,279,19,3386,123,0.5840502869711939,0.036326048434731244,23,39
Europe,Denmark,5797446,2020-04-04,371,16,3757,139,0.6480439835058402,0.036997604471652915,24,39
Europe,Denmark,5797446,2020-04-05,320,22,4077,161,0.7032407028888238,0.03948982094677459,25,39
Europe,Denmark,5797446,2020-04-06,292,18,4369,179,0.7536077093257962,0.04097047379262989,26,39
Europe,Denmark,5797446,2020-04-07,312,8,4681,187,0.8074245107242051,0.03994872890408033,27,39
Europe,Denmark,5797446,2020-04-08,390,16,5071,203,0.8746955124722162,0.040031551962137646,28,39
Europe,Denmark,5797446,2020-04-09,331,15,5402,218,0.9317896190839897,0.04035542391706775,29,39
Europe,Denmark,5797446,2020-04-10,233,19,5635,237,0.9719797303847246,0.042058562555456966,30,39
Europe,Denmark,5797446,2020-04-11,184,10,5819,247,1.00371784402994,0.04244715586870596,31,39
Europe,Denmark,5797446,2020-04-12,177,13,5996,260,1.0342485294386528,0.04336224149432955,32,39
Europe,Denmark,5797446,2020-04-13,178,13,6174,273,1.0649517045954373,0.04421768707482993,33,39
Europe,Denmark,5797446,2020-04-14,144,12,6318,285,1.08979022831778,0.04510921177587844,34,39
Europe,Denmark,5797446,2020-04-15,193,14,6511,299,1.1230807496956419,0.04592228536323145,35,39
Europe,Denmark,5797446,2020-04-16,170,10,6681,309,1.1524040068678518,0.046250561293219576,36,39
Europe,Denmark,5797446,2020-04-17,198,12,6879,321,1.1865569769860729,0.04666375926733537,37,39
Europe,Denmark,5797446,2020-04-18,194,15,7073,336,1.2200199881120066,0.04750459493849851,38,39
Europe,Denmark,5797446,2020-04-19,169,10,7242,346,1.2491707555361447,0.04777685722176194,39,39
Europe,Denmark,5797446,2020-04-20,142,9,7384,355,1.2736642997623437,0.04807692307692308,40,39
Europe,Denmark,5797446,2020-04-21,131,9,7515,364,1.2962604567597524,0.04843646041250832,41,39
Europe,Denmark,5797446,2020-04-22,180,6,7695,370,1.3273086114126806,0.04808317089018843,42,39
Europe,Denmark,5797446,2020-04-23,217,14,7912,384,1.3647388867442665,0.04853387259858443,43,39
Europe,Denmark,5797446,2020-04-24,161,10,8073,394,1.39250973618383,0.04880465750030968,44,39
Europe,Denmark,5797446,2020-04-25,137,9,8210,403,1.4161408316696698,0.04908647990255786,45,39
Europe,Denmark,5797446,2020-04-26,235,15,8445,418,1.4566759224665482,0.04949674363528715,46,39
Europe,Denmark,5797446,2020-04-27,130,4,8575,422,1.4790995897158852,0.04921282798833819,47,39
Europe,Denmark,5797446,2020-04-28,123,5,8698,427,1.5003158287287195,0.04909174522878823,48,39
Europe,Denmark,5797446,2020-04-29,153,7,8851,434,1.5267067601837085,0.049034007456784545,49,39
Europe,Denmark,5797446,2020-04-30,157,9,9008,443,1.5537876506309847,0.04917850799289521,50,39
Europe,Denmark,5797446,2020-05-01,150,9,9158,452,1.5796611128417584,0.049355754531557106,51,39
Europe,Denmark,5797446,2020-05-02,153,10,9311,462,1.6060520442967472,0.04961873053377725,52,39
Europe,Denmark,5797446,2020-05-03,96,11,9407,473,1.6226110601116421,0.050281705113213566,53,39
Europe,Denmark,5797446,2020-05-04,116,8,9523,481,1.6426198708879738,0.050509293289929647,54,39
Europe,Denmark,5797446,2020-05-05,147,9,9670,490,1.667975863854532,0.050672182006204755,55,39
Europe,Denmark,5797446,2020-05-06,151,7,9821,497,1.694021815813377,0.05060584461867427,56,39
Europe,Denmark,5797446,2020-05-07,162,3,9983,500,1.7219651550010124,0.050085144746068316,57,39
Europe,Denmark,5797446,2020-05-08,100,6,10083,506,1.739214129808195,0.050183477139740154,58,39
Europe,Denmark,5797446,2020-05-09,135,6,10218,512,1.7625002457978909,0.05010765316108828,59,39
Europe,Denmark,5797446,2020-05-10,101,4,10319,516,1.779921710353145,0.050004845430758796,60,39
Europe,Denmark,5797446,2020-05-11,110,3,10429,519,1.7988955826410458,0.04976507814747339,61,39
Europe,Denmark,5797446,2020-05-12,84,5,10513,524,1.8133847214790788,0.04984305146009702,62,39
Europe,Denmark,5797446,2020-05-13,78,4,10591,528,1.8268389218286811,0.0498536493248985,63,39
Europe,Denmark,5797446,2020-05-14,76,6,10667,534,1.8399481426821396,0.050060935595762635,64,39
Europe,Denmark,5797446,2020-05-15,46,4,10713,538,1.8478826710934435,0.050219359656492116,65,39
Europe,Denmark,5797446,2020-05-16,78,0,10791,538,1.8613368714430458,0.04985636178296729,66,39
Europe,Denmark,5797446,2020-05-17,67,5,10858,543,1.872893684563858,0.05000920979922638,67,39
Europe,Denmark,5797446,2020-05-18,69,4,10927,547,1.8847954771808137,0.05005948567767914,68,39
Europe,Denmark,5797446,2020-05-19,41,1,10968,548,1.8918675568517584,0.049963530269876,69,39
Europe,Denmark,5797446,2020-05-20,76,3,11044,551,1.9049767777052171,0.04989134371604491,70,39
Europe,Denmark,5797446,2020-05-21,73,3,11117,554,1.9175685293144602,0.049833588198254924,71,39
Europe,Denmark,5797446,2020-05-22,65,7,11182,561,1.9287803629391287,0.05016991593632624,72,39
Europe,Denmark,5797446,2020-05-23,48,0,11230,561,1.937059870846576,0.04995547640249332,73,39
Europe,Denmark,5797446,2020-05-24,59,0,11289,561,1.9472367659828138,0.04969439277172469,74,39
Europe,Denmark,5797446,2020-05-25,71,1,11360,562,1.9594835380959135,0.04947183098591549,75,39
Europe,Denmark,5797446,2020-05-26,27,1,11387,563,1.9641407612938526,0.049442346535522964,76,39
Europe,Denmark,5797446,2020-05-27,41,0,11428,563,1.9712128409647973,0.04926496324816241,77,39
Africa,Djibouti,958920,2020-03-31,7,0,26,0,0.027113836399282526,0,0,40
Africa,Djibouti,958920,2020-04-01,5,0,31,0,0.03232803570683686,0,1,40
Africa,Djibouti,958920,2020-04-02,3,0,34,0,0.03545655529136946,0,2,40
Africa,Djibouti,958920,2020-04-03,7,0,41,0,0.04275643432194552,0,3,40
Africa,Djibouti,958920,2020-04-04,0,0,41,0,0.04275643432194552,0,4,40
Africa,Djibouti,958920,2020-04-05,10,0,51,0,0.053184832937054186,0,5,40
Africa,Djibouti,958920,2020-04-06,8,0,59,0,0.061527551829141124,0,6,40
Africa,Djibouti,958920,2020-04-07,31,0,90,0,0.09385558753597797,0,7,40
Africa,Djibouti,958920,2020-04-08,31,0,121,0,0.12618362324281485,0,8,40
Africa,Djibouti,958920,2020-04-09,14,0,135,0,0.14078338130396695,0,9,40
Africa,Djibouti,958920,2020-04-10,5,1,140,1,0.1459975806115213,0.007142857142857143,10,40
Africa,Djibouti,958920,2020-04-11,10,0,150,1,0.15642597922662996,0.006666666666666667,11,40
Africa,Djibouti,958920,2020-04-12,37,1,187,2,0.195011054102532,0.0106951871657754,12,40
Africa,Djibouti,958920,2020-04-13,27,0,214,2,0.2231677303633254,0.009345794392523364,13,40
Africa,Djibouti,958920,2020-04-14,84,0,298,2,0.3107662787302382,0.006711409395973154,14,40
Africa,Djibouti,958920,2020-04-15,65,0,363,2,0.3785508697284445,0.005509641873278237,15,40
Africa,Djibouti,958920,2020-04-16,72,0,435,2,0.45363533975722686,0.004597701149425287,16,40
Africa,Djibouti,958920,2020-04-17,156,0,591,2,0.616318358152922,0.00338409475465313,17,40
Africa,Djibouti,958920,2020-04-18,141,0,732,2,0.7633587786259541,0.00273224043715847,18,40
Africa,Djibouti,958920,2020-04-19,0,0,732,2,0.7633587786259541,0.00273224043715847,19,40
Africa,Djibouti,958920,2020-04-20,114,0,846,2,0.8822425228381929,0.002364066193853428,20,40
Africa,Djibouti,958920,2020-04-21,0,0,846,2,0.8822425228381929,0.002364066193853428,21,40
Africa,Djibouti,958920,2020-04-22,99,0,945,2,0.9854836691277687,0.0021164021164021165,22,40
Africa,Djibouti,958920,2020-04-23,29,0,974,2,1.0157260251115838,0.002053388090349076,23,40
Africa,Djibouti,958920,2020-04-24,12,0,986,2,1.0282401034497142,0.002028397565922921,24,40
Africa,Djibouti,958920,2020-04-25,13,0,999,2,1.0417970216493555,0.002002002002002002,25,40
Africa,Djibouti,958920,2020-04-26,9,0,1008,2,1.0511825804029533,0.001984126984126984,26,40
Africa,Djibouti,958920,2020-04-27,15,0,1023,2,1.0668251783256164,0.0019550342130987292,27,40
Africa,Djibouti,958920,2020-04-28,12,0,1035,2,1.0793392566637467,0.001932367149758454,28,40
Africa,Djibouti,958920,2020-04-29,37,0,1072,2,1.1179243315396488,0.0018656716417910447,29,40
Africa,Djibouti,958920,2020-04-30,5,0,1077,2,1.123138530847203,0.0018570102135561746,30,40
Africa,Djibouti,958920,2020-05-01,12,0,1089,2,1.1356526091853334,0.0018365472910927456,31,40
Africa,Djibouti,958920,2020-05-02,8,0,1097,2,1.1439953280774204,0.0018231540565177757,32,40
Africa,Djibouti,958920,2020-05-03,15,0,1112,2,1.1596379260000835,0.0017985611510791368,33,40
Africa,Djibouti,958920,2020-05-04,0,0,1112,2,1.1596379260000835,0.0017985611510791368,34,40
Africa,Djibouti,958920,2020-05-05,4,0,1116,2,1.1638092854461268,0.0017921146953405018,35,40
Africa,Djibouti,958920,2020-05-06,4,0,1120,2,1.1679806448921703,0.0017857142857142857,36,40
Africa,Djibouti,958920,2020-05-07,0,1,1120,3,1.1679806448921703,0.0026785714285714286,37,40
Africa,Djibouti,958920,2020-05-08,13,0,1133,3,1.1815375630918115,0.00264783759929391,38,40
Africa,Djibouti,958920,2020-05-09,2,0,1135,3,1.1836232428148332,0.0026431718061674008,39,40
Africa,Djibouti,958920,2020-05-10,54,0,1189,3,1.2399365953364203,0.002523128679562658,40,40
Africa,Djibouti,958920,2020-05-11,21,0,1210,3,1.2618362324281482,0.0024793388429752068,41,40
Africa,Djibouti,958920,2020-05-12,17,0,1227,3,1.2795645100738329,0.0024449877750611247,42,40
Africa,Djibouti,958920,2020-05-13,29,0,1256,3,1.3098068660576483,0.0023885350318471337,43,40
Africa,Djibouti,958920,2020-05-14,12,0,1268,3,1.3223209443957786,0.002365930599369085,44,40
Africa,Djibouti,958920,2020-05-15,16,0,1284,3,1.3390063821799525,0.002336448598130841,45,40
Africa,Djibouti,958920,2020-05-16,25,1,1309,4,1.3650773787177242,0.0030557677616501145,46,40
Africa,Djibouti,958920,2020-05-17,22,0,1331,4,1.3880198556709633,0.003005259203606311,47,40
Africa,Djibouti,958920,2020-05-18,70,0,1401,4,1.4610186459767238,0.0028551034975017845,48,40
Africa,Djibouti,958920,2020-05-19,117,3,1518,7,1.5830309097734954,0.00461133069828722,49,40
Africa,Djibouti,958920,2020-05-20,0,0,1518,7,1.5830309097734954,0.00461133069828722,50,40
Africa,Djibouti,958920,2020-05-21,310,2,1828,9,1.9063112668418638,0.004923413566739606,51,40
Africa,Djibouti,958920,2020-05-22,219,1,2047,10,2.1346931965127434,0.004885197850512946,52,40
Africa,Djibouti,958920,2020-05-23,223,0,2270,10,2.3672464856296664,0.004405286343612335,53,40
Africa,Djibouti,958920,2020-05-24,0,0,2270,10,2.3672464856296664,0.004405286343612335,54,40
Africa,Djibouti,958920,2020-05-25,0,0,2270,10,2.3672464856296664,0.004405286343612335,55,40
Africa,Djibouti,958920,2020-05-26,198,4,2468,14,2.5737287782088183,0.005672609400324149,56,40
Africa,Djibouti,958920,2020-05-27,0,0,2468,14,2.5737287782088183,0.005672609400324149,57,40
America,Dominican Republic,10627165,2020-03-24,43,0,245,3,0.023054125912225887,0.012244897959183673,0,41
America,Dominican Republic,10627165,2020-03-25,67,3,312,6,0.02935872361067133,0.019230769230769232,1,41
America,Dominican Republic,10627165,2020-03-26,80,4,392,10,0.036886601459561415,0.025510204081632654,2,41
America,Dominican Republic,10627165,2020-03-27,96,0,488,10,0.04592005487822952,0.020491803278688523,3,41
America,Dominican Republic,10627165,2020-03-28,93,10,581,20,0.05467121287756424,0.03442340791738382,4,41
America,Dominican Republic,10627165,2020-03-29,138,8,719,28,0.067656802166899635,0.03894297635605007,5,41
America,Dominican Republic,10627165,2020-03-30,140,11,859,39,0.08083058840245728,0.04540162980209546,6,41
America,Dominican Republic,10627165,2020-03-31,42,3,901,42,0.08478272427312458,0.04661487236403995,7,41
America,Dominican Republic,10627165,2020-04-01,208,9,1109,51,0.1043552066802388,0.045987376014427414,8,41
America,Dominican Republic,10627165,2020-04-02,175,6,1284,57,0.12082243947468586,0.04439252336448598,9,41
America,Dominican Republic,10627165,2020-04-03,96,3,1380,60,0.12985589289335397,0.043478260869565216,10,41
America,Dominican Republic,10627165,2020-04-04,108,8,1488,68,0.14001852798935557,0.0456989247311828,11,41
America,Dominican Republic,10627165,2020-04-05,90,9,1578,77,0.14848739056935692,0.048795944233206594,12,41
America,Dominican Republic,10627165,2020-04-06,167,5,1745,82,0.16420183557891496,0.04699140401146132,13,41
America,Dominican Republic,10627165,2020-04-07,83,4,1828,86,0.17201200884713844,0.047045951859956234,14,41
America,Dominican Republic,10627165,2020-04-08,128,12,1956,98,0.18405661340536256,0.050102249488752554,15,41
America,Dominican Republic,10627165,2020-04-09,155,10,2111,108,0.19864187673758713,0.05116058739933681,16,41
America,Dominican Republic,10627165,2020-04-10,238,10,2349,118,0.2210373133380351,0.05023414218816517,17,41
America,Dominican Republic,10627165,2020-04-11,271,8,2620,126,0.2465379995511503,0.048091603053435114,18,41
America,Dominican Republic,10627165,2020-04-12,139,9,2759,135,0.2596176873135968,0.04893077201884741,19,41
America,Dominican Republic,10627165,2020-04-13,208,38,2967,173,0.27919016972071103,0.058308055274688235,20,41
America,Dominican Republic,10627165,2020-04-14,200,4,3167,177,0.2980098643429362,0.055888853804862644,21,41
America,Dominican Republic,10627165,2020-04-15,119,6,3286,183,0.3092075826431603,0.055690809494826535,22,41
America,Dominican Republic,10627165,2020-04-16,328,6,3614,189,0.3400718818236096,0.052296624239070284,23,41
America,Dominican Republic,10627165,2020-04-17,141,7,3755,196,0.35333976653227833,0.052197070572569906,24,41
America,Dominican Republic,10627165,2020-04-18,371,4,4126,200,0.3882503000565061,0.048473097430925836,25,41
America,Dominican Republic,10627165,2020-04-19,209,17,4335,217,0.40791688093673145,0.05005767012687428,26,41
America,Dominican Republic,10627165,2020-04-20,345,9,4680,226,0.44038085416006995,0.04829059829059829,27,41
America,Dominican Republic,10627165,2020-04-21,284,9,4964,235,0.4671048205236298,0.04734085414987913,28,41
America,Dominican Republic,10627165,2020-04-22,80,10,5044,245,0.47463269837251987,0.0485725614591594,29,41
America,Dominican Republic,10627165,2020-04-23,256,15,5300,260,0.4987219074889681,0.04905660377358491,30,41
America,Dominican Republic,10627165,2020-04-24,243,5,5543,265,0.5215878364549718,0.047808046184376694,31,41
America,Dominican Republic,10627165,2020-04-25,206,2,5749,267,0.5409721219158637,0.04644285962776135,32,41
America,Dominican Republic,10627165,2020-04-26,177,6,5926,273,0.5576275516565331,0.04606817414782315,33,41
America,Dominican Republic,10627165,2020-04-27,209,5,6135,278,0.5772941325367584,0.045313773431132846,34,41
America,Dominican Republic,10627165,2020-04-28,0,0,6135,278,0.5772941325367584,0.045313773431132846,35,41
America,Dominican Republic,10627165,2020-04-29,281,8,6416,286,0.6037358034809849,0.044576059850374064,36,41
America,Dominican Republic,10627165,2020-04-30,236,7,6652,293,0.6259430431352105,0.044046903187011426,37,41
America,Dominican Republic,10627165,2020-05-01,320,8,6972,301,0.6560545545307709,0.04317269076305221,38,41
America,Dominican Republic,10627165,2020-05-02,316,12,7288,313,0.6857896720338867,0.04294731064763996,39,41
America,Dominican Republic,10627165,2020-05-03,290,13,7578,326,0.7130782292361133,0.043019266297176034,40,41
America,Dominican Republic,10627165,2020-05-04,376,7,7954,333,0.7484592551258967,0.04186572793562987,41,41
America,Dominican Republic,10627165,2020-05-05,281,13,8235,346,0.7749009260701232,0.04201578627808136,42,41
America,Dominican Republic,10627165,2020-05-06,245,8,8480,354,0.7979550519823491,0.04174528301886792,43,41
America,Dominican Republic,10627165,2020-05-07,327,8,8807,362,0.8287252526896872,0.04110366753718633,44,41
America,Dominican Republic,10627165,2020-05-08,288,11,9095,373,0.8558256129456916,0.041011544804837825,45,41
America,Dominican Republic,10627165,2020-05-09,281,7,9376,380,0.8822672838899179,0.04052901023890785,46,41
America,Dominican Republic,10627165,2020-05-10,506,5,9882,385,0.9298811112841477,0.03895972475207448,47,41
America,Dominican Republic,10627165,2020-05-11,465,3,10347,388,0.9736369012808214,0.03749879192036339,48,41
America,Dominican Republic,10627165,2020-05-12,287,5,10634,393,1.0006431630637145,0.036956930599962384,49,41
America,Dominican Republic,10627165,2020-05-13,266,9,10900,402,1.0256733569112741,0.03688073394495413,50,41
America,Dominican Republic,10627165,2020-05-14,296,7,11196,409,1.0535265049521674,0.03653090389424794,51,41
America,Dominican Republic,10627165,2020-05-15,124,13,11320,422,1.065194715617947,0.037279151943462895,52,41
America,Dominican Republic,10627165,2020-05-16,419,2,11739,424,1.1046219758515088,0.03611891983985007,53,41
America,Dominican Republic,10627165,2020-05-17,154,0,11893,424,1.1191131407106223,0.035651223408727825,54,41
America,Dominican Republic,10627165,2020-05-18,421,4,12314,428,1.1587285978904063,0.03475718694169238,55,41
America,Dominican Republic,10627165,2020-05-19,411,6,12725,434,1.197403070339079,0.034106090373280946,56,41
America,Dominican Republic,10627165,2020-05-20,498,7,13223,441,1.24426410994842,0.03335097935415564,57,41
America,Dominican Republic,10627165,2020-05-21,254,5,13477,446,1.2681651221186458,0.03309341841656155,58,41
America,Dominican Republic,10627165,2020-05-22,180,2,13657,448,1.2851028472786488,0.032803690415171706,59,41
America,Dominican Republic,10627165,2020-05-23,332,8,13989,456,1.3163435403515427,0.03259704053184645,60,41
America,Dominican Republic,10627165,2020-05-24,433,2,14422,458,1.35708817920866,0.03175703785882679,61,41
America,Dominican Republic,10627165,2020-05-25,0,0,14422,458,1.35708817920866,0.03175703785882679,62,41
America,Dominican Republic,10627165,2020-05-26,651,2,15073,460,1.4183462852040032,0.030518145027532674,63,41
America,Dominican Republic,10627165,2020-05-27,191,8,15264,468,1.4363190935682282,0.030660377358490566,64,41
America,Ecuador,17084357,2020-03-21,227,4,426,7,0.024935091206534726,0.01643192488262911,0,42
America,Ecuador,17084357,2020-03-22,106,0,532,7,0.0311395974691936,0.013157894736842105,1,42
America,Ecuador,17084357,2020-03-23,257,7,789,14,0.04618259850224389,0.017743979721166033,2,42
America,Ecuador,17084357,2020-03-24,192,4,981,18,0.057420949468569404,0.01834862385321101,3,42
America,Ecuador,17084357,2020-03-25,101,9,1082,27,0.06333279034148022,0.024953789279112754,4,42
America,Ecuador,17084357,2020-03-26,129,2,1211,29,0.07088355739698017,0.023947151114781174,5,42
America,Ecuador,17084357,2020-03-27,192,5,1403,34,0.08212190836330568,0.024233784746970778,6,42
America,Ecuador,17084357,2020-03-28,224,7,1627,41,0.09523331782401878,0.02519975414874001,7,42
America,Ecuador,17084357,2020-03-29,208,7,1835,48,0.10740819803753808,0.026158038147138966,8,42
America,Ecuador,17084357,2020-03-30,55,10,1890,58,0.11062751732476675,0.030687830687830688,9,42
America,Ecuador,17084357,2020-03-31,76,4,1966,62,0.11507603124893725,0.03153611393692777,10,42
America,Ecuador,17084357,2020-04-01,336,17,2302,79,0.1347431454400069,0.03431798436142485,11,42
America,Ecuador,17084357,2020-04-02,456,41,2758,120,0.16143422898503,0.043509789702683106,12,42
America,Ecuador,17084357,2020-04-03,405,0,3163,120,0.18514012555462286,0.0379386658235852,13,42
America,Ecuador,17084357,2020-04-04,205,25,3368,145,0.19713940653429332,0.043052256532066506,14,42
America,Ecuador,17084357,2020-04-05,97,27,3465,172,0.2028171150954057,0.04963924963924964,15,42
America,Ecuador,17084357,2020-04-06,181,8,3646,180,0.21341160220428548,0.04936917169500823,16,42
America,Ecuador,17084357,2020-04-07,101,11,3747,191,0.2193234430771963,0.05097411262343208,17,42
America,Ecuador,17084357,2020-04-08,248,29,3995,220,0.23383964640870006,0.05506883604505632,18,42
America,Ecuador,17084357,2020-04-09,455,22,4450,242,0.26047219687577355,0.05438202247191011,19,42
America,Ecuador,17084357,2020-04-10,515,30,4965,272,0.29061673201982374,0.054783484390735146,20,42
America,Ecuador,17084357,2020-04-11,2196,25,7161,297,0.4191553711971718,0.041474654377880185,21,42
America,Ecuador,17084357,2020-04-12,96,18,7257,315,0.42477454668033454,0.0434063662670525,22,42
America,Ecuador,17084357,2020-04-13,209,18,7466,333,0.4370079599718034,0.04460219662469864,23,42
America,Ecuador,17084357,2020-04-14,63,22,7529,355,0.440695543882629,0.04715101607119139,24,42
America,Ecuador,17084357,2020-04-15,74,0,7603,355,0.44502699165090026,0.04669209522556885,25,42
America,Ecuador,17084357,2020-04-16,255,33,7858,388,0.45995292652805136,0.04937643166200051,26,42
America,Ecuador,17084357,2020-04-17,367,15,8225,403,0.481434566135559,0.04899696048632219,27,42
America,Ecuador,17084357,2020-04-18,225,18,8450,421,0.49460450867422173,0.04982248520710059,28,42
America,Ecuador,17084357,2020-04-19,572,35,9022,456,0.5280854292613997,0.050543116825537575,29,42
America,Ecuador,17084357,2020-04-20,446,18,9468,474,0.5541911820269267,0.050063371356147024,30,42
America,Ecuador,17084357,2020-04-21,660,33,10128,507,0.5928230134736706,0.05005924170616114,31,42
America,Ecuador,17084357,2020-04-22,270,13,10398,520,0.6086269445200659,0.05000961723408348,32,42
America,Ecuador,17084357,2020-04-23,452,17,10850,537,0.6350838957532906,0.049493087557603684,33,42
America,Ecuador,17084357,2020-04-24,333,23,11183,560,0.6545754107105114,0.05007600822677278,34,42
America,Ecuador,17084357,2020-04-25,0,16,11183,576,0.6545754107105114,0.05150675131896629,35,42
America,Ecuador,17084357,2020-04-26,0,0,11183,576,0.6545754107105114,0.05150675131896629,36,42
America,Ecuador,17084357,2020-04-27,11536,0,22719,576,1.3298129979372357,0.025353228575201375,37,42
America,Ecuador,17084357,2020-04-28,521,87,23240,663,1.3603087315489837,0.02852839931153184,38,42
America,Ecuador,17084357,2020-04-29,1018,208,24258,871,1.4198954049016888,0.03590568060021436,39,42
America,Ecuador,17084357,2020-04-30,417,12,24675,883,1.444303698406677,0.03578520770010132,40,42
America,Ecuador,17084357,2020-05-01,259,17,24934,900,1.4594637655956264,0.03609529156974412,41,42
America,Ecuador,17084357,2020-05-02,1402,163,26336,1063,1.5415271408809825,0.04036300121506683,42,42
America,Ecuador,17084357,2020-05-03,1128,308,27464,1371,1.6075524528081448,0.049919895135450046,43,42
America,Ecuador,17084357,2020-05-04,2074,193,29538,1564,1.7289500564756404,0.052948743990791525,44,42
America,Ecuador,17084357,2020-05-05,2343,5,31881,1569,1.866093058111581,0.04921426555001412,45,42
America,Ecuador,17084357,2020-05-06,0,0,31881,1569,1.866093058111581,0.04921426555001412,46,42
America,Ecuador,17084357,2020-05-08,878,36,30298,1654,1.7734351957173453,0.05459106211631131,48,42
America,Ecuador,17084357,2020-05-10,253,13,29071,1717,1.7016151090731713,0.05906229575865983,50,42
America,Ecuador,17084357,2020-05-11,488,410,29559,2127,1.7301792511125822,0.07195777935654116,51,42
America,Ecuador,17084357,2020-05-13,910,182,30419,2327,1.7805176981492483,0.07649824123080969,53,42
America,Ecuador,17084357,2020-05-14,67,7,30486,2334,1.7844394143718725,0.0765597323361543,54,42
America,Ecuador,17084357,2020-05-15,16,4,30502,2338,1.7853759436190662,0.07665071142875877,55,42
America,Ecuador,17084357,2020-05-16,965,256,31467,2594,1.8418603638404418,0.08243556741983665,56,42
America,Ecuador,17084357,2020-05-17,1296,94,32763,2688,1.9177192328631392,0.08204376888563318,57,42
America,Ecuador,17084357,2020-05-18,419,48,33182,2736,1.9422445925240264,0.08245434271593033,58,42
America,Ecuador,17084357,2020-05-19,400,63,33582,2799,1.965657823703871,0.08334822226192604,59,42
America,Ecuador,17084357,2020-05-20,569,40,34151,2839,1.9989631450572005,0.0831308014406606,60,42
America,Ecuador,17084357,2020-05-21,703,49,34854,2888,2.040111898855778,0.08285992999368795,61,42
America,Ecuador,17084357,2020-05-22,452,51,35306,2939,2.0665688500890025,0.0832436413074265,62,42
America,Ecuador,17084357,2020-05-23,522,117,35828,3056,2.0971231167787,0.08529641621078486,63,42
America,Ecuador,17084357,2020-05-24,430,40,36258,3096,2.122292340297033,0.08538805229190799,64,42
America,Ecuador,17084357,2020-05-25,498,12,36756,3108,2.15144181311594,0.08455762324518445,65,42
America,Ecuador,17084357,2020-05-26,599,95,37355,3203,2.1865031268077577,0.08574488020345335,66,42
America,Ecuador,17084357,2020-05-27,0,0,37355,3203,2.1865031268077577,0.08574488020345335,67,42
Africa,Egypt,98423595,2020-04-13,126,13,2065,159,0.020980741457371072,0.07699757869249395,0,43
Africa,Egypt,98423595,2020-04-14,125,5,2190,164,0.02225076212670346,0.07488584474885844,1,43
Africa,Egypt,98423595,2020-04-15,160,14,2350,178,0.02387638858344892,0.07574468085106383,2,43
Africa,Egypt,98423595,2020-04-16,155,5,2505,183,0.02545121421342108,0.07305389221556886,3,43
Africa,Egypt,98423595,2020-04-17,168,13,2673,196,0.02715812199300381,0.07332585110362888,4,43
Africa,Egypt,98423595,2020-04-18,171,9,2844,205,0.02889551026865052,0.0720815752461322,5,43
Africa,Egypt,98423595,2020-04-19,188,19,3032,224,0.03080562135532643,0.07387862796833773,6,43
Africa,Egypt,98423595,2020-04-20,112,15,3144,239,0.03194355987504825,0.07601781170483461,7,43
Africa,Egypt,98423595,2020-04-21,189,11,3333,250,0.033863831127078824,0.075007500750075,8,43
Africa,Egypt,98423595,2020-04-22,157,14,3490,264,0.03545897708776031,0.07564469914040114,9,43
Africa,Egypt,98423595,2020-04-23,0,0,3490,264,0.03545897708776031,0.07564469914040114,10,43
Africa,Egypt,98423595,2020-04-24,169,12,3659,276,0.0371760450326977,0.07543044547690626,11,43
Africa,Egypt,98423595,2020-04-25,433,18,4092,294,0.041575396631265096,0.0718475073313783,12,43
Africa,Egypt,98423595,2020-04-26,227,13,4319,307,0.043881754166772716,0.07108126881222505,13,43
Africa,Egypt,98423595,2020-04-27,0,0,4319,307,0.043881754166772716,0.07108126881222505,14,43
Africa,Egypt,98423595,2020-04-28,463,30,4782,337,0.04858591072597988,0.07047260560434965,15,43
Africa,Egypt,98423595,2020-04-29,260,22,5042,359,0.05122755371819126,0.07120190400634668,16,43
Africa,Egypt,98423595,2020-04-30,226,21,5268,380,0.05352375108834421,0.0721336370539104,17,43
Africa,Egypt,98423595,2020-05-01,269,12,5537,392,0.05625683556874751,0.07079646017699115,18,43
Africa,Egypt,98423595,2020-05-02,358,14,5895,406,0.05989417476571548,0.06887192536047498,19,43
Africa,Egypt,98423595,2020-05-03,298,9,6193,415,0.06292190404140388,0.06701114161149685,20,43
Africa,Egypt,98423595,2020-05-04,272,14,6465,429,0.06568546901787117,0.06635730858468677,21,43
Africa,Egypt,98423595,2020-05-05,348,7,6813,436,0.06922120656129255,0.06399530309702041,22,43
Africa,Egypt,98423595,2020-05-06,388,16,7201,452,0.07316335071890029,0.06276905985279822,23,43
Africa,Egypt,98423595,2020-05-07,387,17,7588,469,0.07709533471115336,0.061808118081180814,24,43
Africa,Egypt,98423595,2020-05-08,393,13,7981,482,0.08108827969553438,0.06039343440671595,25,43
Africa,Egypt,98423595,2020-05-09,495,21,8476,503,0.08611756154609065,0.05934403020292591,26,43
Africa,Egypt,98423595,2020-05-10,488,11,8964,514,0.0910757222391643,0.05734047300312361,27,43
Africa,Egypt,98423595,2020-05-11,436,11,9400,525,0.09550555433379568,0.05585106382978723,28,43
Africa,Egypt,98423595,2020-05-12,346,8,9746,533,0.09902097154650773,0.0546891032218346,29,43
Africa,Egypt,98423595,2020-05-13,347,11,10093,544,0.10254654892457443,0.05389874170216982,30,43
Africa,Egypt,98423595,2020-05-14,338,12,10431,556,0.10598068481444922,0.05330265554596875,31,43
Africa,Egypt,98423595,2020-05-15,398,15,10829,571,0.11002443062560355,0.052728783821220794,32,43
Africa,Egypt,98423595,2020-05-16,399,21,11228,592,0.11407833660211253,0.052725329533309585,33,43
Africa,Egypt,98423595,2020-05-17,491,20,11719,612,0.11906697779125017,0.052222885911767214,34,43
Africa,Egypt,98423595,2020-05-18,510,18,12229,630,0.12424866212212632,0.05151688609044076,35,43
Africa,Egypt,98423595,2020-05-19,535,15,12764,645,0.12968435058686895,0.05053274835474773,36,43
Africa,Egypt,98423595,2020-05-20,720,14,13484,659,0.1369996696422235,0.04887273805992287,37,43
Africa,Egypt,98423595,2020-05-21,745,21,14229,680,0.14456899283144453,0.04778972520908005,38,43
Africa,Egypt,98423595,2020-05-22,774,16,15003,696,0.15243296081595067,0.046390721855628876,39,43
Africa,Egypt,98423595,2020-05-23,783,11,15786,707,0.16038837028864877,0.044786519701000886,40,43
Africa,Egypt,98423595,2020-05-24,827,28,16613,735,0.16879082703695186,0.04424246072352977,41,43
Africa,Egypt,98423595,2020-05-25,652,29,17265,764,0.17541525484818962,0.044251375615406895,42,43
Africa,Egypt,98423595,2020-05-26,702,19,17967,783,0.1825476909271603,0.04357989647687427,43,43
Africa,Egypt,98423595,2020-05-27,789,14,18756,797,0.19056406139198634,0.042493068884623585,44,43
America,El Salvador,6420744,2020-04-14,24,0,149,6,0.023206033444099314,0.040268456375838924,0,44
America,El Salvador,6420744,2020-04-15,10,0,159,6,0.024763485353099267,0.03773584905660377,1,44
America,El Salvador,6420744,2020-04-16,0,0,159,6,0.024763485353099267,0.03773584905660377,2,44
America,El Salvador,6420744,2020-04-17,5,0,164,6,0.025542211307599243,0.036585365853658534,3,44
America,El Salvador,6420744,2020-04-18,13,1,177,7,0.027566898789299184,0.03954802259887006,4,44
America,El Salvador,6420744,2020-04-19,13,0,190,7,0.029591586270999122,0.03684210526315789,5,44
America,El Salvador,6420744,2020-04-20,11,0,201,7,0.03130478337089907,0.03482587064676617,6,44
America,El Salvador,6420744,2020-04-21,17,0,218,7,0.033952451616198996,0.03211009174311927,7,44
America,El Salvador,6420744,2020-04-22,7,0,225,7,0.03504266795249896,0.03111111111111111,8,44
America,El Salvador,6420744,2020-04-23,12,1,237,8,0.036911610243298906,0.03375527426160337,9,44
America,El Salvador,6420744,2020-04-24,13,0,250,8,0.03893629772499885,0.032,10,44
America,El Salvador,6420744,2020-04-25,11,0,261,8,0.040649494824898796,0.03065134099616858,11,44
America,El Salvador,6420744,2020-04-26,37,0,298,8,0.04641206688819863,0.026845637583892617,12,44
America,El Salvador,6420744,2020-04-27,0,0,298,8,0.04641206688819863,0.026845637583892617,13,44
America,El Salvador,6420744,2020-04-28,25,0,323,8,0.050305696660698514,0.02476780185758514,14,44
America,El Salvador,6420744,2020-04-29,22,1,345,9,0.05373209086049841,0.02608695652173913,15,44
America,El Salvador,6420744,2020-04-30,32,0,377,9,0.05871593696929826,0.023872679045092837,16,44
America,El Salvador,6420744,2020-05-01,47,1,424,10,0.06603596094159805,0.02358490566037736,17,44
America,El Salvador,6420744,2020-05-02,22,0,446,10,0.06946235514139794,0.02242152466367713,18,44
America,El Salvador,6420744,2020-05-03,0,1,446,11,0.06946235514139794,0.02466367713004484,19,44
America,El Salvador,6420744,2020-05-04,109,1,555,12,0.08643858094949744,0.021621621621621623,20,44
America,El Salvador,6420744,2020-05-05,32,1,587,13,0.09142242705829728,0.022146507666098807,21,44
America,El Salvador,6420744,2020-05-06,0,1,587,14,0.09142242705829728,0.02385008517887564,22,44
America,El Salvador,6420744,2020-05-07,108,1,695,15,0.1082429076754968,0.02158273381294964,23,44
America,El Salvador,6420744,2020-05-08,0,0,695,15,0.1082429076754968,0.02158273381294964,24,44
America,El Salvador,6420744,2020-05-09,89,1,784,16,0.12210422966559638,0.02040816326530612,25,44
America,El Salvador,6420744,2020-05-10,105,1,889,17,0.1384574747100959,0.019122609673790775,26,44
America,El Salvador,6420744,2020-05-11,69,0,958,17,0.14920389288219557,0.017745302713987474,27,44
America,El Salvador,6420744,2020-05-12,40,1,998,18,0.15543370051819538,0.018036072144288578,28,44
America,El Salvador,6420744,2020-05-13,39,2,1037,20,0.16150776296329522,0.019286403085824494,29,44
America,El Salvador,6420744,2020-05-14,75,0,1112,20,0.17318865228079486,0.017985611510791366,30,44
America,El Salvador,6420744,2020-05-15,98,3,1210,23,0.18845168098899442,0.019008264462809916,31,44
America,El Salvador,6420744,2020-05-16,55,2,1265,25,0.19701766648849417,0.019762845849802372,32,44
America,El Salvador,6420744,2020-05-17,0,1,1265,26,0.19701766648849417,0.020553359683794466,33,44
America,El Salvador,6420744,2020-05-18,73,4,1338,30,0.20838706542419383,0.02242152466367713,34,44
America,El Salvador,6420744,2020-05-19,75,0,1413,30,0.22006795474169347,0.021231422505307854,35,44
America,El Salvador,6420744,2020-05-20,85,1,1498,31,0.23330629596819308,0.02069425901201602,36,44
America,El Salvador,6420744,2020-05-21,73,1,1571,32,0.24467569490389277,0.020369191597708464,37,44
America,El Salvador,6420744,2020-05-22,69,1,1640,33,0.25542211307599244,0.020121951219512196,38,44
America,El Salvador,6420744,2020-05-23,85,0,1725,33,0.268660454302492,0.019130434782608695,39,44
America,El Salvador,6420744,2020-05-24,94,2,1819,35,0.28330050224709163,0.019241341396371632,40,44
America,El Salvador,6420744,2020-05-25,96,0,1915,35,0.2982520405734912,0.018276762402088774,41,44
America,El Salvador,6420744,2020-05-26,68,1,1983,36,0.30884271355469084,0.018154311649016642,42,44
America,El Salvador,6420744,2020-05-27,59,0,2042,36,0.31803167981779057,0.01762977473065622,43,44
Africa,Equatorial Guinea,1308974,2020-04-15,20,0,41,0,0.03132224169464023,0,0,45
Africa,Equatorial Guinea,1308974,2020-04-16,10,0,51,0,0.03896181283967443,0,1,45
Africa,Equatorial Guinea,1308974,2020-04-17,0,0,51,0,0.03896181283967443,0,2,45
Africa,Equatorial Guinea,1308974,2020-04-18,28,0,79,0,0.0603526120457702,0,3,45
Africa,Equatorial Guinea,1308974,2020-04-19,0,0,79,0,0.0603526120457702,0,4,45
Africa,Equatorial Guinea,1308974,2020-04-20,0,0,79,0,0.0603526120457702,0,5,45
Africa,Equatorial Guinea,1308974,2020-04-21,0,0,79,0,0.0603526120457702,0,6,45
Africa,Equatorial Guinea,1308974,2020-04-22,0,0,79,0,0.0603526120457702,0,7,45
Africa,Equatorial Guinea,1308974,2020-04-23,4,0,83,0,0.06340844050378389,0,8,45
Africa,Equatorial Guinea,1308974,2020-04-24,1,1,84,1,0.0641723976182873,0.011904761904761904,9,45
Africa,Equatorial Guinea,1308974,2020-04-25,128,0,212,1,0.1619589082747251,0.0047169811320754715,10,45
Africa,Equatorial Guinea,1308974,2020-04-26,2,0,214,1,0.16348682250373195,0.004672897196261682,11,45
Africa,Equatorial Guinea,1308974,2020-04-27,44,0,258,1,0.19710093554188243,0.003875968992248062,12,45
Africa,Equatorial Guinea,1308974,2020-04-28,0,0,258,1,0.19710093554188243,0.003875968992248062,13,45
Africa,Equatorial Guinea,1308974,2020-04-29,57,0,315,1,0.24064649106857736,0.0031746031746031746,14,45
Africa,Equatorial Guinea,1308974,2020-04-30,0,0,315,1,0.24064649106857736,0.0031746031746031746,15,45
Africa,Equatorial Guinea,1308974,2020-05-01,0,0,315,1,0.24064649106857736,0.0031746031746031746,16,45
Africa,Equatorial Guinea,1308974,2020-05-02,0,0,315,1,0.24064649106857736,0.0031746031746031746,17,45
Africa,Equatorial Guinea,1308974,2020-05-03,0,0,315,1,0.24064649106857736,0.0031746031746031746,18,45
Africa,Equatorial Guinea,1308974,2020-05-04,0,0,315,1,0.24064649106857736,0.0031746031746031746,19,45
Africa,Equatorial Guinea,1308974,2020-05-05,0,1,315,2,0.24064649106857736,0.006349206349206349,20,45
Africa,Equatorial Guinea,1308974,2020-05-06,124,2,439,4,0.3353771732670015,0.009111617312072893,21,45
Africa,Equatorial Guinea,1308974,2020-05-07,0,0,439,4,0.3353771732670015,0.009111617312072893,22,45
Africa,Equatorial Guinea,1308974,2020-05-08,0,0,439,4,0.3353771732670015,0.009111617312072893,23,45
Africa,Equatorial Guinea,1308974,2020-05-09,0,0,439,4,0.3353771732670015,0.009111617312072893,24,45
Africa,Equatorial Guinea,1308974,2020-05-10,0,0,439,4,0.3353771732670015,0.009111617312072893,25,45
Africa,Equatorial Guinea,1308974,2020-05-11,0,0,439,4,0.3353771732670015,0.009111617312072893,26,45
Africa,Equatorial Guinea,1308974,2020-05-12,0,0,439,4,0.3353771732670015,0.009111617312072893,27,45
Africa,Equatorial Guinea,1308974,2020-05-13,0,0,439,4,0.3353771732670015,0.009111617312072893,28,45
Africa,Equatorial Guinea,1308974,2020-05-14,83,2,522,6,0.39878561377078536,0.011494252873563218,29,45
Africa,Equatorial Guinea,1308974,2020-05-15,72,1,594,7,0.4537905260150316,0.011784511784511785,30,45
Africa,Equatorial Guinea,1308974,2020-05-16,0,0,594,7,0.4537905260150316,0.011784511784511785,31,45
Africa,Equatorial Guinea,1308974,2020-05-17,0,0,594,7,0.4537905260150316,0.011784511784511785,32,45
Africa,Equatorial Guinea,1308974,2020-05-18,0,0,594,7,0.4537905260150316,0.011784511784511785,33,45
Africa,Equatorial Guinea,1308974,2020-05-19,125,0,719,7,0.5492851653279591,0.009735744089012517,34,45
Africa,Equatorial Guinea,1308974,2020-05-20,171,0,890,7,0.679921831908044,0.007865168539325843,35,45
Africa,Equatorial Guinea,1308974,2020-05-21,0,0,890,7,0.679921831908044,0.007865168539325843,36,45
Africa,Equatorial Guinea,1308974,2020-05-22,13,3,903,10,0.6898532743965885,0.01107419712070875,37,45
Africa,Equatorial Guinea,1308974,2020-05-23,0,0,903,10,0.6898532743965885,0.01107419712070875,38,45
Africa,Equatorial Guinea,1308974,2020-05-24,140,2,1043,12,0.7968072704270673,0.011505273250239693,39,45
Africa,Equatorial Guinea,1308974,2020-05-25,0,0,1043,12,0.7968072704270673,0.011505273250239693,40,45
Africa,Equatorial Guinea,1308974,2020-05-26,0,0,1043,12,0.7968072704270673,0.011505273250239693,41,45
Africa,Equatorial Guinea,1308974,2020-05-27,0,0,1043,12,0.7968072704270673,0.011505273250239693,42,45
Europe,Estonia,1320884,2020-03-13,11,0,27,0,0.02044085627504005,0,0,46
Europe,Estonia,1320884,2020-03-14,52,0,79,0,0.059808431323265326,0,1,46
Europe,Estonia,1320884,2020-03-15,36,0,115,0,0.08706290635665206,0,2,46
Europe,Estonia,1320884,2020-03-16,56,0,171,0,0.12945875640858695,0,3,46
Europe,Estonia,1320884,2020-03-17,34,0,205,0,0.15519909394011888,0,4,46
Europe,Estonia,1320884,2020-03-18,20,0,225,0,0.17034046895866706,0,5,46
Europe,Estonia,1320884,2020-03-19,33,0,258,0,0.19532373773927156,0,6,46
Europe,Estonia,1320884,2020-03-20,9,0,267,0,0.20213735649761827,0,7,46
Europe,Estonia,1320884,2020-03-21,16,0,283,0,0.2142504565124568,0,8,46
Europe,Estonia,1320884,2020-03-22,23,0,306,0,0.23166303778378722,0,9,46
Europe,Estonia,1320884,2020-03-23,20,0,326,0,0.2468044128023354,0,10,46
Europe,Estonia,1320884,2020-03-24,26,0,352,0,0.26648820032644804,0,11,46
Europe,Estonia,1320884,2020-03-25,17,0,369,0,0.279358369092214,0,12,46
Europe,Estonia,1320884,2020-03-26,35,1,404,1,0.30585577537467334,0.0024752475247524753,13,46
Europe,Estonia,1320884,2020-03-27,134,0,538,1,0.40730298799894615,0.0018587360594795538,14,46
Europe,Estonia,1320884,2020-03-28,37,0,575,1,0.4353145317832603,0.0017391304347826088,15,46
Europe,Estonia,1320884,2020-03-29,65,0,640,1,0.4845240005935419,0.0015625,16,46
Europe,Estonia,1320884,2020-03-30,39,2,679,3,0.5140496818797108,0.004418262150220913,17,46
Europe,Estonia,1320884,2020-03-31,36,0,715,3,0.5413041569130976,0.004195804195804196,18,46
Europe,Estonia,1320884,2020-04-01,30,1,745,4,0.5640162194409198,0.005369127516778523,19,46
Europe,Estonia,1320884,2020-04-02,34,1,779,5,0.5897565569724518,0.006418485237483954,20,46
Europe,Estonia,1320884,2020-04-03,79,6,858,11,0.6495649882957171,0.01282051282051282,21,46
Europe,Estonia,1320884,2020-04-04,103,1,961,12,0.7275430696412403,0.012486992715920915,22,46
Europe,Estonia,1320884,2020-04-05,57,1,1018,13,0.7706959884441026,0.012770137524557957,23,46
Europe,Estonia,1320884,2020-04-06,79,2,1097,15,0.8305044197673679,0.013673655423883319,24,46
Europe,Estonia,1320884,2020-04-07,11,4,1108,19,0.8388321760275694,0.017148014440433214,25,46
Europe,Estonia,1320884,2020-04-08,41,2,1149,21,0.8698719948155932,0.018276762402088774,26,46
Europe,Estonia,1320884,2020-04-09,36,3,1185,24,0.8971264698489799,0.020253164556962026,27,46
Europe,Estonia,1320884,2020-04-10,22,0,1207,24,0.9137819823693829,0.01988400994200497,28,46
Europe,Estonia,1320884,2020-04-11,51,0,1258,24,0.9523924886666808,0.019077901430842606,29,46
Europe,Estonia,1320884,2020-04-12,46,0,1304,24,0.9872176512093416,0.018404907975460124,30,46
Europe,Estonia,1320884,2020-04-13,5,1,1309,25,0.9910029949639788,0.019098548510313215,31,46
Europe,Estonia,1320884,2020-04-14,23,3,1332,28,1.008415576235309,0.021021021021021023,32,46
Europe,Estonia,1320884,2020-04-15,41,3,1373,31,1.039455395023333,0.022578295702840496,33,46
Europe,Estonia,1320884,2020-04-16,29,4,1402,35,1.0614103888002278,0.024964336661911554,34,46
Europe,Estonia,1320884,2020-04-17,32,1,1434,36,1.0856365888299049,0.02510460251046025,35,46
Europe,Estonia,1320884,2020-04-18,25,2,1459,38,1.1045633076030899,0.02604523646333105,36,46
Europe,Estonia,1320884,2020-04-19,53,0,1512,38,1.1446879514022428,0.02513227513227513,37,46
Europe,Estonia,1320884,2020-04-20,16,2,1528,40,1.1568010514170814,0.02617801047120419,38,46
Europe,Estonia,1320884,2020-04-21,7,0,1535,40,1.1621005326735732,0.026058631921824105,39,46
Europe,Estonia,1320884,2020-04-22,17,3,1552,43,1.1749707014393391,0.027706185567010308,40,46
Europe,Estonia,1320884,2020-04-23,7,1,1559,44,1.1802701826958308,0.028223220012828735,41,46
Europe,Estonia,1320884,2020-04-24,33,1,1592,45,1.2052534514764355,0.028266331658291458,42,46
Europe,Estonia,1320884,2020-04-25,13,1,1605,46,1.2150953452384918,0.02866043613707165,43,46
Europe,Estonia,1320884,2020-04-26,30,0,1635,46,1.2378074077663141,0.028134556574923548,44,46
Europe,Estonia,1320884,2020-04-27,8,3,1643,49,1.2438639577737334,0.02982349360925137,45,46
Europe,Estonia,1320884,2020-04-28,4,1,1647,50,1.246892232777443,0.030358227079538554,46,46
Europe,Estonia,1320884,2020-04-29,13,0,1660,50,1.2567341265394993,0.030120481927710843,47,46
Europe,Estonia,1320884,2020-04-30,6,0,1666,50,1.2612765390450638,0.030012004801920768,48,46
Europe,Estonia,1320884,2020-05-01,23,2,1689,52,1.2786891203163941,0.03078744819419775,49,46
Europe,Estonia,1320884,2020-05-02,5,0,1694,52,1.2824744640710313,0.030696576151121605,50,46
Europe,Estonia,1320884,2020-05-03,5,1,1699,53,1.2862598078256682,0.031194820482636845,51,46
Europe,Estonia,1320884,2020-05-04,1,2,1700,55,1.2870168765765957,0.03235294117647059,52,46
Europe,Estonia,1320884,2020-05-05,3,0,1703,55,1.2892880828293778,0.03229594832648268,53,46
Europe,Estonia,1320884,2020-05-06,8,0,1711,55,1.2953446328367972,0.032144944476914086,54,46
Europe,Estonia,1320884,2020-05-07,2,0,1713,55,1.2968587703386518,0.03210741389375365,55,46
Europe,Estonia,1320884,2020-05-08,7,1,1720,56,1.302158251595144,0.03255813953488372,56,46
Europe,Estonia,1320884,2020-05-09,5,0,1725,56,1.3059435953497809,0.03246376811594203,57,46
Europe,Estonia,1320884,2020-05-10,8,4,1733,60,1.3120001453572003,0.03462204270051933,58,46
Europe,Estonia,1320884,2020-05-11,6,0,1739,60,1.3165425578627645,0.034502587694077054,59,46
Europe,Estonia,1320884,2020-05-12,2,1,1741,61,1.3180566953646193,0.0350373348650201,60,46
Europe,Estonia,1320884,2020-05-13,5,0,1746,61,1.3218420391192567,0.03493699885452463,61,46
Europe,Estonia,1320884,2020-05-14,5,0,1751,61,1.3256273828738936,0.034837235865219876,62,46
Europe,Estonia,1320884,2020-05-15,7,1,1758,62,1.3309268641303853,0.03526734926052332,63,46
Europe,Estonia,1320884,2020-05-16,8,1,1766,63,1.3369834141378047,0.03567383918459796,64,46
Europe,Estonia,1320884,2020-05-17,4,0,1770,63,1.3400116891415144,0.03559322033898305,65,46
Europe,Estonia,1320884,2020-05-18,4,0,1774,63,1.343039964145224,0.03551296505073281,66,46
Europe,Estonia,1320884,2020-05-19,10,1,1784,64,1.350610651654498,0.03587443946188341,67,46
Europe,Estonia,1320884,2020-05-20,7,0,1791,64,1.3559101329109897,0.03573422668900056,68,46
Europe,Estonia,1320884,2020-05-21,3,0,1794,64,1.358181339163772,0.03567447045707915,69,46
Europe,Estonia,1320884,2020-05-22,6,0,1800,64,1.3627237516693365,0.035555555555555556,70,46
Europe,Estonia,1320884,2020-05-23,7,0,1807,64,1.3680232329258284,0.03541781959048146,71,46
Europe,Estonia,1320884,2020-05-24,14,0,1821,64,1.3786221954388123,0.03514552443712246,72,46
Europe,Estonia,1320884,2020-05-25,2,0,1823,64,1.3801363329406668,0.03510696653867252,73,46
Europe,Estonia,1320884,2020-05-26,1,1,1824,65,1.3808934016915946,0.0356359649122807,74,46
Europe,Estonia,1320884,2020-05-27,10,0,1834,65,1.3884640892008686,0.03544165757906216,75,46
Africa,Eswatini,1367000,2020-04-23,7,0,31,1,0.02267739575713241,0.03225806451612903,0,47
Africa,Eswatini,1367000,2020-04-24,1,0,32,1,0.023408924652523776,0.03125,1,47
Africa,Eswatini,1367000,2020-04-25,8,0,40,1,0.029261155815654718,0.025,2,47
Africa,Eswatini,1367000,2020-04-26,0,0,40,1,0.029261155815654718,0.025,3,47
Africa,Eswatini,1367000,2020-04-27,19,0,59,1,0.04316020482809071,0.01694915254237288,4,47
Africa,Eswatini,1367000,2020-04-28,6,0,65,1,0.04754937820043892,0.015384615384615385,5,47
Africa,Eswatini,1367000,2020-04-29,6,0,71,1,0.05193855157278712,0.014084507042253521,6,47
Africa,Eswatini,1367000,2020-04-30,20,0,91,1,0.06656912948061448,0.01098901098901099,7,47
Africa,Eswatini,1367000,2020-05-01,9,0,100,1,0.0731528895391368,0.01,8,47
Africa,Eswatini,1367000,2020-05-02,6,0,106,1,0.07754206291148501,0.009433962264150943,9,47
Africa,Eswatini,1367000,2020-05-03,2,0,108,1,0.07900512070226774,0.009259259259259259,10,47
Africa,Eswatini,1367000,2020-05-04,4,0,112,1,0.08193123628383321,0.008928571428571428,11,47
Africa,Eswatini,1367000,2020-05-05,4,0,116,1,0.08485735186539868,0.008620689655172414,12,47
Africa,Eswatini,1367000,2020-05-06,0,0,116,1,0.08485735186539868,0.008620689655172414,13,47
Africa,Eswatini,1367000,2020-05-07,7,1,123,2,0.08997805413313827,0.016260162601626018,14,47
Africa,Eswatini,1367000,2020-05-08,30,0,153,2,0.1119239209948793,0.013071895424836602,15,47
Africa,Eswatini,1367000,2020-05-09,6,0,159,2,0.1163130943672275,0.012578616352201259,16,47
Africa,Eswatini,1367000,2020-05-10,4,0,163,2,0.11923920994879297,0.012269938650306749,17,47
Africa,Eswatini,1367000,2020-05-11,9,0,172,2,0.1258229700073153,0.011627906976744186,18,47
Africa,Eswatini,1367000,2020-05-12,3,0,175,2,0.12801755669348938,0.011428571428571429,19,47
Africa,Eswatini,1367000,2020-05-13,9,0,184,2,0.1346013167520117,0.010869565217391304,20,47
Africa,Eswatini,1367000,2020-05-14,3,0,187,2,0.1367959034381858,0.0106951871657754,21,47
Africa,Eswatini,1367000,2020-05-15,0,0,187,2,0.1367959034381858,0.0106951871657754,22,47
Africa,Eswatini,1367000,2020-05-16,3,0,190,2,0.1389904901243599,0.010526315789473684,23,47
Africa,Eswatini,1367000,2020-05-17,12,0,202,2,0.14776883686905634,0.009900990099009901,24,47
Africa,Eswatini,1367000,2020-05-18,1,0,203,2,0.1485003657644477,0.009852216748768473,25,47
Africa,Eswatini,1367000,2020-05-19,0,0,203,2,0.1485003657644477,0.009852216748768473,26,47
Africa,Eswatini,1367000,2020-05-20,5,0,208,2,0.15215801024140455,0.009615384615384616,27,47
Africa,Eswatini,1367000,2020-05-21,9,0,217,2,0.15874177029992684,0.009216589861751152,28,47
Africa,Eswatini,1367000,2020-05-22,3,0,220,2,0.16093635698610095,0.00909090909090909,29,47
Africa,Eswatini,1367000,2020-05-23,0,0,220,2,0.16093635698610095,0.00909090909090909,30,47
Africa,Eswatini,1367000,2020-05-24,18,0,238,2,0.17410387710314557,0.008403361344537815,31,47
Africa,Eswatini,1367000,2020-05-25,12,0,250,2,0.182882223847842,0.008,32,47
Africa,Eswatini,1367000,2020-05-26,6,0,256,2,0.1872713972201902,0.0078125,33,47
Africa,Eswatini,1367000,2020-05-27,5,0,261,2,0.19092904169714703,0.007662835249042145,34,47
Oceania,Fiji,883483,2020-04-21,1,0,18,0,0.020373906458867913,0,0,48
Oceania,Fiji,883483,2020-04-22,0,0,18,0,0.020373906458867913,0,1,48
Oceania,Fiji,883483,2020-04-23,0,0,18,0,0.020373906458867913,0,2,48
Oceania,Fiji,883483,2020-04-24,0,0,18,0,0.020373906458867913,0,3,48
Oceania,Fiji,883483,2020-04-25,0,0,18,0,0.020373906458867913,0,4,48
Oceania,Fiji,883483,2020-04-26,0,0,18,0,0.020373906458867913,0,5,48
Oceania,Fiji,883483,2020-04-27,0,0,18,0,0.020373906458867913,0,6,48
Oceania,Fiji,883483,2020-04-28,0,0,18,0,0.020373906458867913,0,7,48
Oceania,Fiji,883483,2020-04-29,0,0,18,0,0.020373906458867913,0,8,48
Oceania,Fiji,883483,2020-04-30,0,0,18,0,0.020373906458867913,0,9,48
Oceania,Fiji,883483,2020-05-01,0,0,18,0,0.020373906458867913,0,10,48
Oceania,Fiji,883483,2020-05-02,0,0,18,0,0.020373906458867913,0,11,48
Oceania,Fiji,883483,2020-05-03,0,0,18,0,0.020373906458867913,0,12,48
Oceania,Fiji,883483,2020-05-04,0,0,18,0,0.020373906458867913,0,13,48
Oceania,Fiji,883483,2020-05-05,0,0,18,0,0.020373906458867913,0,14,48
Oceania,Fiji,883483,2020-05-06,0,0,18,0,0.020373906458867913,0,15,48
Oceania,Fiji,883483,2020-05-07,0,0,18,0,0.020373906458867913,0,16,48
Oceania,Fiji,883483,2020-05-08,0,0,18,0,0.020373906458867913,0,17,48
Oceania,Fiji,883483,2020-05-09,0,0,18,0,0.020373906458867913,0,18,48
Oceania,Fiji,883483,2020-05-10,0,0,18,0,0.020373906458867913,0,19,48
Oceania,Fiji,883483,2020-05-11,0,0,18,0,0.020373906458867913,0,20,48
Oceania,Fiji,883483,2020-05-12,0,0,18,0,0.020373906458867913,0,21,48
Oceania,Fiji,883483,2020-05-13,0,0,18,0,0.020373906458867913,0,22,48
Oceania,Fiji,883483,2020-05-14,0,0,18,0,0.020373906458867913,0,23,48
Oceania,Fiji,883483,2020-05-15,0,0,18,0,0.020373906458867913,0,24,48
Oceania,Fiji,883483,2020-05-16,0,0,18,0,0.020373906458867913,0,25,48
Oceania,Fiji,883483,2020-05-17,0,0,18,0,0.020373906458867913,0,26,48
Oceania,Fiji,883483,2020-05-18,0,0,18,0,0.020373906458867913,0,27,48
Oceania,Fiji,883483,2020-05-19,0,0,18,0,0.020373906458867913,0,28,48
Oceania,Fiji,883483,2020-05-20,0,0,18,0,0.020373906458867913,0,29,48
Oceania,Fiji,883483,2020-05-21,0,0,18,0,0.020373906458867913,0,30,48
Oceania,Fiji,883483,2020-05-22,0,0,18,0,0.020373906458867913,0,31,48
Oceania,Fiji,883483,2020-05-23,0,0,18,0,0.020373906458867913,0,32,48
Oceania,Fiji,883483,2020-05-24,0,0,18,0,0.020373906458867913,0,33,48
Oceania,Fiji,883483,2020-05-25,0,0,18,0,0.020373906458867913,0,34,48
Oceania,Fiji,883483,2020-05-26,0,0,18,0,0.020373906458867913,0,35,48
Oceania,Fiji,883483,2020-05-27,0,0,18,0,0.020373906458867913,0,36,48
Europe,Finland,5518050,2020-03-13,96,0,155,0,0.028089633113146856,0,0,49
Europe,Finland,5518050,2020-03-14,28,0,183,0,0.03316388941745725,0,1,49
Europe,Finland,5518050,2020-03-15,27,0,210,0,0.038056922282328,0,2,49
Europe,Finland,5518050,2020-03-16,57,0,267,0,0.04838665833038845,0,3,49
Europe,Finland,5518050,2020-03-17,5,0,272,0,0.049292775527586735,0,4,49
Europe,Finland,5518050,2020-03-18,47,0,319,0,0.057810277181250626,0,5,49
Europe,Finland,5518050,2020-03-19,50,0,369,0,0.06687144915323348,0,6,49
Europe,Finland,5518050,2020-03-20,31,0,400,0,0.07248937577586285,0,7,49
Europe,Finland,5518050,2020-03-21,50,0,450,0,0.0815505477478457,0,8,49
Europe,Finland,5518050,2020-03-22,71,1,521,1,0.09441741194806136,0.0019193857965451055,9,49
Europe,Finland,5518050,2020-03-23,105,0,626,1,0.11344587308922535,0.001597444089456869,10,49
Europe,Finland,5518050,2020-03-24,74,0,700,1,0.12685640760775999,0.0014285714285714286,11,49
Europe,Finland,5518050,2020-03-25,92,0,792,1,0.14352896403620843,0.0012626262626262627,12,49
Europe,Finland,5518050,2020-03-26,88,2,880,3,0.15947662670689827,0.003409090909090909,13,49
Europe,Finland,5518050,2020-03-27,78,1,958,4,0.17361205498319152,0.0041753653444676405,14,49
Europe,Finland,5518050,2020-03-28,67,3,1025,7,0.18575402542564856,0.006829268292682927,15,49
Europe,Finland,5518050,2020-03-29,193,2,1218,9,0.2207301492375024,0.007389162561576354,16,49
Europe,Finland,5518050,2020-03-30,0,2,1218,11,0.2207301492375024,0.0090311986863711,17,49
Europe,Finland,5518050,2020-03-31,95,2,1313,13,0.23794637598426982,0.009900990099009901,18,49
Europe,Finland,5518050,2020-04-01,71,4,1384,17,0.2508132401844855,0.012283236994219654,19,49
Europe,Finland,5518050,2020-04-02,62,0,1446,17,0.2620490934297442,0.011756569847856155,20,49
Europe,Finland,5518050,2020-04-03,72,2,1518,19,0.2750971810693995,0.012516469038208168,21,49
Europe,Finland,5518050,2020-04-04,97,1,1615,20,0.29267585469504626,0.01238390092879257,22,49
Europe,Finland,5518050,2020-04-05,267,5,1882,25,0.34106251302543467,0.013283740701381509,23,49
Europe,Finland,5518050,2020-04-06,45,2,1927,27,0.3492175678002193,0.01401141670991178,24,49
Europe,Finland,5518050,2020-04-07,249,0,2176,27,0.3943422042206939,0.012408088235294117,25,49
Europe,Finland,5518050,2020-04-08,132,7,2308,34,0.41826369822672865,0.014731369150779897,26,49
Europe,Finland,5518050,2020-04-09,179,6,2487,40,0.45070269388642725,0.016083634901487735,27,49
Europe,Finland,5518050,2020-04-10,118,2,2605,42,0.47208705974030685,0.016122840690978888,28,49
Europe,Finland,5518050,2020-04-11,164,6,2769,48,0.5018077038084106,0.01733477789815818,29,49
Europe,Finland,5518050,2020-04-12,136,1,2905,49,0.5264540915722039,0.016867469879518072,30,49
Europe,Finland,5518050,2020-04-13,69,7,2974,56,0.5389585088935404,0.01882985877605918,31,49
Europe,Finland,5518050,2020-04-14,90,3,3064,59,0.5552686184431095,0.019255874673629242,32,49
Europe,Finland,5518050,2020-04-15,97,5,3161,64,0.5728472920687562,0.02024675735526732,33,49
Europe,Finland,5518050,2020-04-16,76,8,3237,72,0.5866202734661701,0.022242817423540315,34,49
Europe,Finland,5518050,2020-04-17,132,3,3369,75,0.6105417674722049,0.02226179875333927,35,49
Europe,Finland,5518050,2020-04-18,120,7,3489,82,0.6322885802049637,0.0235024362281456,36,49
Europe,Finland,5518050,2020-04-19,192,8,3681,90,0.6670834805773779,0.02444987775061125,37,49
Europe,Finland,5518050,2020-04-20,102,4,3783,94,0.6855682714002229,0.024848004229447527,38,49
Europe,Finland,5518050,2020-04-21,85,4,3868,98,0.7009722637525938,0.025336091003102378,39,49
Europe,Finland,5518050,2020-04-22,146,43,4014,141,0.7274308859107836,0.035127055306427506,40,49
Europe,Finland,5518050,2020-04-23,115,8,4129,149,0.7482715814463443,0.03608621942358925,41,49
Europe,Finland,5518050,2020-04-24,155,23,4284,172,0.7763612145594911,0.040149393090569564,42,49
Europe,Finland,5518050,2020-04-25,111,5,4395,177,0.7964770163372931,0.040273037542662114,43,49
Europe,Finland,5518050,2020-04-26,80,9,4475,186,0.8109748914924657,0.04156424581005587,44,49
Europe,Finland,5518050,2020-04-27,101,4,4576,190,0.829278458875871,0.041520979020979024,45,49
Europe,Finland,5518050,2020-04-28,119,3,4695,193,0.8508440481691902,0.04110756123535676,46,49
Europe,Finland,5518050,2020-04-29,45,6,4740,199,0.8589991029439747,0.0419831223628692,47,49
Europe,Finland,5518050,2020-04-30,166,7,4906,206,0.8890821938909579,0.041989400733795354,48,49
Europe,Finland,5518050,2020-05-01,89,5,4995,211,0.9052110800010873,0.04224224224224224,49,49
Europe,Finland,5518050,2020-05-02,56,7,5051,218,0.9153595926097082,0.04315977034250643,50,49
Europe,Finland,5518050,2020-05-03,128,2,5179,220,0.9385561928579843,0.042479243097123,51,49
Europe,Finland,5518050,2020-05-04,75,10,5254,230,0.9521479508159585,0.04377617053673392,52,49
Europe,Finland,5518050,2020-05-05,73,10,5327,240,0.9653772618950535,0.045053501032476066,53,49
Europe,Finland,5518050,2020-05-06,85,6,5412,246,0.98078125424742435,0.045454545454545456,54,49
Europe,Finland,5518050,2020-05-07,161,6,5573,252,1.0099582279972092,0.045218015431544946,55,49
Europe,Finland,5518050,2020-05-08,100,3,5673,255,1.0280805719411747,0.0449497620306716,56,49
Europe,Finland,5518050,2020-05-09,65,5,5738,260,1.0398600955047526,0.04531195538515162,57,49
Europe,Finland,5518050,2020-05-10,142,5,5880,265,1.0655938239051839,0.045068027210884355,58,49
Europe,Finland,5518050,2020-05-11,82,2,5962,267,1.0804541459392358,0.044783629654478366,59,49
Europe,Finland,5518050,2020-05-12,22,4,5984,271,1.0844410616069082,0.045287433155080214,60,49
Europe,Finland,5518050,2020-05-13,19,4,6003,275,1.0878843069562618,0.045810428119273695,61,49
Europe,Finland,5518050,2020-05-14,51,9,6054,284,1.0971267023676843,0.04691113313511728,62,49
Europe,Finland,5518050,2020-05-15,91,3,6145,287,1.1136180353566931,0.046704637917005694,63,49
Europe,Finland,5518050,2020-05-16,83,6,6228,293,1.1286595808301845,0.04704560051380861,64,49
Europe,Finland,5518050,2020-05-17,58,4,6286,297,1.1391705403176846,0.0472478523703468,65,49
Europe,Finland,5518050,2020-05-18,61,1,6347,298,1.1502251701235038,0.0469513155821648,66,49
Europe,Finland,5518050,2020-05-19,33,2,6380,300,1.1562055436250125,0.047021943573667714,67,49
Europe,Finland,5518050,2020-05-20,19,1,6399,301,1.159648788974366,0.047038599781215815,68,49
Europe,Finland,5518050,2020-05-21,44,3,6443,304,1.1676226203097109,0.04718298929070309,69,49
Europe,Finland,5518050,2020-05-22,50,2,6493,306,1.1766837922816937,0.04712767595872478,70,49
Europe,Finland,5518050,2020-05-23,44,0,6537,306,1.1846576236170385,0.046810463515374025,71,49
Europe,Finland,5518050,2020-05-24,31,0,6568,306,1.190275550239668,0.04658952496954933,72,49
Europe,Finland,5518050,2020-05-25,11,1,6579,307,1.1922690080735043,0.04666362669098647,73,49
Europe,Finland,5518050,2020-05-26,20,1,6599,308,1.1958934768622975,0.04667373844521897,74,49
Europe,Finland,5518050,2020-05-27,29,4,6628,312,1.2011489566060474,0.04707302353651177,75,49
Europe,France,66987244,2020-03-10,286,11,1412,30,0.021078639987039918,0.021246458923512748,0,50
Europe,France,66987244,2020-03-11,372,3,1784,33,0.02663193607427707,0.018497757847533634,1,50
Europe,France,66987244,2020-03-12,497,15,2281,48,0.034051259072548204,0.02104340201665936,2,50
Europe,France,66987244,2020-03-13,595,13,2876,61,0.042933547169069976,0.02121001390820584,3,50
Europe,France,66987244,2020-03-14,785,18,3661,79,0.05465219617036342,0.02157880360557225,4,50
Europe,France,66987244,2020-03-15,838,12,4499,91,0.06716204058193527,0.02022671704823294,5,50
Europe,France,66987244,2020-03-16,924,36,5423,127,0.0809557115082985,0.023418771897473722,6,50
Europe,France,66987244,2020-03-17,1210,21,6633,148,0.0990188520071075,0.02231267902909694,7,50
Europe,France,66987244,2020-03-18,1097,27,7730,175,0.11539510417834178,0.022639068564036222,8,50
Europe,France,66987244,2020-03-19,1404,69,9134,244,0.13635431844307552,0.026713378585504707,9,50
Europe,France,66987244,2020-03-20,1861,128,10995,372,0.16413572709454952,0.03383356070941337,10,50
Europe,France,66987244,2020-03-21,1617,78,12612,450,0.18827465121568518,0.0356803044719315,11,50
Europe,France,66987244,2020-03-22,1847,112,14459,562,0.21584706485312338,0.038868524794245796,12,50
Europe,France,66987244,2020-03-23,1559,112,16018,674,0.2391201524875393,0.04207766262954177,13,50
Europe,France,66987244,2020-03-24,3838,186,19856,860,0.2964146427639268,0.04331184528605963,14,50
Europe,France,66987244,2020-03-25,2446,240,22302,1100,0.3329290573590399,0.049322930678862884,15,50
Europe,France,66987244,2020-03-26,2931,231,25233,1331,0.37668365636896484,0.052748385051321685,16,50
Europe,France,66987244,2020-03-27,3922,365,29155,1696,0.43523211672956724,0.058171840164637285,17,50
Europe,France,66987244,2020-03-28,3809,299,32964,1995,0.4920936887625949,0.06052056789224609,18,50
Europe,France,66987244,2020-03-29,4611,319,37575,2314,0.5609276894568166,0.061583499667332,19,50
Europe,France,66987244,2020-03-30,2599,292,40174,2606,0.5997261209910352,0.06486782496141784,20,50
Europe,France,66987244,2020-03-31,4376,418,44550,3024,0.6650519910925131,0.06787878787878789,21,50
Europe,France,66987244,2020-04-01,7578,499,52128,3523,0.7781780065470376,0.06758364027010436,22,50
Europe,France,66987244,2020-04-02,4861,509,56989,4032,0.8507440610633272,0.07075049570969837,23,50
Europe,France,66987244,2020-04-03,2116,471,59105,4503,0.8823321646133107,0.07618644784705186,24,50
Europe,France,66987244,2020-04-04,5233,2004,64338,6507,0.9604515152168374,0.10113774130373962,25,50
Europe,France,66987244,2020-04-05,4267,1053,68605,7560,1.0241502098518935,0.11019604985059397,26,50
Europe,France,66987244,2020-04-06,1873,518,70478,8078,1.0521107570868269,0.11461732739294532,27,50
Europe,France,66987244,2020-04-07,3912,833,74390,8911,1.1105099352945464,0.11978760586100282,28,50
Europe,France,66987244,2020-04-08,3777,1417,78167,10328,1.1668938044383494,0.1321273683267875,29,50
Europe,France,66987244,2020-04-09,3881,541,82048,10869,1.2248302079721327,0.13247123634945399,30,50
Europe,France,66987244,2020-04-10,4286,1341,86334,12210,1.2888125386976659,0.141427479324484,31,50
Europe,France,66987244,2020-04-11,4342,987,90676,13197,1.3536308494793428,0.14554016498301645,32,50
Europe,France,66987244,2020-04-12,3114,635,93790,13832,1.4001173118870214,0.1474784092120695,33,50
Europe,France,66987244,2020-04-13,1613,561,95403,14393,1.424196523147004,0.15086527677326708,34,50
Europe,France,66987244,2020-04-14,2673,574,98076,14967,1.4640996426125548,0.15260614217545576,35,50
Europe,France,66987244,2020-04-15,5497,762,103573,15729,1.5461600420521853,0.1518639027545789,36,50
Europe,France,66987244,2020-04-16,2633,1438,106206,17167,1.5854660329062054,0.16163870214488824,37,50
Europe,France,66987244,2020-04-17,2641,753,108847,17920,1.6248914494825313,0.16463476255661616,38,50
Europe,France,66987244,2020-04-18,405,761,109252,18681,1.6309373766742814,0.17099000475963827,39,50
Europe,France,66987244,2020-04-19,2569,642,111821,19323,1.669287961749852,0.1728029618765706,40,50
Europe,France,66987244,2020-04-20,785,395,112606,19718,1.6810066107511454,0.17510612223149744,41,50
Europe,France,66987244,2020-04-21,2051,547,114657,20265,1.711624380307391,0.1767445511394856,42,50
Europe,France,66987244,2020-04-22,2667,531,117324,20796,1.7514379304812122,0.17725273601309194,43,50
Europe,France,66987244,2020-04-23,1827,544,119151,21340,1.7787117798128849,0.1791004691525879,44,50
Europe,France,66987244,2020-04-24,1653,516,120804,21856,1.8033881196843984,0.180921161550942,45,50
Europe,France,66987244,2020-04-25,1773,389,122577,22245,1.8298558453905045,0.18147776499669596,46,50
Europe,France,66987244,2020-04-26,1537,369,124114,22614,1.8528005122885784,0.18220345811109143,47,50
Europe,France,66987244,2020-04-27,461,242,124575,22856,1.8596824195364718,0.18347180413405578,48,50
Europe,France,66987244,2020-04-28,1195,437,125770,23293,1.8775216368059569,0.1852031486045957,49,50
Europe,France,66987244,2020-04-29,1065,367,126835,23660,1.8934201860879663,0.18654156975598218,50,50
Europe,France,66987244,2020-04-30,1607,427,128442,24087,1.9174098280562193,0.18753211566310085,51,50
Europe,France,66987244,2020-05-01,1139,289,129581,24376,1.9344130652695608,0.1881139981941797,52,50
Europe,France,66987244,2020-05-02,604,218,130185,24594,1.9434297073036773,0.18891577370664822,53,50
Europe,France,66987244,2020-05-03,794,166,130979,24760,1.955282710242565,0.18903793737927455,54,50
Europe,France,66987244,2020-05-04,308,135,131287,24895,1.9598806005513527,0.18962273492424991,55,50
Europe,France,66987244,2020-05-05,576,306,131863,25201,1.9684792525573973,0.19111502089289642,56,50
Europe,France,66987244,2020-05-06,1104,330,132967,25531,1.9849600022356497,0.19201004760579693,57,50
Europe,France,66987244,2020-05-07,4183,278,137150,25809,2.0474047267864908,0.18818082391542107,58,50
Europe,France,66987244,2020-05-08,629,178,137779,25987,2.056794574202814,0.18861364939504568,59,50
Europe,France,66987244,2020-05-09,642,243,138421,26230,2.0663784884178846,0.1894943686290375,60,50
Europe,France,66987244,2020-05-10,433,80,138854,26310,2.072842405637706,0.18947959727483543,61,50
Europe,France,66987244,2020-05-11,209,70,139063,26380,2.075962402632955,0.1896981943435709,62,50
Europe,France,66987244,2020-05-12,456,263,139519,26643,2.0827696688044073,0.1909632379819236,63,50
Europe,France,66987244,2020-05-13,708,348,140227,26991,2.0933388452285038,0.19248076333373745,64,50
Europe,France,66987244,2020-05-14,507,83,140734,27074,2.1009074503796574,0.19237710858783236,65,50
Europe,France,66987244,2020-05-15,622,351,141356,27425,2.1101928002889627,0.1940136959166926,66,50
Europe,France,66987244,2020-05-16,563,130,141919,27555,2.1185973854962596,0.1941600490420592,67,50
Europe,France,66987244,2020-05-17,372,88,142291,27643,2.1241506815834965,0.1942708955591007,68,50
Europe,France,66987244,2020-05-18,120,68,142411,27711,2.1259420674180896,0.1945846879805633,69,50
Europe,France,66987244,2020-05-19,492,186,142903,27897,2.133286749339919,0.19521633555628642,70,50
Europe,France,66987244,2020-05-20,524,125,143427,28022,2.1411091341509736,0.1953746505190794,71,50
Europe,France,66987244,2020-05-21,418,110,143845,28132,2.1473491281414714,0.1955716222322639,72,50
Europe,France,66987244,2020-05-22,318,83,144163,28215,2.1520963006031417,0.1957159604059294,73,50
Europe,France,66987244,2020-05-23,403,74,144566,28289,2.1581123713643153,0.19568224893820124,74,50
Europe,France,66987244,2020-05-24,240,43,144806,28332,2.1616951430335005,0.19565487617916386,75,50
Europe,France,66987244,2020-05-25,115,35,144921,28367,2.1634118877916517,0.19574112792486942,76,50
Europe,France,66987244,2020-05-26,358,65,145279,28432,2.1687561888648528,0.19570619291157015,77,50
Europe,France,66987244,2020-05-27,276,98,145555,28530,2.172876376284416,0.19600838171138057,78,50
Oceania,French Polynesia,277679,2020-03-21,12,0,15,0,0.05401920923080247,0,0,51
Oceania,French Polynesia,277679,2020-03-22,2,0,17,0,0.06122177046157613,0,1,51
Oceania,French Polynesia,277679,2020-03-23,1,0,18,0,0.06482305107696297,0,2,51
Oceania,French Polynesia,277679,2020-03-24,5,0,23,0,0.08282945415389713,0,3,51
Oceania,French Polynesia,277679,2020-03-25,2,0,25,0,0.09003201538467079,0,4,51
Oceania,French Polynesia,277679,2020-03-26,0,0,25,0,0.09003201538467079,0,5,51
Oceania,French Polynesia,277679,2020-03-27,5,0,30,0,0.10803841846160495,0,6,51
Oceania,French Polynesia,277679,2020-03-28,0,0,30,0,0.10803841846160495,0,7,51
Oceania,French Polynesia,277679,2020-03-29,4,0,34,0,0.12244354092315227,0,8,51
Oceania,French Polynesia,277679,2020-03-30,1,0,35,0,0.1260448215385391,0,9,51
Oceania,French Polynesia,277679,2020-03-31,1,0,36,0,0.12964610215392594,0,10,51
Oceania,French Polynesia,277679,2020-04-01,1,0,37,0,0.13324738276931278,0,11,51
Oceania,French Polynesia,277679,2020-04-02,0,0,37,0,0.13324738276931278,0,12,51
Oceania,French Polynesia,277679,2020-04-03,0,0,37,0,0.13324738276931278,0,13,51
Oceania,French Polynesia,277679,2020-04-04,2,0,39,0,0.14044994400008645,0,14,51
Oceania,French Polynesia,277679,2020-04-05,1,0,40,0,0.14405122461547326,0,15,51
Oceania,French Polynesia,277679,2020-04-06,1,0,41,0,0.1476525052308601,0,16,51
Oceania,French Polynesia,277679,2020-04-07,0,0,41,0,0.1476525052308601,0,17,51
Oceania,French Polynesia,277679,2020-04-08,6,0,47,0,0.16926018892318107,0,18,51
Oceania,French Polynesia,277679,2020-04-09,4,0,51,0,0.18366531138472839,0,19,51
Oceania,French Polynesia,277679,2020-04-10,0,0,51,0,0.18366531138472839,0,20,51
Oceania,French Polynesia,277679,2020-04-11,0,0,51,0,0.18366531138472839,0,21,51
Oceania,French Polynesia,277679,2020-04-12,0,0,51,0,0.18366531138472839,0,22,51
Oceania,French Polynesia,277679,2020-04-13,2,0,53,0,0.1908678726155021,0,23,51
Oceania,French Polynesia,277679,2020-04-14,2,0,55,0,0.19807043384627573,0,24,51
Oceania,French Polynesia,277679,2020-04-15,0,0,55,0,0.19807043384627573,0,25,51
Oceania,French Polynesia,277679,2020-04-16,0,0,55,0,0.19807043384627573,0,26,51
Oceania,French Polynesia,277679,2020-04-17,0,0,55,0,0.19807043384627573,0,27,51
Oceania,French Polynesia,277679,2020-04-18,0,0,55,0,0.19807043384627573,0,28,51
Oceania,French Polynesia,277679,2020-04-19,0,0,55,0,0.19807043384627573,0,29,51
Oceania,French Polynesia,277679,2020-04-20,0,0,55,0,0.19807043384627573,0,30,51
Oceania,French Polynesia,277679,2020-04-21,1,0,56,0,0.20167171446166257,0,31,51
Oceania,French Polynesia,277679,2020-04-22,1,0,57,0,0.2052729950770494,0,32,51
Oceania,French Polynesia,277679,2020-04-23,0,0,57,0,0.2052729950770494,0,33,51
Oceania,French Polynesia,277679,2020-04-24,0,0,57,0,0.2052729950770494,0,34,51
Oceania,French Polynesia,277679,2020-04-25,0,0,57,0,0.2052729950770494,0,35,51
Oceania,French Polynesia,277679,2020-04-26,0,0,57,0,0.2052729950770494,0,36,51
Oceania,French Polynesia,277679,2020-04-27,0,0,57,0,0.2052729950770494,0,37,51
Oceania,French Polynesia,277679,2020-04-28,1,0,58,0,0.20887427569243622,0,38,51
Oceania,French Polynesia,277679,2020-04-29,0,0,58,0,0.20887427569243622,0,39,51
Oceania,French Polynesia,277679,2020-04-30,0,0,58,0,0.20887427569243622,0,40,51
Oceania,French Polynesia,277679,2020-05-01,0,0,58,0,0.20887427569243622,0,41,51
Oceania,French Polynesia,277679,2020-05-02,0,0,58,0,0.20887427569243622,0,42,51
Oceania,French Polynesia,277679,2020-05-03,0,0,58,0,0.20887427569243622,0,43,51
Oceania,French Polynesia,277679,2020-05-04,0,0,58,0,0.20887427569243622,0,44,51
Oceania,French Polynesia,277679,2020-05-05,0,0,58,0,0.20887427569243622,0,45,51
Oceania,French Polynesia,277679,2020-05-06,2,0,60,0,0.2160768369232099,0,46,51
Oceania,French Polynesia,277679,2020-05-07,0,0,60,0,0.2160768369232099,0,47,51
Oceania,French Polynesia,277679,2020-05-08,0,0,60,0,0.2160768369232099,0,48,51
Oceania,French Polynesia,277679,2020-05-09,0,0,60,0,0.2160768369232099,0,49,51
Oceania,French Polynesia,277679,2020-05-10,0,0,60,0,0.2160768369232099,0,50,51
Oceania,French Polynesia,277679,2020-05-11,0,0,60,0,0.2160768369232099,0,51,51
Oceania,French Polynesia,277679,2020-05-12,0,0,60,0,0.2160768369232099,0,52,51
Oceania,French Polynesia,277679,2020-05-13,0,0,60,0,0.2160768369232099,0,53,51
Oceania,French Polynesia,277679,2020-05-14,0,0,60,0,0.2160768369232099,0,54,51
Oceania,French Polynesia,277679,2020-05-15,0,0,60,0,0.2160768369232099,0,55,51
Oceania,French Polynesia,277679,2020-05-16,0,0,60,0,0.2160768369232099,0,56,51
Oceania,French Polynesia,277679,2020-05-17,0,0,60,0,0.2160768369232099,0,57,51
Oceania,French Polynesia,277679,2020-05-18,0,0,60,0,0.2160768369232099,0,58,51
Oceania,French Polynesia,277679,2020-05-19,0,0,60,0,0.2160768369232099,0,59,51
Oceania,French Polynesia,277679,2020-05-20,0,0,60,0,0.2160768369232099,0,60,51
Oceania,French Polynesia,277679,2020-05-21,0,0,60,0,0.2160768369232099,0,61,51
Oceania,French Polynesia,277679,2020-05-22,0,0,60,0,0.2160768369232099,0,62,51
Oceania,French Polynesia,277679,2020-05-23,0,0,60,0,0.2160768369232099,0,63,51
Oceania,French Polynesia,277679,2020-05-24,0,0,60,0,0.2160768369232099,0,64,51
Oceania,French Polynesia,277679,2020-05-25,0,0,60,0,0.2160768369232099,0,65,51
Oceania,French Polynesia,277679,2020-05-26,0,0,60,0,0.2160768369232099,0,66,51
Oceania,French Polynesia,277679,2020-05-27,0,0,60,0,0.2160768369232099,0,67,51
Africa,Gabon,2119275,2020-04-10,11,0,44,1,0.02076181713085843,0.022727272727272728,0,52
Africa,Gabon,2119275,2020-04-11,2,0,46,1,0.021705536091351993,0.021739130434782608,1,52
Africa,Gabon,2119275,2020-04-12,3,0,49,1,0.023121114532092344,0.02040816326530612,2,52
Africa,Gabon,2119275,2020-04-13,8,0,57,1,0.026895990374066602,0.017543859649122806,3,52
Africa,Gabon,2119275,2020-04-14,0,0,57,1,0.026895990374066602,0.017543859649122806,4,52
Africa,Gabon,2119275,2020-04-15,18,0,75,1,0.03538946101850869,0.013333333333333334,5,52
Africa,Gabon,2119275,2020-04-16,12,0,87,1,0.041051774781470075,0.011494252873563218,6,52
Africa,Gabon,2119275,2020-04-17,8,0,95,1,0.044826650623444333,0.010526315789473684,7,52
Africa,Gabon,2119275,2020-04-18,13,0,108,1,0.05096082386665251,0.009259259259259259,8,52
Africa,Gabon,2119275,2020-04-19,1,0,109,1,0.051432683346899294,0.009174311926605505,9,52
Africa,Gabon,2119275,2020-04-20,0,0,109,1,0.051432683346899294,0.009174311926605505,10,52
Africa,Gabon,2119275,2020-04-21,11,0,120,1,0.0566231376296139,0.008333333333333333,11,52
Africa,Gabon,2119275,2020-04-22,36,0,156,1,0.07361007891849808,0.00641025641025641,12,52
Africa,Gabon,2119275,2020-04-23,10,0,166,1,0.0783286737209659,0.006024096385542169,13,52
Africa,Gabon,2119275,2020-04-24,1,1,167,2,0.07880053320121268,0.011976047904191617,14,52
Africa,Gabon,2119275,2020-04-25,5,1,172,3,0.0811598306024466,0.01744186046511628,15,52
Africa,Gabon,2119275,2020-04-26,4,0,176,3,0.08304726852343372,0.017045454545454544,16,52
Africa,Gabon,2119275,2020-04-27,0,0,176,3,0.08304726852343372,0.017045454545454544,17,52
Africa,Gabon,2119275,2020-04-28,35,0,211,3,0.09956235033207111,0.014218009478672985,18,52
Africa,Gabon,2119275,2020-04-29,27,0,238,3,0.11230255629873423,0.012605042016806723,19,52
Africa,Gabon,2119275,2020-04-30,38,0,276,3,0.13023321654811196,0.010869565217391304,20,52
Africa,Gabon,2119275,2020-05-01,0,0,276,3,0.13023321654811196,0.010869565217391304,21,52
Africa,Gabon,2119275,2020-05-02,32,1,308,4,0.14533271991600902,0.012987012987012988,22,52
Africa,Gabon,2119275,2020-05-03,27,1,335,5,0.15807292588267213,0.014925373134328358,23,52
Africa,Gabon,2119275,2020-05-04,0,0,335,5,0.15807292588267213,0.014925373134328358,24,52
Africa,Gabon,2119275,2020-05-05,32,1,367,6,0.17317242925056917,0.01634877384196185,25,52
Africa,Gabon,2119275,2020-05-06,30,0,397,6,0.18732821365797267,0.015113350125944584,26,52
Africa,Gabon,2119275,2020-05-07,42,2,439,8,0.20714631182833754,0.018223234624145785,27,52
Africa,Gabon,2119275,2020-05-08,65,0,504,8,0.2378171780443784,0.015873015873015872,28,52
Africa,Gabon,2119275,2020-05-09,116,0,620,8,0.29255287775300515,0.012903225806451613,29,52
Africa,Gabon,2119275,2020-05-10,41,0,661,8,0.31189911644312324,0.012102874432677761,30,52
Africa,Gabon,2119275,2020-05-11,0,0,661,8,0.31189911644312324,0.012102874432677761,31,52
Africa,Gabon,2119275,2020-05-12,141,1,802,9,0.3784313031579196,0.011221945137157107,32,52
Africa,Gabon,2119275,2020-05-13,61,0,863,9,0.4072147314529733,0.010428736964078795,33,52
Africa,Gabon,2119275,2020-05-14,141,0,1004,9,0.4737469181677696,0.008964143426294821,34,52
Africa,Gabon,2119275,2020-05-15,100,1,1104,10,0.5209328661924478,0.009057971014492754,35,52
Africa,Gabon,2119275,2020-05-16,105,0,1209,10,0.57047811161836,0.008271298593879239,36,52
Africa,Gabon,2119275,2020-05-17,111,1,1320,11,0.6228545139257529,0.008333333333333333,37,52
Africa,Gabon,2119275,2020-05-18,0,0,1320,11,0.6228545139257529,0.008333333333333333,38,52
Africa,Gabon,2119275,2020-05-19,112,0,1432,11,0.6757027757133925,0.007681564245810056,39,52
Africa,Gabon,2119275,2020-05-20,70,1,1502,12,0.7087329393306673,0.007989347536617843,40,52
Africa,Gabon,2119275,2020-05-21,65,0,1567,12,0.7394038055467081,0.007657945118059987,41,52
Africa,Gabon,2119275,2020-05-22,0,0,1567,12,0.7394038055467081,0.007657945118059987,42,52
Africa,Gabon,2119275,2020-05-23,161,0,1728,12,0.8153731818664401,0.006944444444444444,43,52
Africa,Gabon,2119275,2020-05-24,206,0,1934,12,0.9125762347972773,0.0062047569803516025,44,52
Africa,Gabon,2119275,2020-05-25,0,0,1934,12,0.9125762347972773,0.0062047569803516025,45,52
Africa,Gabon,2119275,2020-05-26,201,2,2135,14,1.0074199903268808,0.006557377049180328,46,52
Africa,Gabon,2119275,2020-05-27,103,0,2238,14,1.056021516792299,0.006255585344057194,47,52
Europe,Georgia,3731000,2020-03-27,6,0,79,0,0.021173948003216293,0,0,53
Europe,Georgia,3731000,2020-03-28,2,0,81,0,0.02170999731975342,0,1,53
Europe,Georgia,3731000,2020-03-29,4,0,85,0,0.02278209595282766,0,2,53
Europe,Georgia,3731000,2020-03-30,5,0,90,0,0.024122219244170462,0,3,53
Europe,Georgia,3731000,2020-03-31,8,0,98,0,0.02626641651031895,0,4,53
Europe,Georgia,3731000,2020-04-01,12,0,110,0,0.02948271240954168,0,5,53
Europe,Georgia,3731000,2020-04-02,5,0,115,0,0.030822835700884482,0,6,53
Europe,Georgia,3731000,2020-04-03,6,0,121,0,0.03243098365049585,0,7,53
Europe,Georgia,3731000,2020-04-04,27,0,148,0,0.03966764942374698,0,8,53
Europe,Georgia,3731000,2020-04-05,9,0,157,0,0.04207987134816404,0,9,53
Europe,Georgia,3731000,2020-04-06,17,2,174,2,0.046636290538729565,0.011494252873563218,10,53
Europe,Georgia,3731000,2020-04-07,14,0,188,2,0.05038863575448941,0.010638297872340425,11,53
Europe,Georgia,3731000,2020-04-08,8,1,196,3,0.0525328330206379,0.015306122448979591,12,53
Europe,Georgia,3731000,2020-04-09,15,0,211,3,0.05655320289466631,0.014218009478672985,13,53
Europe,Georgia,3731000,2020-04-10,7,0,218,3,0.05842937550254623,0.013761467889908258,14,53
Europe,Georgia,3731000,2020-04-11,16,0,234,3,0.06271777003484322,0.01282051282051282,15,53
Europe,Georgia,3731000,2020-04-12,8,0,242,3,0.0648619673009917,0.012396694214876033,16,53
Europe,Georgia,3731000,2020-04-13,15,0,257,3,0.06888233717502011,0.011673151750972763,17,53
Europe,Georgia,3731000,2020-04-14,15,0,272,3,0.07290270704904851,0.011029411764705883,18,53
Europe,Georgia,3731000,2020-04-15,28,0,300,3,0.08040739748056822,0.01,19,53
Europe,Georgia,3731000,2020-04-16,6,0,306,3,0.08201554543017957,0.00980392156862745,20,53
Europe,Georgia,3731000,2020-04-17,42,0,348,3,0.09327258107745913,0.008620689655172414,21,53
Europe,Georgia,3731000,2020-04-18,22,0,370,3,0.09916912355936747,0.008108108108108109,22,53
Europe,Georgia,3731000,2020-04-19,18,1,388,4,0.10399356740820155,0.010309278350515464,23,53
Europe,Georgia,3731000,2020-04-20,6,0,394,4,0.10560171535781293,0.01015228426395939,24,53
Europe,Georgia,3731000,2020-04-21,8,0,402,4,0.10774591262396141,0.009950248756218905,25,53
Europe,Georgia,3731000,2020-04-22,6,0,408,4,0.10935406057357276,0.00980392156862745,26,53
Europe,Georgia,3731000,2020-04-23,8,1,416,5,0.11149825783972125,0.01201923076923077,27,53
Europe,Georgia,3731000,2020-04-24,9,0,425,5,0.1139104797641383,0.011764705882352941,28,53
Europe,Georgia,3731000,2020-04-25,19,0,444,5,0.11900294827124096,0.01126126126126126,29,53
Europe,Georgia,3731000,2020-04-26,12,0,456,5,0.12221924417046368,0.010964912280701754,30,53
Europe,Georgia,3731000,2020-04-27,30,1,486,6,0.1302599839185205,0.012345679012345678,31,53
Europe,Georgia,3731000,2020-04-28,11,0,497,6,0.13320825515947465,0.012072434607645875,32,53
Europe,Georgia,3731000,2020-04-29,14,0,511,6,0.13696060037523453,0.011741682974559686,33,53
Europe,Georgia,3731000,2020-04-30,6,0,517,6,0.13856874832484586,0.01160541586073501,34,53
Europe,Georgia,3731000,2020-05-01,22,0,539,6,0.14446529080675422,0.011131725417439703,35,53
Europe,Georgia,3731000,2020-05-02,43,2,582,8,0.15599035111230233,0.013745704467353952,36,53
Europe,Georgia,3731000,2020-05-03,0,0,582,8,0.15599035111230233,0.013745704467353952,37,53
Europe,Georgia,3731000,2020-05-04,7,1,589,9,0.15786652372018226,0.015280135823429542,38,53
Europe,Georgia,3731000,2020-05-05,4,0,593,9,0.1589386223532565,0.01517706576728499,39,53
Europe,Georgia,3731000,2020-05-06,11,0,604,9,0.16188689359421068,0.014900662251655629,40,53
Europe,Georgia,3731000,2020-05-07,6,0,610,9,0.16349504154382202,0.014754098360655738,41,53
Europe,Georgia,3731000,2020-05-08,5,0,615,9,0.16483516483516483,0.014634146341463415,42,53
Europe,Georgia,3731000,2020-05-09,8,1,623,10,0.16697936210131334,0.016051364365971106,43,53
Europe,Georgia,3731000,2020-05-10,3,0,626,10,0.167783436076119,0.01597444089456869,44,53
Europe,Georgia,3731000,2020-05-11,9,0,635,10,0.17019565800053604,0.015748031496062992,45,53
Europe,Georgia,3731000,2020-05-12,3,1,638,11,0.17099973197534174,0.017241379310344827,46,53
Europe,Georgia,3731000,2020-05-13,4,0,642,11,0.17207183060841597,0.017133956386292833,47,53
Europe,Georgia,3731000,2020-05-14,5,0,647,11,0.17341195389975878,0.017001545595054096,48,53
Europe,Georgia,3731000,2020-05-15,20,1,667,12,0.17877244706512999,0.017991004497751123,49,53
Europe,Georgia,3731000,2020-05-16,4,0,671,12,0.17984454569820424,0.01788375558867362,50,53
Europe,Georgia,3731000,2020-05-17,24,0,695,12,0.1862771374966497,0.017266187050359712,51,53
Europe,Georgia,3731000,2020-05-18,6,0,701,12,0.18788528544626104,0.017118402282453638,52,53
Europe,Georgia,3731000,2020-05-19,1,0,702,12,0.1881533101045296,0.017094017094017096,53,53
Europe,Georgia,3731000,2020-05-20,5,0,707,12,0.1894934333958724,0.016973125884016973,54,53
Europe,Georgia,3731000,2020-05-21,6,0,713,12,0.1911015813454838,0.016830294530154277,55,53
Europe,Georgia,3731000,2020-05-22,8,0,721,12,0.19324577861163225,0.016643550624133148,56,53
Europe,Georgia,3731000,2020-05-23,2,0,723,12,0.1937818279281694,0.016597510373443983,57,53
Europe,Georgia,3731000,2020-05-24,5,0,728,12,0.1951219512195122,0.016483516483516484,58,53
Europe,Georgia,3731000,2020-05-25,2,0,730,12,0.19565800053604931,0.01643835616438356,59,53
Europe,Georgia,3731000,2020-05-26,1,0,731,12,0.19592602519431787,0.016415868673050615,60,53
Europe,Georgia,3731000,2020-05-27,1,0,732,12,0.19619404985258643,0.01639344262295082,61,53
Europe,Germany,82927922,2020-03-13,802,2,2369,5,0.028566976512446555,0.002110595187842972,0,54
Europe,Germany,82927922,2020-03-14,693,0,3062,5,0.03692363110219981,0.0016329196603527107,1,54
Europe,Germany,82927922,2020-03-15,733,3,3795,8,0.04576263227722021,0.002108036890645586,2,54
Europe,Germany,82927922,2020-03-16,1043,4,4838,12,0.058339819488060975,0.0024803637866887144,3,54
Europe,Germany,82927922,2020-03-17,1174,1,6012,13,0.07249669176565161,0.002162341982701264,4,54
Europe,Germany,82927922,2020-03-18,1144,0,7156,13,0.08629180410429192,0.0018166573504751259,5,54
Europe,Germany,82927922,2020-03-19,1042,0,8198,13,0.098856932650501,0.0015857526225908757,6,54
Europe,Germany,82927922,2020-03-20,5940,30,14138,43,0.17048540056267178,0.0030414485782996182,7,54
Europe,Germany,82927922,2020-03-21,4049,2,18187,45,0.21931093365633836,0.002474294825974597,8,54
Europe,Germany,82927922,2020-03-22,3276,22,21463,67,0.2588151189897174,0.0031216512137166286,9,54
Europe,Germany,82927922,2020-03-23,3311,27,24774,94,0.29874135758520515,0.0037943004763058043,10,54
Europe,Germany,82927922,2020-03-24,4438,32,29212,126,0.3522577112205946,0.00431329590579214,11,54
Europe,Germany,82927922,2020-03-25,2342,23,31554,149,0.3804991037879859,0.004722063763706662,12,54
Europe,Germany,82927922,2020-03-26,4954,49,36508,198,0.4402377283733216,0.005423468828749863,13,54
Europe,Germany,82927922,2020-03-27,5780,55,42288,253,0.5099368099444238,0.005982784714339766,14,54
Europe,Germany,82927922,2020-03-28,6294,72,48582,325,0.5858340451362088,0.0066897204726030215,15,54
Europe,Germany,82927922,2020-03-29,3965,64,52547,389,0.6336466504008144,0.0074028964546025465,16,54
Europe,Germany,82927922,2020-03-30,4751,66,57298,455,0.6909373660659193,0.00794094034695801,17,54
Europe,Germany,82927922,2020-03-31,4615,128,61913,583,0.7465881033411159,0.009416439196937638,18,54
Europe,Germany,82927922,2020-04-01,5453,149,67366,732,0.8123440015776592,0.010866015497431939,19,54
Europe,Germany,82927922,2020-04-02,6156,140,73522,872,0.8865771410502725,0.01186039552786921,20,54
Europe,Germany,82927922,2020-04-03,6174,145,79696,1017,0.9610273364862562,0.01276099176872114,21,54
Europe,Germany,82927922,2020-04-04,6082,141,85778,1158,1.0343681347761253,0.013499965025997342,22,54
Europe,Germany,82927922,2020-04-05,5936,184,91714,1342,1.1059483680297693,0.014632444337832827,23,54
Europe,Germany,82927922,2020-04-06,3677,92,95391,1434,1.1502880778804514,0.015032864735666887,24,54
Europe,Germany,82927922,2020-04-07,3834,173,99225,1607,1.1965209980783071,0.01619551524313429,25,54
Europe,Germany,82927922,2020-04-08,4003,254,103228,1861,1.2447918325989165,0.01802805440384392,26,54
Europe,Germany,82927922,2020-04-09,4974,246,108202,2107,1.3047716304768857,0.01947283784033567,27,54
Europe,Germany,82927922,2020-04-10,5323,266,113525,2373,1.3689599023113108,0.020902884827130586,28,54
Europe,Germany,82927922,2020-04-11,4133,171,117658,2544,1.4187983632340384,0.021621989155008584,29,54
Europe,Germany,82927922,2020-04-12,2821,129,120479,2673,1.4528158561600037,0.02218643913047087,30,54
Europe,Germany,82927922,2020-04-13,2537,126,123016,2799,1.4834086883305722,0.02275313780321259,31,54
Europe,Germany,82927922,2020-04-14,2082,170,125098,2969,1.5085148280937268,0.02373339301987242,32,54
Europe,Germany,82927922,2020-04-15,2486,285,127584,3254,1.53849266836808,0.025504765487835465,33,54
Europe,Germany,82927922,2020-04-16,2866,315,130450,3569,1.5730528012024707,0.027359141433499424,34,54
Europe,Germany,82927922,2020-04-17,3380,299,133830,3868,1.6138110876575444,0.028902338788014646,35,54
Europe,Germany,82927922,2020-04-18,3609,242,137439,4110,1.6573308083132723,0.029904175670661167,36,54
Europe,Germany,82927922,2020-04-19,2458,184,139897,4294,1.6869710059779381,0.03069401059350808,37,54
Europe,Germany,82927922,2020-04-20,1775,110,141672,4404,1.7083751356991679,0.031085888531255292,38,54
Europe,Germany,82927922,2020-04-21,1785,194,143457,4598,1.7298998520667141,0.03205141610378023,39,54
Europe,Germany,82927922,2020-04-22,2237,281,145694,4879,1.756875084847779,0.03348799538759317,40,54
Europe,Germany,82927922,2020-04-23,2352,215,148046,5094,1.7852370640614872,0.034408224470772596,41,54
Europe,Germany,82927922,2020-04-24,2337,227,150383,5321,1.8134181633057198,0.03538298876867731,42,54
Europe,Germany,82927922,2020-04-25,2055,179,152438,5500,1.8381987191238194,0.03608024245922933,43,54
Europe,Germany,82927922,2020-04-26,1737,140,154175,5640,1.859144619589045,0.03658180638884385,44,54
Europe,Germany,82927922,2020-04-27,1018,110,155193,5750,1.8714203401840939,0.03705064017062625,45,54
Europe,Germany,82927922,2020-04-28,1144,163,156337,5913,1.885215452522734,0.037822140632096046,46,54
Europe,Germany,82927922,2020-04-29,1304,202,157641,6115,1.900939951202443,0.038790669939926796,47,54
Europe,Germany,82927922,2020-04-30,1478,173,159119,6288,1.918762657528064,0.039517593750589185,48,54
Europe,Germany,82927922,2020-05-01,0,0,159119,6288,1.918762657528064,0.039517593750589185,49,54
Europe,Germany,82927922,2020-05-02,2584,287,161703,6575,1.9499222469363213,0.040660964855321176,50,54
Europe,Germany,82927922,2020-05-03,793,74,162496,6649,1.9594847679892426,0.04091793028751477,51,54
Europe,Germany,82927922,2020-05-04,679,43,163175,6692,1.9676726012741521,0.0410111843113222,52,54
Europe,Germany,82927922,2020-05-05,685,139,163860,6831,1.9759327865468521,0.04168802636396924,53,54
Europe,Germany,82927922,2020-05-06,1037,165,164897,6996,1.988437621769903,0.04242648441148111,54,54
Europe,Germany,82927922,2020-05-07,1194,123,166091,7119,2.002835667340127,0.042862045505174876,55,54
Europe,Germany,82927922,2020-05-08,1209,147,167300,7266,2.017414592879826,0.043430962343096235,56,54
Europe,Germany,82927922,2020-05-09,1251,103,168551,7369,2.0324999823340564,0.04371970501509929,57,54
Europe,Germany,82927922,2020-05-10,667,26,169218,7395,2.040543111643386,0.043701024713682944,58,54
Europe,Germany,82927922,2020-05-11,357,22,169575,7417,2.044848054916895,0.04373875866135928,59,54
Europe,Germany,82927922,2020-05-12,933,116,170508,7533,2.0560987890182516,0.04417974523189528,60,54
Europe,Germany,82927922,2020-05-13,798,101,171306,7634,2.065721603394331,0.044563529590323746,61,54
Europe,Germany,82927922,2020-05-14,933,89,172239,7723,2.076972337495687,0.04483885763386922,62,54
Europe,Germany,82927922,2020-05-15,913,101,173152,7824,2.0879818983044096,0.045185732766586585,63,54
Europe,Germany,82927922,2020-05-16,620,57,173772,7881,2.0954582703760503,0.04535253090256198,64,54
Europe,Germany,82927922,2020-05-17,583,33,174355,7914,2.1024884718563186,0.04539015227552981,65,54
Europe,Germany,82927922,2020-05-18,342,21,174697,7935,2.106612535160353,0.0454215012278402,66,54
Europe,Germany,82927922,2020-05-19,513,72,175210,8007,2.1127986301164037,0.04569944637863136,67,54
Europe,Germany,82927922,2020-05-20,797,83,176007,8090,2.122409385827852,0.04596408097405217,68,54
Europe,Germany,82927922,2020-05-21,745,57,176752,8147,2.1313930909784524,0.04609283063275097,69,54
Europe,Germany,82927922,2020-05-22,460,27,177212,8174,2.1369400767090245,0.0461255445455161,70,54
Europe,Germany,82927922,2020-05-23,638,42,177850,8216,2.1446335047440357,0.04619623278043295,71,54
Europe,Germany,82927922,2020-05-24,431,31,178281,8247,2.1498307892002892,0.04625843471822572,72,54
Europe,Germany,82927922,2020-05-25,289,10,178570,8257,2.153315743278844,0.04623956991655933,73,54
Europe,Germany,82927922,2020-05-26,432,45,179002,8302,2.158525086399729,0.046379370062904324,74,54
Europe,Germany,82927922,2020-05-27,362,47,179364,8349,2.1628903229963967,0.04654780223456212,75,54
Africa,Ghana,29767108,2020-04-15,70,0,636,8,0.021365864631525507,0.012578616352201259,0,55
Africa,Ghana,29767108,2020-04-16,5,0,641,8,0.021533835265421148,0.0124804992199688,1,55
Africa,Ghana,29767108,2020-04-17,0,0,641,8,0.021533835265421148,0.0124804992199688,2,55
Africa,Ghana,29767108,2020-04-18,0,0,641,8,0.021533835265421148,0.0124804992199688,3,55
Africa,Ghana,29767108,2020-04-19,193,1,834,9,0.02801750173379288,0.01079136690647482,4,55
Africa,Ghana,29767108,2020-04-20,208,0,1042,9,0.03500508010385154,0.008637236084452975,5,55
Africa,Ghana,29767108,2020-04-21,0,0,1042,9,0.03500508010385154,0.008637236084452975,6,55
Africa,Ghana,29767108,2020-04-22,0,0,1042,9,0.03500508010385154,0.008637236084452975,7,55
Africa,Ghana,29767108,2020-04-23,112,0,1154,9,0.0387676223031139,0.00779896013864818,8,55
Africa,Ghana,29767108,2020-04-24,0,0,1154,9,0.0387676223031139,0.00779896013864818,9,55
Africa,Ghana,29767108,2020-04-25,125,1,1279,10,0.04296688815050491,0.007818608287724784,10,55
Africa,Ghana,29767108,2020-04-26,0,0,1279,10,0.04296688815050491,0.007818608287724784,11,55
Africa,Ghana,29767108,2020-04-27,271,1,1550,11,0.052070896507648644,0.0070967741935483875,12,55
Africa,Ghana,29767108,2020-04-28,0,0,1550,11,0.052070896507648644,0.0070967741935483875,13,55
Africa,Ghana,29767108,2020-04-29,121,5,1671,16,0.05613578584792315,0.009575104727707959,14,55
Africa,Ghana,29767108,2020-04-30,0,0,1671,16,0.05613578584792315,0.009575104727707959,15,55
Africa,Ghana,29767108,2020-05-01,403,1,2074,17,0.0696742189399118,0.00819672131147541,16,55
Africa,Ghana,29767108,2020-05-02,0,0,2074,17,0.0696742189399118,0.00819672131147541,17,55
Africa,Ghana,29767108,2020-05-03,95,1,2169,18,0.07286566098392896,0.008298755186721992,18,55
Africa,Ghana,29767108,2020-05-04,0,0,2169,18,0.07286566098392896,0.008298755186721992,19,55
Africa,Ghana,29767108,2020-05-05,550,0,2719,18,0.09134243071244946,0.0066200809121000365,20,55
Africa,Ghana,29767108,2020-05-06,0,0,2719,18,0.09134243071244946,0.0066200809121000365,21,55
Africa,Ghana,29767108,2020-05-07,372,0,3091,18,0.10383944587428513,0.005823358136525397,22,55
Africa,Ghana,29767108,2020-05-08,0,0,3091,18,0.10383944587428513,0.005823358136525397,23,55
Africa,Ghana,29767108,2020-05-09,921,0,4012,18,0.13477963663786216,0.00448654037886341,24,55
Africa,Ghana,29767108,2020-05-10,251,4,4263,22,0.14321176245942333,0.005160684963640629,25,55
Africa,Ghana,29767108,2020-05-11,0,0,4263,22,0.14321176245942333,0.005160684963640629,26,55
Africa,Ghana,29767108,2020-05-12,437,0,4700,22,0.15789239586190235,0.004680851063829788,27,55
Africa,Ghana,29767108,2020-05-13,427,0,5127,22,0.17223708799659007,0.004291008386970939,28,55
Africa,Ghana,29767108,2020-05-14,281,2,5408,24,0.18167703762152507,0.004437869822485207,29,55
Africa,Ghana,29767108,2020-05-15,122,0,5530,24,0.1857755210885787,0.00433996383363472,30,55
Africa,Ghana,29767108,2020-05-16,108,4,5638,28,0.18940368678072453,0.004966300106420717,31,55
Africa,Ghana,29767108,2020-05-17,97,1,5735,29,0.19266231707829998,0.005056669572798605,32,55
Africa,Ghana,29767108,2020-05-18,0,0,5735,29,0.19266231707829998,0.005056669572798605,33,55
Africa,Ghana,29767108,2020-05-19,0,0,5735,29,0.19266231707829998,0.005056669572798605,34,55
Africa,Ghana,29767108,2020-05-20,361,2,6096,31,0.20478979684556523,0.005085301837270341,35,55
Africa,Ghana,29767108,2020-05-21,173,0,6269,31,0.21060158077835442,0.0049449672994097945,36,55
Africa,Ghana,29767108,2020-05-22,217,0,6486,31,0.21789150628942525,0.004779525131051496,37,55
Africa,Ghana,29767108,2020-05-23,131,0,6617,31,0.222292336897491,0.004684902523802327,38,55
Africa,Ghana,29767108,2020-05-24,0,0,6617,31,0.222292336897491,0.004684902523802327,39,55
Africa,Ghana,29767108,2020-05-25,66,1,6683,32,0.22450954926491348,0.004788268741583121,40,55
Africa,Ghana,29767108,2020-05-26,125,0,6808,32,0.2287088151123045,0.004700352526439483,41,55
Africa,Ghana,29767108,2020-05-27,309,2,7117,34,0.2390894002870551,0.00477729380356892,42,55
Europe,Greece,10727668,2020-03-15,38,2,228,3,0.021253454152384284,0.013157894736842105,0,56
Europe,Greece,10727668,2020-03-16,103,1,331,4,0.03085479528262806,0.012084592145015106,1,56
Europe,Greece,10727668,2020-03-17,21,0,352,4,0.032812350270347665,0.011363636363636364,2,56
Europe,Greece,10727668,2020-03-18,35,1,387,5,0.036074941916547004,0.012919896640826873,3,56
Europe,Greece,10727668,2020-03-19,31,0,418,5,0.038964665946037855,0.011961722488038277,4,56
Europe,Greece,10727668,2020-03-20,46,0,464,5,0.04325264353818556,0.010775862068965518,5,56
Europe,Greece,10727668,2020-03-21,31,3,495,8,0.0461423675676764,0.01616161616161616,6,56
Europe,Greece,10727668,2020-03-22,35,5,530,13,0.04940495921387574,0.024528301886792454,7,56
Europe,Greece,10727668,2020-03-23,94,2,624,15,0.05816734820652541,0.02403846153846154,8,56
Europe,Greece,10727668,2020-03-24,71,2,695,17,0.06478574840310122,0.02446043165467626,9,56
Europe,Greece,10727668,2020-03-25,48,3,743,20,0.06926015980360317,0.026917900403768506,10,56
Europe,Greece,10727668,2020-03-26,78,2,821,22,0.07653107832941884,0.02679658952496955,11,56
Europe,Greece,10727668,2020-03-27,71,4,892,26,0.08314947852599465,0.02914798206278027,12,56
Europe,Greece,10727668,2020-03-28,74,2,966,28,0.09004752943510184,0.028985507246376812,13,56
Europe,Greece,10727668,2020-03-29,95,4,1061,32,0.09890313533192861,0.030160226201696512,14,56
Europe,Greece,10727668,2020-03-30,95,6,1156,38,0.1077587412287554,0.0328719723183391,15,56
Europe,Greece,10727668,2020-03-31,56,5,1212,43,0.11297888786267435,0.03547854785478548,16,56
Europe,Greece,10727668,2020-04-01,102,6,1314,49,0.122487012088741,0.03729071537290715,17,56
Europe,Greece,10727668,2020-04-02,61,1,1375,50,0.12817324324354556,0.03636363636363636,18,56
Europe,Greece,10727668,2020-04-03,139,3,1514,53,0.1411303929241658,0.03500660501981506,19,56
Europe,Greece,10727668,2020-04-04,99,6,1613,59,0.15035886643770108,0.0365778053316801,20,56
Europe,Greece,10727668,2020-04-05,60,9,1673,68,0.15595188068832855,0.04064554692169755,21,56
Europe,Greece,10727668,2020-04-06,62,5,1735,73,0.16173132874731022,0.04207492795389049,22,56
Europe,Greece,10727668,2020-04-07,20,6,1755,79,0.16359566683085272,0.045014245014245016,23,56
Europe,Greece,10727668,2020-04-08,77,2,1832,81,0.17077336845249128,0.04421397379912664,24,56
Europe,Greece,10727668,2020-04-09,52,2,1884,83,0.1756206474697017,0.0440552016985138,25,56
Europe,Greece,10727668,2020-04-10,71,3,1955,86,0.18223904766627752,0.043989769820971865,26,56
Europe,Greece,10727668,2020-04-11,56,4,2011,90,0.18745919430019647,0.04475385380407757,27,56
Europe,Greece,10727668,2020-04-12,70,3,2081,93,0.19398437759259515,0.04469005285920231,28,56
Europe,Greece,10727668,2020-04-13,33,5,2114,98,0.19706053543044022,0.046357615894039736,29,56
Europe,Greece,10727668,2020-04-14,31,1,2145,99,0.19995025945993108,0.046153846153846156,30,56
Europe,Greece,10727668,2020-04-15,25,2,2170,101,0.2022806820643592,0.046543778801843315,31,56
Europe,Greece,10727668,2020-04-16,22,1,2192,102,0.20433145395625593,0.046532846715328466,32,56
Europe,Greece,10727668,2020-04-17,15,3,2207,105,0.20572970751891276,0.047575894879927506,33,56
Europe,Greece,10727668,2020-04-18,0,0,2207,105,0.20572970751891276,0.047575894879927506,34,56
Europe,Greece,10727668,2020-04-19,0,0,2207,105,0.20572970751891276,0.047575894879927506,35,56
Europe,Greece,10727668,2020-04-20,28,5,2235,110,0.20833978083587226,0.049217002237136466,36,56
Europe,Greece,10727668,2020-04-21,10,6,2245,116,0.2092719498776435,0.051670378619153676,37,56
Europe,Greece,10727668,2020-04-22,156,5,2401,121,0.22381378692927484,0.05039566847147022,38,56
Europe,Greece,10727668,2020-04-23,7,0,2408,121,0.22446630525851471,0.05024916943521595,39,56
Europe,Greece,10727668,2020-04-24,55,4,2463,125,0.2295932349882565,0.05075111652456354,40,56
Europe,Greece,10727668,2020-04-25,27,5,2490,130,0.2321100914010389,0.05220883534136546,41,56
Europe,Greece,10727668,2020-04-26,16,0,2506,130,0.23360156186787287,0.05187549880287311,42,56
Europe,Greece,10727668,2020-04-27,0,0,2506,130,0.23360156186787287,0.05187549880287311,43,56
Europe,Greece,10727668,2020-04-28,28,6,2534,136,0.23621163518483235,0.05367008681925809,44,56
Europe,Greece,10727668,2020-04-29,0,0,2534,136,0.23621163518483235,0.05367008681925809,45,56
Europe,Greece,10727668,2020-04-30,42,3,2576,139,0.24012674516027155,0.053959627329192544,46,56
Europe,Greece,10727668,2020-05-01,15,1,2591,140,0.2415249987229284,0.05403319181783095,47,56
Europe,Greece,10727668,2020-05-02,0,0,2591,140,0.2415249987229284,0.05403319181783095,48,56
Europe,Greece,10727668,2020-05-03,29,3,2620,143,0.244228288944065,0.05458015267175573,49,56
Europe,Greece,10727668,2020-05-04,6,1,2626,144,0.24478759036912778,0.05483625285605483,50,56
Europe,Greece,10727668,2020-05-05,6,2,2632,146,0.24534689179419047,0.05547112462006079,51,56
Europe,Greece,10727668,2020-05-06,10,0,2642,146,0.2462790608359617,0.05526116578349735,52,56
Europe,Greece,10727668,2020-05-07,21,1,2663,147,0.24823661582368137,0.0552009012392039,53,56
Europe,Greece,10727668,2020-05-08,15,1,2678,148,0.2496348693863382,0.05526512322628827,54,56
Europe,Greece,10727668,2020-05-09,13,2,2691,150,0.2508466891406408,0.055741360089186176,55,56
Europe,Greece,10727668,2020-05-10,19,1,2710,151,0.2526178103200062,0.05571955719557196,56,56
Europe,Greece,10727668,2020-05-11,6,0,2716,151,0.2531771117450689,0.05559646539027982,57,56
Europe,Greece,10727668,2020-05-12,10,0,2726,151,0.25410928078684014,0.0553925165077036,58,56
Europe,Greece,10727668,2020-05-13,18,1,2744,152,0.2557871850620284,0.05539358600583091,59,56
Europe,Greece,10727668,2020-05-14,16,3,2760,155,0.25727865552886237,0.05615942028985507,60,56
Europe,Greece,10727668,2020-05-15,10,1,2770,156,0.2582108245706336,0.05631768953068592,61,56
Europe,Greece,10727668,2020-05-16,40,4,2810,160,0.2619395007377186,0.05693950177935943,62,56
Europe,Greece,10727668,2020-05-17,9,2,2819,162,0.2627784528753127,0.05746718694572543,63,56
Europe,Greece,10727668,2020-05-18,15,1,2834,163,0.2641767064379696,0.05751587861679605,64,56
Europe,Greece,10727668,2020-05-19,2,2,2836,165,0.26436314024632385,0.058180535966149506,65,56
Europe,Greece,10727668,2020-05-20,4,0,2840,165,0.2647360078630323,0.058098591549295774,66,56
Europe,Greece,10727668,2020-05-21,10,1,2850,166,0.26566817690480354,0.05824561403508772,67,56
Europe,Greece,10727668,2020-05-22,3,2,2853,168,0.2659478276173349,0.058885383806519455,68,56
Europe,Greece,10727668,2020-05-23,20,1,2873,169,0.2678121657008774,0.058823529411764705,69,56
Europe,Greece,10727668,2020-05-24,3,2,2876,171,0.26809181641340873,0.05945757997218359,70,56
Europe,Greece,10727668,2020-05-25,2,0,2878,171,0.268278250221763,0.05941626129256428,71,56
Europe,Greece,10727668,2020-05-26,4,1,2882,172,0.2686511178384715,0.05968077723802915,72,56
Europe,Greece,10727668,2020-05-27,10,1,2892,173,0.26958328688024275,0.059820193637621026,73,56
America,Grenada,111454,2020-03-27,6,0,7,0,0.06280618012812461,0,0,57
America,Grenada,111454,2020-03-28,0,0,7,0,0.06280618012812461,0,1,57
America,Grenada,111454,2020-03-29,2,0,9,0,0.0807508030218745,0,2,57
America,Grenada,111454,2020-03-30,0,0,9,0,0.0807508030218745,0,3,57
America,Grenada,111454,2020-03-31,0,0,9,0,0.0807508030218745,0,4,57
America,Grenada,111454,2020-04-01,0,0,9,0,0.0807508030218745,0,5,57
America,Grenada,111454,2020-04-02,1,0,10,0,0.08972311446874945,0,6,57
America,Grenada,111454,2020-04-03,0,0,10,0,0.08972311446874945,0,7,57
America,Grenada,111454,2020-04-04,2,0,12,0,0.10766773736249934,0,8,57
America,Grenada,111454,2020-04-05,0,0,12,0,0.10766773736249934,0,9,57
America,Grenada,111454,2020-04-06,0,0,12,0,0.10766773736249934,0,10,57
America,Grenada,111454,2020-04-07,0,0,12,0,0.10766773736249934,0,11,57
America,Grenada,111454,2020-04-08,0,0,12,0,0.10766773736249934,0,12,57
America,Grenada,111454,2020-04-09,0,0,12,0,0.10766773736249934,0,13,57
America,Grenada,111454,2020-04-10,0,0,12,0,0.10766773736249934,0,14,57
America,Grenada,111454,2020-04-11,2,0,14,0,0.12561236025624922,0,15,57
America,Grenada,111454,2020-04-12,0,0,14,0,0.12561236025624922,0,16,57
America,Grenada,111454,2020-04-13,0,0,14,0,0.12561236025624922,0,17,57
America,Grenada,111454,2020-04-14,0,0,14,0,0.12561236025624922,0,18,57
America,Grenada,111454,2020-04-15,0,0,14,0,0.12561236025624922,0,19,57
America,Grenada,111454,2020-04-16,0,0,14,0,0.12561236025624922,0,20,57
America,Grenada,111454,2020-04-17,0,0,14,0,0.12561236025624922,0,21,57
America,Grenada,111454,2020-04-18,0,0,14,0,0.12561236025624922,0,22,57
America,Grenada,111454,2020-04-19,0,0,14,0,0.12561236025624922,0,23,57
America,Grenada,111454,2020-04-20,0,0,14,0,0.12561236025624922,0,24,57
America,Grenada,111454,2020-04-21,0,0,14,0,0.12561236025624922,0,25,57
America,Grenada,111454,2020-04-22,0,0,14,0,0.12561236025624922,0,26,57
America,Grenada,111454,2020-04-23,1,0,15,0,0.13458467170312416,0,27,57
America,Grenada,111454,2020-04-24,0,0,15,0,0.13458467170312416,0,28,57
America,Grenada,111454,2020-04-25,0,0,15,0,0.13458467170312416,0,29,57
America,Grenada,111454,2020-04-26,3,0,18,0,0.161501606043749,0,30,57
America,Grenada,111454,2020-04-27,0,0,18,0,0.161501606043749,0,31,57
America,Grenada,111454,2020-04-28,0,0,18,0,0.161501606043749,0,32,57
America,Grenada,111454,2020-04-29,0,0,18,0,0.161501606043749,0,33,57
America,Grenada,111454,2020-04-30,2,0,20,0,0.1794462289374989,0,34,57
America,Grenada,111454,2020-05-01,0,0,20,0,0.1794462289374989,0,35,57
America,Grenada,111454,2020-05-02,0,0,20,0,0.1794462289374989,0,36,57
America,Grenada,111454,2020-05-03,1,0,21,0,0.1884185403843738,0,37,57
America,Grenada,111454,2020-05-04,0,0,21,0,0.1884185403843738,0,38,57
America,Grenada,111454,2020-05-05,0,0,21,0,0.1884185403843738,0,39,57
America,Grenada,111454,2020-05-06,0,0,21,0,0.1884185403843738,0,40,57
America,Grenada,111454,2020-05-07,0,0,21,0,0.1884185403843738,0,41,57
America,Grenada,111454,2020-05-08,0,0,21,0,0.1884185403843738,0,42,57
America,Grenada,111454,2020-05-09,0,0,21,0,0.1884185403843738,0,43,57
America,Grenada,111454,2020-05-10,0,0,21,0,0.1884185403843738,0,44,57
America,Grenada,111454,2020-05-11,0,0,21,0,0.1884185403843738,0,45,57
America,Grenada,111454,2020-05-12,0,0,21,0,0.1884185403843738,0,46,57
America,Grenada,111454,2020-05-13,0,0,21,0,0.1884185403843738,0,47,57
America,Grenada,111454,2020-05-14,0,0,21,0,0.1884185403843738,0,48,57
America,Grenada,111454,2020-05-15,0,0,21,0,0.1884185403843738,0,49,57
America,Grenada,111454,2020-05-16,1,0,22,0,0.19739085183124877,0,50,57
America,Grenada,111454,2020-05-17,0,0,22,0,0.19739085183124877,0,51,57
America,Grenada,111454,2020-05-18,0,0,22,0,0.19739085183124877,0,52,57
America,Grenada,111454,2020-05-19,0,0,22,0,0.19739085183124877,0,53,57
America,Grenada,111454,2020-05-20,0,0,22,0,0.19739085183124877,0,54,57
America,Grenada,111454,2020-05-21,0,0,22,0,0.19739085183124877,0,55,57
America,Grenada,111454,2020-05-22,0,0,22,0,0.19739085183124877,0,56,57
America,Grenada,111454,2020-05-23,0,0,22,0,0.19739085183124877,0,57,57
America,Grenada,111454,2020-05-24,0,0,22,0,0.19739085183124877,0,58,57
America,Grenada,111454,2020-05-25,0,0,22,0,0.19739085183124877,0,59,57
America,Grenada,111454,2020-05-26,1,0,23,0,0.2063631632781237,0,60,57
America,Grenada,111454,2020-05-27,0,0,23,0,0.2063631632781237,0,61,57
Oceania,Guam,165768,2020-03-20,9,0,12,0,0.07239032865209208,0,0,58
Oceania,Guam,165768,2020-03-21,2,0,14,0,0.08445538342744076,0,1,58
Oceania,Guam,165768,2020-03-22,1,1,15,1,0.0904879108151151,0.06666666666666667,2,58
Oceania,Guam,165768,2020-03-23,12,0,27,1,0.1628782394672072,0.037037037037037035,3,58
Oceania,Guam,165768,2020-03-24,2,0,29,1,0.17494329424255586,0.034482758620689655,4,58
Oceania,Guam,165768,2020-03-25,3,0,32,1,0.19304087640557888,0.03125,5,58
Oceania,Guam,165768,2020-03-26,5,0,37,1,0.22320351334395058,0.02702702702702703,6,58
Oceania,Guam,165768,2020-03-27,12,0,49,1,0.29559384199604266,0.02040816326530612,7,58
Oceania,Guam,165768,2020-03-28,2,0,51,1,0.30765889677139135,0.0196078431372549,8,58
Oceania,Guam,165768,2020-03-29,4,0,55,1,0.33178900632208874,0.01818181818181818,9,58
Oceania,Guam,165768,2020-03-30,1,0,56,1,0.33782153370976303,0.017857142857142856,10,58
Oceania,Guam,165768,2020-03-31,4,0,60,1,0.3619516432604604,0.016666666666666666,11,58
Oceania,Guam,165768,2020-04-01,9,2,69,3,0.41624438974952943,0.043478260869565216,12,58
Oceania,Guam,165768,2020-04-02,8,0,77,3,0.4645046088509242,0.03896103896103896,13,58
Oceania,Guam,165768,2020-04-03,5,0,82,3,0.4946672457892959,0.036585365853658534,14,58
Oceania,Guam,165768,2020-04-04,5,1,87,4,0.5248298827276675,0.04597701149425287,15,58
Oceania,Guam,165768,2020-04-05,6,0,93,4,0.5610250470537136,0.043010752688172046,16,58
Oceania,Guam,165768,2020-04-06,17,0,110,4,0.6635780126441775,0.03636363636363636,17,58
Oceania,Guam,165768,2020-04-07,2,0,112,4,0.6756430674195261,0.03571428571428571,18,58
Oceania,Guam,165768,2020-04-08,9,0,121,4,0.7299358139085952,0.03305785123966942,19,58
Oceania,Guam,165768,2020-04-09,4,0,125,4,0.7540659234592925,0.032,20,58
Oceania,Guam,165768,2020-04-10,3,0,128,4,0.7721635056223155,0.03125,21,58
Oceania,Guam,165768,2020-04-11,2,0,130,4,0.7842285603976642,0.03076923076923077,22,58
Oceania,Guam,165768,2020-04-12,3,1,133,5,0.8023261425606872,0.03759398496240601,23,58
Oceania,Guam,165768,2020-04-13,0,0,133,5,0.8023261425606872,0.03759398496240601,24,58
Oceania,Guam,165768,2020-04-14,1,0,134,5,0.8083586699483616,0.03731343283582089,25,58
Oceania,Guam,165768,2020-04-15,1,0,135,5,0.8143911973360359,0.037037037037037035,26,58
Oceania,Guam,165768,2020-04-16,0,0,135,5,0.8143911973360359,0.037037037037037035,27,58
Oceania,Guam,165768,2020-04-17,0,0,135,5,0.8143911973360359,0.037037037037037035,28,58
Oceania,Guam,165768,2020-04-18,1,0,136,5,0.8204237247237102,0.03676470588235294,29,58
Oceania,Guam,165768,2020-04-19,0,0,136,5,0.8204237247237102,0.03676470588235294,30,58
Oceania,Guam,165768,2020-04-20,0,0,136,5,0.8204237247237102,0.03676470588235294,31,58
Oceania,Guam,165768,2020-04-21,0,0,136,5,0.8204237247237102,0.03676470588235294,32,58
Oceania,Guam,165768,2020-04-22,0,0,136,5,0.8204237247237102,0.03676470588235294,33,58
Oceania,Guam,165768,2020-04-23,1,0,137,5,0.8264562521113845,0.0364963503649635,34,58
Oceania,Guam,165768,2020-04-24,3,0,140,5,0.8445538342744077,0.03571428571428571,35,58
Oceania,Guam,165768,2020-04-25,1,0,141,5,0.850586361662082,0.03546099290780142,36,58
Oceania,Guam,165768,2020-04-26,0,0,141,5,0.850586361662082,0.03546099290780142,37,58
Oceania,Guam,165768,2020-04-27,1,0,142,5,0.8566188890497562,0.035211267605633804,38,58
Oceania,Guam,165768,2020-04-28,2,0,144,5,0.8686839438251049,0.034722222222222224,39,58
Oceania,Guam,165768,2020-04-29,1,0,145,5,0.8747164712127793,0.034482758620689655,40,58
Oceania,Guam,165768,2020-04-30,0,0,145,5,0.8747164712127793,0.034482758620689655,41,58
Oceania,Guam,165768,2020-05-01,1,0,146,5,0.8807489986004536,0.03424657534246575,42,58
Oceania,Guam,165768,2020-05-02,0,0,146,5,0.8807489986004536,0.03424657534246575,43,58
Oceania,Guam,165768,2020-05-03,2,0,148,5,0.8928140533758023,0.033783783783783786,44,58
Oceania,Guam,165768,2020-05-04,1,0,149,5,0.8988465807634767,0.03355704697986577,45,58
Oceania,Guam,165768,2020-05-05,0,0,149,5,0.8988465807634767,0.03355704697986577,46,58
Oceania,Guam,165768,2020-05-06,0,0,149,5,0.8988465807634767,0.03355704697986577,47,58
Oceania,Guam,165768,2020-05-07,2,0,151,5,0.9109116355388254,0.033112582781456956,48,58
Oceania,Guam,165768,2020-05-08,0,0,151,5,0.9109116355388254,0.033112582781456956,49,58
Oceania,Guam,165768,2020-05-09,0,0,151,5,0.9109116355388254,0.033112582781456956,50,58
Oceania,Guam,165768,2020-05-10,0,0,151,5,0.9109116355388254,0.033112582781456956,51,58
Oceania,Guam,165768,2020-05-11,0,0,151,5,0.9109116355388254,0.033112582781456956,52,58
Oceania,Guam,165768,2020-05-12,1,0,152,5,0.9169441629264997,0.03289473684210526,53,58
Oceania,Guam,165768,2020-05-13,0,0,152,5,0.9169441629264997,0.03289473684210526,54,58
Oceania,Guam,165768,2020-05-14,0,0,152,5,0.9169441629264997,0.03289473684210526,55,58
Oceania,Guam,165768,2020-05-15,2,0,154,5,0.9290092177018484,0.032467532467532464,56,58
Oceania,Guam,165768,2020-05-16,0,0,154,5,0.9290092177018484,0.032467532467532464,57,58
Oceania,Guam,165768,2020-05-17,0,0,154,5,0.9290092177018484,0.032467532467532464,58,58
Oceania,Guam,165768,2020-05-18,0,0,154,5,0.9290092177018484,0.032467532467532464,59,58
Oceania,Guam,165768,2020-05-19,0,0,154,5,0.9290092177018484,0.032467532467532464,60,58
Oceania,Guam,165768,2020-05-20,0,0,154,5,0.9290092177018484,0.032467532467532464,61,58
Oceania,Guam,165768,2020-05-21,11,0,165,5,0.9953670189662661,0.030303030303030304,62,58
Oceania,Guam,165768,2020-05-22,0,0,165,5,0.9953670189662661,0.030303030303030304,63,58
Oceania,Guam,165768,2020-05-23,0,0,165,5,0.9953670189662661,0.030303030303030304,64,58
Oceania,Guam,165768,2020-05-24,1,0,166,5,1.0013995463539405,0.030120481927710843,65,58
Oceania,Guam,165768,2020-05-25,0,0,166,5,1.0013995463539405,0.030120481927710843,66,58
Oceania,Guam,165768,2020-05-26,0,0,166,5,1.0013995463539405,0.030120481927710843,67,58
Oceania,Guam,165768,2020-05-27,3,0,169,5,1.0194971285169634,0.029585798816568046,68,58
America,Guatemala,17247807,2020-04-24,42,1,384,11,0.02226369995907306,0.028645833333333332,0,59
America,Guatemala,17247807,2020-04-25,46,0,430,11,0.02493070568333702,0.02558139534883721,1,59
America,Guatemala,17247807,2020-04-26,43,2,473,13,0.02742377625167072,0.02748414376321353,2,59
America,Guatemala,17247807,2020-04-27,27,2,500,15,0.028989192655043045,0.03,3,59
America,Guatemala,17247807,2020-04-28,30,0,530,15,0.030728544214345628,0.02830188679245283,4,59
America,Guatemala,17247807,2020-04-29,27,1,557,16,0.03229396061771795,0.02872531418312388,5,59
America,Guatemala,17247807,2020-04-30,28,0,585,16,0.03391735540640036,0.02735042735042735,6,59
America,Guatemala,17247807,2020-05-01,14,0,599,16,0.03472905280074157,0.02671118530884808,7,59
America,Guatemala,17247807,2020-05-02,45,0,644,16,0.03733808013969544,0.024844720496894408,8,59
America,Guatemala,17247807,2020-05-03,44,1,688,17,0.03988912909333923,0.024709302325581394,9,59
America,Guatemala,17247807,2020-05-04,15,0,703,17,0.04075880487299052,0.02418207681365576,10,59
America,Guatemala,17247807,2020-05-05,27,2,730,19,0.042324221276362844,0.026027397260273973,11,59
America,Guatemala,17247807,2020-05-06,33,0,763,19,0.04423750799159568,0.02490170380078637,12,59
America,Guatemala,17247807,2020-05-07,35,2,798,21,0.046266751477448693,0.02631578947368421,13,59
America,Guatemala,17247807,2020-05-08,34,2,832,23,0.04823801657799163,0.027644230769230768,14,59
America,Guatemala,17247807,2020-05-09,68,1,900,24,0.05218054677907748,0.02666666666666667,15,59
America,Guatemala,17247807,2020-05-10,67,0,967,24,0.05606509859485325,0.02481902792140641,16,59
America,Guatemala,17247807,2020-05-11,85,2,1052,26,0.06099326134621057,0.024714828897338403,17,59
America,Guatemala,17247807,2020-05-12,62,0,1114,26,0.0645879212354359,0.02333931777378815,18,59
America,Guatemala,17247807,2020-05-13,85,1,1199,27,0.06951608398679322,0.022518765638031693,19,59
America,Guatemala,17247807,2020-05-14,143,2,1342,29,0.07780699308613553,0.021609538002980627,20,59
America,Guatemala,17247807,2020-05-15,176,0,1518,29,0.08801118890071069,0.019104084321475624,21,59
America,Guatemala,17247807,2020-05-16,125,1,1643,30,0.09525848706447144,0.018259281801582473,22,59
America,Guatemala,17247807,2020-05-17,120,3,1763,33,0.10221589330168177,0.01871809415768576,23,59
America,Guatemala,17247807,2020-05-18,149,2,1912,35,0.1108546727128846,0.018305439330543932,24,59
America,Guatemala,17247807,2020-05-19,89,3,2001,38,0.11601474900548227,0.01899050474762619,25,59
America,Guatemala,17247807,2020-05-20,132,5,2133,43,0.12366789586641362,0.02015939990623535,26,59
America,Guatemala,17247807,2020-05-21,132,2,2265,45,0.131321042727345,0.019867549668874173,27,59
America,Guatemala,17247807,2020-05-22,247,3,2512,48,0.14564170389893624,0.01910828025477707,28,59
America,Guatemala,17247807,2020-05-23,231,3,2743,51,0.15903471090556615,0.01859278162595698,29,59
America,Guatemala,17247807,2020-05-24,311,4,3054,55,0.1770659887370029,0.018009168303863784,30,59
America,Guatemala,17247807,2020-05-25,370,3,3424,58,0.19851799130173475,0.016939252336448597,31,59
America,Guatemala,17247807,2020-05-26,336,1,3760,59,0.2179987287659237,0.015691489361702126,32,59
America,Guatemala,17247807,2020-05-27,194,4,3954,63,0.22924653551608037,0.015933232169954476,33,59
Africa,Guinea,12414318,2020-04-12,38,0,250,0,0.020138037385541437,0,0,60
Africa,Guinea,12414318,2020-04-13,0,0,250,0,0.020138037385541437,0,1,60
Africa,Guinea,12414318,2020-04-14,69,0,319,0,0.02569613570395087,0,2,60
Africa,Guinea,12414318,2020-04-15,44,0,363,0,0.029240430283806164,0,3,60
Africa,Guinea,12414318,2020-04-16,41,1,404,1,0.03254306841503496,0.0024752475247524753,4,60
Africa,Guinea,12414318,2020-04-17,34,0,438,1,0.0352818414994686,0.00228310502283105,5,60
Africa,Guinea,12414318,2020-04-18,39,2,477,3,0.03842337533161306,0.006289308176100629,6,60
Africa,Guinea,12414318,2020-04-19,0,0,477,3,0.03842337533161306,0.006289308176100629,7,60
Africa,Guinea,12414318,2020-04-20,102,2,579,5,0.046639694584913974,0.008635578583765112,8,60
Africa,Guinea,12414318,2020-04-21,43,0,622,5,0.0501034370152271,0.008038585209003215,9,60
Africa,Guinea,12414318,2020-04-22,66,1,688,6,0.055419878885010036,0.00872093023255814,10,60
Africa,Guinea,12414318,2020-04-23,73,0,761,6,0.06130018580158813,0.00788436268068331,11,60
Africa,Guinea,12414318,2020-04-24,101,0,862,6,0.06943595290534688,0.0069605568445475635,12,60
Africa,Guinea,12414318,2020-04-25,92,0,954,6,0.07684675066322612,0.006289308176100629,13,60
Africa,Guinea,12414318,2020-04-26,42,1,996,7,0.08022994094399709,0.007028112449799197,14,60
Africa,Guinea,12414318,2020-04-27,98,0,1094,7,0.08812405159912934,0.006398537477148081,15,60
Africa,Guinea,12414318,2020-04-28,69,0,1163,7,0.09368214991753876,0.0060189165950128975,16,60
Africa,Guinea,12414318,2020-04-29,77,0,1240,7,0.09988466543228552,0.00564516129032258,17,60
Africa,Guinea,12414318,2020-04-30,111,0,1351,7,0.10882595403146593,0.0051813471502590676,18,60
Africa,Guinea,12414318,2020-05-01,144,0,1495,7,0.1204254635655378,0.0046822742474916385,19,60
Africa,Guinea,12414318,2020-05-02,42,0,1537,7,0.12380865384630876,0.004554326610279766,20,60
Africa,Guinea,12414318,2020-05-03,49,0,1586,7,0.12775570917387488,0.004413619167717529,21,60
Africa,Guinea,12414318,2020-05-04,0,0,1586,7,0.12775570917387488,0.004413619167717529,22,60
Africa,Guinea,12414318,2020-05-05,124,2,1710,9,0.13774417571710343,0.005263157894736842,23,60
Africa,Guinea,12414318,2020-05-06,101,1,1811,10,0.14587994282086217,0.005521811154058531,24,60
Africa,Guinea,12414318,2020-05-07,45,1,1856,11,0.14950478955025961,0.005926724137931034,25,60
Africa,Guinea,12414318,2020-05-08,71,0,1927,11,0.1552239921677534,0.005708354955889984,26,60
Africa,Guinea,12414318,2020-05-09,82,0,2009,11,0.161829268430211,0.0054753608760577405,27,60
Africa,Guinea,12414318,2020-05-10,33,0,2042,11,0.16448748936510246,0.0053868756121449556,28,60
Africa,Guinea,12414318,2020-05-11,104,0,2146,11,0.1728649129174877,0.005125815470643057,29,60
Africa,Guinea,12414318,2020-05-12,67,0,2213,11,0.1782619069368128,0.004970628106642567,30,60
Africa,Guinea,12414318,2020-05-13,0,0,2213,11,0.1782619069368128,0.004970628106642567,31,60
Africa,Guinea,12414318,2020-05-14,161,3,2374,14,0.1912308030131015,0.005897219882055603,32,60
Africa,Guinea,12414318,2020-05-15,99,0,2473,14,0.19920546581777587,0.005661140315406389,33,60
Africa,Guinea,12414318,2020-05-16,58,1,2531,15,0.20387749049122153,0.005926511260371394,34,60
Africa,Guinea,12414318,2020-05-17,127,1,2658,16,0.21410761348307658,0.006019563581640331,35,60
Africa,Guinea,12414318,2020-05-18,0,0,2658,16,0.21410761348307658,0.006019563581640331,36,60
Africa,Guinea,12414318,2020-05-19,138,0,2796,16,0.22522381011989545,0.005722460658082976,37,60
Africa,Guinea,12414318,2020-05-20,67,2,2863,18,0.23062080413922054,0.0062871114215857496,38,60
Africa,Guinea,12414318,2020-05-21,0,0,2863,18,0.23062080413922054,0.0062871114215857496,39,60
Africa,Guinea,12414318,2020-05-22,204,1,3067,19,0.24705344264582235,0.006194978806651451,40,60
Africa,Guinea,12414318,2020-05-23,0,0,3067,19,0.24705344264582235,0.006194978806651451,41,60
Africa,Guinea,12414318,2020-05-24,109,1,3176,20,0.25583362694591844,0.006297229219143577,42,60
Africa,Guinea,12414318,2020-05-25,99,0,3275,20,0.2638082897505928,0.0061068702290076335,43,60
Africa,Guinea,12414318,2020-05-26,0,0,3275,20,0.2638082897505928,0.0061068702290076335,44,60
Africa,Guinea,12414318,2020-05-27,83,0,3358,20,0.2704941181625926,0.005955926146515783,45,60
Africa,Guinea Bissau,1874309,2020-04-12,3,0,38,0,0.020274138362457842,0,0,61
Africa,Guinea Bissau,1874309,2020-04-13,1,0,39,0,0.02080766831936463,0,1,61
Africa,Guinea Bissau,1874309,2020-04-14,0,0,39,0,0.02080766831936463,0,2,61
Africa,Guinea Bissau,1874309,2020-04-15,1,0,40,0,0.021341198276271418,0,3,61
Africa,Guinea Bissau,1874309,2020-04-16,3,0,43,0,0.02294178814699177,0,4,61
Africa,Guinea Bissau,1874309,2020-04-17,3,0,46,0,0.024542378017712127,0,5,61
Africa,Guinea Bissau,1874309,2020-04-18,4,0,50,0,0.02667649784533927,0,6,61
Africa,Guinea Bissau,1874309,2020-04-19,0,0,50,0,0.02667649784533927,0,7,61
Africa,Guinea Bissau,1874309,2020-04-20,0,0,50,0,0.02667649784533927,0,8,61
Africa,Guinea Bissau,1874309,2020-04-21,0,0,50,0,0.02667649784533927,0,9,61
Africa,Guinea Bissau,1874309,2020-04-22,0,0,50,0,0.02667649784533927,0,10,61
Africa,Guinea Bissau,1874309,2020-04-23,0,0,50,0,0.02667649784533927,0,11,61
Africa,Guinea Bissau,1874309,2020-04-24,2,0,52,0,0.02774355775915284,0,12,61
Africa,Guinea Bissau,1874309,2020-04-25,0,0,52,0,0.02774355775915284,0,13,61
Africa,Guinea Bissau,1874309,2020-04-26,0,0,52,0,0.02774355775915284,0,14,61
Africa,Guinea Bissau,1874309,2020-04-27,1,1,53,1,0.028277087716059624,0.018867924528301886,15,61
Africa,Guinea Bissau,1874309,2020-04-28,20,0,73,1,0.03894768685419533,0.0136986301369863,16,61
Africa,Guinea Bissau,1874309,2020-04-29,0,0,73,1,0.03894768685419533,0.0136986301369863,17,61
Africa,Guinea Bissau,1874309,2020-04-30,4,0,77,1,0.04108180668182247,0.012987012987012988,18,61
Africa,Guinea Bissau,1874309,2020-05-01,128,0,205,1,0.109373641165891,0.004878048780487805,19,61
Africa,Guinea Bissau,1874309,2020-05-02,52,0,257,1,0.13711719892504384,0.0038910505836575876,20,61
Africa,Guinea Bissau,1874309,2020-05-03,0,0,257,1,0.13711719892504384,0.0038910505836575876,21,61
Africa,Guinea Bissau,1874309,2020-05-04,35,1,292,2,0.1557907474167813,0.00684931506849315,22,61
Africa,Guinea Bissau,1874309,2020-05-05,121,0,413,2,0.22034787220250235,0.004842615012106538,23,61
Africa,Guinea Bissau,1874309,2020-05-06,62,0,475,2,0.25342672953072304,0.004210526315789474,24,61
Africa,Guinea Bissau,1874309,2020-05-07,0,0,475,2,0.25342672953072304,0.004210526315789474,25,61
Africa,Guinea Bissau,1874309,2020-05-08,89,0,564,2,0.30091089569542695,0.0035460992907801418,26,61
Africa,Guinea Bissau,1874309,2020-05-09,30,0,594,2,0.31691679440263054,0.003367003367003367,27,61
Africa,Guinea Bissau,1874309,2020-05-10,47,1,641,3,0.34199270237724944,0.0046801872074883,28,61
Africa,Guinea Bissau,1874309,2020-05-11,85,0,726,3,0.3873427487143262,0.004132231404958678,29,61
Africa,Guinea Bissau,1874309,2020-05-12,35,0,761,3,0.4060162972060637,0.003942181340341655,30,61
Africa,Guinea Bissau,1874309,2020-05-13,59,0,820,3,0.437494564663564,0.003658536585365854,31,61
Africa,Guinea Bissau,1874309,2020-05-14,0,0,820,3,0.437494564663564,0.003658536585365854,32,61
Africa,Guinea Bissau,1874309,2020-05-15,93,0,913,3,0.48711285065589505,0.0032858707557502738,33,61
Africa,Guinea Bissau,1874309,2020-05-16,0,0,913,3,0.48711285065589505,0.0032858707557502738,34,61
Africa,Guinea Bissau,1874309,2020-05-17,0,0,913,3,0.48711285065589505,0.0032858707557502738,35,61
Africa,Guinea Bissau,1874309,2020-05-18,77,1,990,4,0.5281946573377175,0.00404040404040404,36,61
Africa,Guinea Bissau,1874309,2020-05-19,0,0,990,4,0.5281946573377175,0.00404040404040404,37,61
Africa,Guinea Bissau,1874309,2020-05-20,48,2,1038,6,0.5538040952692432,0.005780346820809248,38,61
Africa,Guinea Bissau,1874309,2020-05-21,0,0,1038,6,0.5538040952692432,0.005780346820809248,39,61
Africa,Guinea Bissau,1874309,2020-05-22,51,0,1089,6,0.5810141230714893,0.005509641873278237,40,61
Africa,Guinea Bissau,1874309,2020-05-23,0,0,1089,6,0.5810141230714893,0.005509641873278237,41,61
Africa,Guinea Bissau,1874309,2020-05-24,25,0,1114,6,0.5943523719941589,0.005385996409335727,42,61
Africa,Guinea Bissau,1874309,2020-05-25,59,0,1173,6,0.6258306394516592,0.005115089514066497,43,61
Africa,Guinea Bissau,1874309,2020-05-26,0,0,1173,6,0.6258306394516592,0.005115089514066497,44,61
Africa,Guinea Bissau,1874309,2020-05-27,0,0,1173,6,0.6258306394516592,0.005115089514066497,45,61
America,Guyana,779004,2020-04-02,7,2,19,4,0.024390118664345754,0.21052631578947367,0,62
America,Guyana,779004,2020-04-03,0,0,19,4,0.024390118664345754,0.21052631578947367,1,62
America,Guyana,779004,2020-04-04,4,0,23,4,0.029524880488418545,0.17391304347826086,2,62
America,Guyana,779004,2020-04-05,1,0,24,4,0.03080857094443674,0.16666666666666666,3,62
America,Guyana,779004,2020-04-06,5,0,29,4,0.03722702322452773,0.13793103448275862,4,62
America,Guyana,779004,2020-04-07,2,1,31,5,0.03979440413656413,0.16129032258064516,5,62
America,Guyana,779004,2020-04-08,2,0,33,5,0.04236178504860052,0.15151515151515152,6,62
America,Guyana,779004,2020-04-09,4,1,37,6,0.047496546872673316,0.16216216216216217,7,62
America,Guyana,779004,2020-04-10,0,0,37,6,0.047496546872673316,0.16216216216216217,8,62
America,Guyana,779004,2020-04-11,3,0,40,6,0.0513476182407279,0.15,9,62
America,Guyana,779004,2020-04-12,5,0,45,6,0.05776607052081889,0.13333333333333333,10,62
America,Guyana,779004,2020-04-13,0,0,45,6,0.05776607052081889,0.13333333333333333,11,62
America,Guyana,779004,2020-04-14,2,0,47,6,0.06033345143285529,0.1276595744680851,12,62
America,Guyana,779004,2020-04-15,1,0,48,6,0.06161714188887348,0.125,13,62
America,Guyana,779004,2020-04-16,7,0,55,6,0.07060297508100087,0.10909090909090909,14,62
America,Guyana,779004,2020-04-17,2,0,57,6,0.07317035599303726,0.10526315789473684,15,62
America,Guyana,779004,2020-04-18,6,0,63,6,0.08087249872914645,0.09523809523809523,16,62
America,Guyana,779004,2020-04-19,0,1,63,7,0.08087249872914645,0.1111111111111111,17,62
America,Guyana,779004,2020-04-20,2,0,65,7,0.08343987964118285,0.1076923076923077,18,62
America,Guyana,779004,2020-04-21,1,0,66,7,0.08472357009720104,0.10606060606060606,19,62
America,Guyana,779004,2020-04-22,1,0,67,7,0.08600726055321924,0.1044776119402985,20,62
America,Guyana,779004,2020-04-23,0,0,67,7,0.08600726055321924,0.1044776119402985,21,62
America,Guyana,779004,2020-04-24,3,0,70,7,0.08985833192127383,0.1,22,62
America,Guyana,779004,2020-04-25,3,1,73,8,0.09370940328932842,0.1095890410958904,23,62
America,Guyana,779004,2020-04-26,1,0,74,8,0.09499309374534663,0.10810810810810811,24,62
America,Guyana,779004,2020-04-27,0,0,74,8,0.09499309374534663,0.10810810810810811,25,62
America,Guyana,779004,2020-04-28,0,0,74,8,0.09499309374534663,0.10810810810810811,26,62
America,Guyana,779004,2020-04-29,1,0,75,8,0.09627678420136482,0.10666666666666667,27,62
America,Guyana,779004,2020-04-30,3,0,78,8,0.10012785556941942,0.10256410256410256,28,62
America,Guyana,779004,2020-05-01,4,1,82,9,0.1052626173934922,0.10975609756097561,29,62
America,Guyana,779004,2020-05-02,0,0,82,9,0.1052626173934922,0.10975609756097561,30,62
America,Guyana,779004,2020-05-03,0,0,82,9,0.1052626173934922,0.10975609756097561,31,62
America,Guyana,779004,2020-05-04,0,0,82,9,0.1052626173934922,0.10975609756097561,32,62
America,Guyana,779004,2020-05-05,10,0,92,9,0.11809952195367418,0.09782608695652174,33,62
America,Guyana,779004,2020-05-06,1,1,93,10,0.11938321240969238,0.10752688172043011,34,62
America,Guyana,779004,2020-05-07,0,0,93,10,0.11938321240969238,0.10752688172043011,35,62
America,Guyana,779004,2020-05-08,0,0,93,10,0.11938321240969238,0.10752688172043011,36,62
America,Guyana,779004,2020-05-09,1,0,94,10,0.12066690286571058,0.10638297872340426,37,62
America,Guyana,779004,2020-05-10,3,0,97,10,0.12451797423376515,0.10309278350515463,38,62
America,Guyana,779004,2020-05-11,7,0,104,10,0.13350380742589255,0.09615384615384616,39,62
America,Guyana,779004,2020-05-12,5,0,109,10,0.13992225970598354,0.09174311926605505,40,62
America,Guyana,779004,2020-05-13,4,0,113,10,0.14505702153005634,0.08849557522123894,41,62
America,Guyana,779004,2020-05-14,0,0,113,10,0.14505702153005634,0.08849557522123894,42,62
America,Guyana,779004,2020-05-15,0,0,113,10,0.14505702153005634,0.08849557522123894,43,62
America,Guyana,779004,2020-05-16,3,0,116,10,0.1489080928981109,0.08620689655172414,44,62
America,Guyana,779004,2020-05-17,1,0,117,10,0.1501917833541291,0.08547008547008547,45,62
America,Guyana,779004,2020-05-18,0,0,117,10,0.1501917833541291,0.08547008547008547,46,62
America,Guyana,779004,2020-05-19,7,0,124,10,0.1591776165462565,0.08064516129032258,47,62
America,Guyana,779004,2020-05-20,1,0,125,10,0.1604613070022747,0.08,48,62
America,Guyana,779004,2020-05-21,0,0,125,10,0.1604613070022747,0.08,49,62
America,Guyana,779004,2020-05-22,2,0,127,10,0.16302868791431108,0.07874015748031496,50,62
America,Guyana,779004,2020-05-23,0,0,127,10,0.16302868791431108,0.07874015748031496,51,62
America,Guyana,779004,2020-05-24,0,0,127,10,0.16302868791431108,0.07874015748031496,52,62
America,Guyana,779004,2020-05-25,8,0,135,10,0.1732982115624567,0.07407407407407407,53,62
America,Guyana,779004,2020-05-26,2,1,137,11,0.17586559247449307,0.08029197080291971,54,62
America,Guyana,779004,2020-05-27,2,0,139,11,0.17843297338652947,0.07913669064748201,55,62
America,Haiti,11123176,2020-05-14,15,0,234,18,0.02103715701342854,0.07692307692307693,0,63
America,Haiti,11123176,2020-05-15,39,2,273,20,0.02454334984899996,0.07326007326007326,1,63
America,Haiti,11123176,2020-05-16,37,0,310,20,0.027869737923772852,0.06451612903225806,2,63
America,Haiti,11123176,2020-05-17,48,0,358,20,0.03218505218293768,0.055865921787709494,3,63
America,Haiti,11123176,2020-05-18,98,0,456,20,0.04099548546206587,0.043859649122807015,4,63
America,Haiti,11123176,2020-05-19,77,1,533,21,0.047917968752809445,0.039399624765478425,5,63
America,Haiti,11123176,2020-05-20,63,1,596,22,0.05358181871796328,0.03691275167785235,6,63
America,Haiti,11123176,2020-05-21,0,0,596,22,0.05358181871796328,0.03691275167785235,7,63
America,Haiti,11123176,2020-05-22,138,3,734,25,0.06598834721306217,0.0340599455040872,8,63
America,Haiti,11123176,2020-05-23,78,0,812,25,0.07300073288420501,0.03078817733990148,9,63
America,Haiti,11123176,2020-05-24,53,1,865,26,0.07776555904536618,0.03005780346820809,10,63
America,Haiti,11123176,2020-05-25,93,1,958,27,0.08612648042249803,0.028183716075156576,11,63
America,Haiti,11123176,2020-05-26,105,4,1063,31,0.0955662303644211,0.02916274694261524,12,63
America,Haiti,11123176,2020-05-27,111,2,1174,33,0.10554539458873977,0.028109028960817718,13,63
America,Honduras,9587522,2020-04-02,47,4,219,14,0.02284219008832522,0.0639269406392694,0,64
America,Honduras,9587522,2020-04-03,3,1,222,15,0.023155096801863922,0.06756756756756757,1,64
America,Honduras,9587522,2020-04-04,42,0,264,15,0.027535790791405747,0.056818181818181816,2,64
America,Honduras,9587522,2020-04-05,4,7,268,22,0.027952999742790682,0.08208955223880597,3,64
America,Honduras,9587522,2020-04-06,30,0,298,22,0.031082066878177696,0.0738255033557047,4,64
America,Honduras,9587522,2020-04-07,7,0,305,22,0.031812182543101336,0.07213114754098361,5,64
America,Honduras,9587522,2020-04-08,7,0,312,22,0.03254229820802497,0.07051282051282051,6,64
America,Honduras,9587522,2020-04-09,31,1,343,23,0.03577566758125822,0.06705539358600583,7,64
America,Honduras,9587522,2020-04-10,39,0,382,23,0.039843454857261346,0.060209424083769635,8,64
America,Honduras,9587522,2020-04-11,10,1,392,24,0.04088647723572369,0.061224489795918366,9,64
America,Honduras,9587522,2020-04-12,1,1,393,25,0.04099077947356992,0.06361323155216285,10,64
America,Honduras,9587522,2020-04-13,4,0,397,25,0.04140798842495485,0.06297229219143577,11,64
America,Honduras,9587522,2020-04-14,10,1,407,26,0.04245101080341719,0.06388206388206388,12,64
America,Honduras,9587522,2020-04-15,12,5,419,31,0.043702637657572,0.07398568019093078,13,64
America,Honduras,9587522,2020-04-16,7,4,426,35,0.04443275332249563,0.08215962441314555,14,64
America,Honduras,9587522,2020-04-17,16,6,442,41,0.04610158912803537,0.09276018099547512,15,64
America,Honduras,9587522,2020-04-18,15,5,457,46,0.04766612269572888,0.10065645514223195,16,64
America,Honduras,9587522,2020-04-19,15,0,472,46,0.0492306562634224,0.09745762711864407,17,64
America,Honduras,9587522,2020-04-20,5,0,477,46,0.04975216745265357,0.09643605870020965,18,64
America,Honduras,9587522,2020-04-21,17,0,494,46,0.05152530549603954,0.0931174089068826,19,64
America,Honduras,9587522,2020-04-22,16,0,510,46,0.05319414130157928,0.09019607843137255,20,64
America,Honduras,9587522,2020-04-23,9,1,519,47,0.05413286144219538,0.0905587668593449,21,64
America,Honduras,9587522,2020-04-24,0,0,519,47,0.05413286144219538,0.0905587668593449,22,64
America,Honduras,9587522,2020-04-25,72,0,591,47,0.061642622567124224,0.07952622673434856,23,64
America,Honduras,9587522,2020-04-26,36,12,627,59,0.06539750312958865,0.09409888357256778,24,64
America,Honduras,9587522,2020-04-27,34,2,661,61,0.0689437792163606,0.09228441754916793,25,64
America,Honduras,9587522,2020-04-28,32,0,693,61,0.07228145082744009,0.08802308802308802,26,64
America,Honduras,9587522,2020-04-29,45,5,738,66,0.07697505153052062,0.08943089430894309,27,64
America,Honduras,9587522,2020-04-30,33,5,771,71,0.08041702537944632,0.09208819714656291,28,64
America,Honduras,9587522,2020-05-01,33,4,804,75,0.08385899922837203,0.09328358208955224,29,64
America,Honduras,9587522,2020-05-02,95,0,899,75,0.09376771182376427,0.08342602892102335,30,64
America,Honduras,9587522,2020-05-03,111,1,1010,76,0.10534526022469623,0.07524752475247524,31,64
America,Honduras,9587522,2020-05-04,45,6,1055,82,0.11003886092777675,0.07772511848341232,32,64
America,Honduras,9587522,2020-05-05,123,0,1178,82,0.12286803618286353,0.06960950764006792,33,64
America,Honduras,9587522,2020-05-06,92,11,1270,93,0.13246384206471704,0.07322834645669292,34,64
America,Honduras,9587522,2020-05-07,191,6,1461,99,0.15238556949334772,0.06776180698151951,35,64
America,Honduras,9587522,2020-05-08,224,6,1685,105,0.1757492707709041,0.06231454005934718,36,64
America,Honduras,9587522,2020-05-09,86,2,1771,107,0.1847192632256802,0.06041784302653868,37,64
America,Honduras,9587522,2020-05-10,59,1,1830,108,0.19087309525860802,0.05901639344262295,38,64
America,Honduras,9587522,2020-05-11,142,0,1972,108,0.20568401303277323,0.05476673427991886,39,64
America,Honduras,9587522,2020-05-12,34,8,2006,116,0.20923028911954517,0.05782652043868395,40,64
America,Honduras,9587522,2020-05-13,74,5,2080,121,0.2169486547201665,0.058173076923076925,41,64
America,Honduras,9587522,2020-05-14,175,2,2255,123,0.2352015463432574,0.05454545454545454,42,64
America,Honduras,9587522,2020-05-15,63,10,2318,133,0.24177258732757015,0.05737704918032787,43,64
America,Honduras,9587522,2020-05-16,142,1,2460,134,0.25658350510173533,0.05447154471544716,44,64
America,Honduras,9587522,2020-05-17,105,4,2565,138,0.2675352400755899,0.05380116959064327,45,64
America,Honduras,9587522,2020-05-18,81,4,2646,142,0.27598372134113486,0.05366591080876795,46,64
America,Honduras,9587522,2020-05-19,152,4,2798,146,0.2918376614937624,0.05218012866333095,47,64
America,Honduras,9587522,2020-05-20,157,1,2955,147,0.3082131128356211,0.049746192893401014,48,64
America,Honduras,9587522,2020-05-21,145,4,3100,151,0.323336937323325,0.048709677419354835,49,64
America,Honduras,9587522,2020-05-22,104,5,3204,156,0.3341843700593334,0.04868913857677903,50,64
America,Honduras,9587522,2020-05-23,273,11,3477,167,0.3626588809913552,0.04802991084268047,51,64
America,Honduras,9587522,2020-05-24,266,7,3743,174,0.39040327625845345,0.046486775313919315,52,64
America,Honduras,9587522,2020-05-25,207,6,3950,180,0.41199383949262386,0.04556962025316456,53,64
America,Honduras,9587522,2020-05-26,239,2,4189,182,0.4369220743378738,0.043447123418476966,54,64
America,Honduras,9587522,2020-05-27,212,6,4401,188,0.4590341487612753,0.04271756418995683,55,64
Europe,Hungary,9768785,2020-03-25,39,2,226,10,0.023134913912016695,0.04424778761061947,0,65
Europe,Hungary,9768785,2020-03-26,35,0,261,10,0.026717754562107777,0.038314176245210725,1,65
Europe,Hungary,9768785,2020-03-27,39,0,300,10,0.030710062715066405,0.03333333333333333,2,65
Europe,Hungary,9768785,2020-03-28,43,1,343,11,0.035111838370892594,0.03206997084548105,3,65
Europe,Hungary,9768785,2020-03-29,65,2,408,13,0.041765685292490314,0.031862745098039214,4,65
Europe,Hungary,9768785,2020-03-30,39,2,447,15,0.045757993445448945,0.03355704697986577,5,65
Europe,Hungary,9768785,2020-03-31,45,1,492,16,0.05036450285270891,0.032520325203252036,6,65
Europe,Hungary,9768785,2020-04-01,33,4,525,20,0.053742609751366216,0.0380952380952381,7,65
Europe,Hungary,9768785,2020-04-02,60,1,585,21,0.0598846222943795,0.035897435897435895,8,65
Europe,Hungary,9768785,2020-04-03,38,5,623,26,0.06377456357162124,0.04173354735152488,9,65
Europe,Hungary,9768785,2020-04-04,55,6,678,32,0.06940474173605007,0.0471976401179941,10,65
Europe,Hungary,9768785,2020-04-05,55,2,733,34,0.07503491990047892,0.04638472032742155,11,65
Europe,Hungary,9768785,2020-04-06,11,4,744,38,0.07616095553336469,0.051075268817204304,12,65
Europe,Hungary,9768785,2020-04-07,73,9,817,47,0.08363373746069752,0.05752753977968176,13,65
Europe,Hungary,9768785,2020-04-08,78,11,895,58,0.09161835376661479,0.06480446927374302,14,65
Europe,Hungary,9768785,2020-04-09,85,8,980,66,0.10031953820255027,0.0673469387755102,15,65
Europe,Hungary,9768785,2020-04-10,210,11,1190,77,0.12181658210309675,0.06470588235294118,16,65
Europe,Hungary,9768785,2020-04-11,120,8,1310,85,0.1341006071891233,0.0648854961832061,17,65
Europe,Hungary,9768785,2020-04-12,100,14,1410,99,0.1443372947608121,0.07021276595744681,18,65
Europe,Hungary,9768785,2020-04-13,48,10,1458,109,0.14925090479522274,0.0747599451303155,19,65
Europe,Hungary,9768785,2020-04-14,54,13,1512,122,0.1547787160839347,0.08068783068783068,20,65
Europe,Hungary,9768785,2020-04-15,67,12,1579,134,0.1616372967569662,0.08486383787207093,21,65
Europe,Hungary,9768785,2020-04-16,73,8,1652,142,0.16911007868429903,0.08595641646489104,22,65
Europe,Hungary,9768785,2020-04-17,111,14,1763,156,0.1804728018888736,0.08848553601815087,23,65
Europe,Hungary,9768785,2020-04-18,71,16,1834,172,0.18774085006477262,0.09378407851690294,24,65
Europe,Hungary,9768785,2020-04-19,82,17,1916,189,0.19613493387355746,0.09864300626304802,25,65
Europe,Hungary,9768785,2020-04-20,68,10,1984,199,0.20309588142230584,0.1003024193548387,26,65
Europe,Hungary,9768785,2020-04-21,114,14,2098,213,0.21476570525403108,0.10152526215443279,27,65
Europe,Hungary,9768785,2020-04-22,70,12,2168,225,0.22193138655421327,0.10378228782287822,28,65
Europe,Hungary,9768785,2020-04-23,116,0,2284,225,0.23380594413737224,0.09851138353765324,29,65
Europe,Hungary,9768785,2020-04-24,99,25,2383,250,0.24394026483334416,0.1049097775912715,30,65
Europe,Hungary,9768785,2020-04-25,60,12,2443,262,0.25008227737635746,0.10724519033974621,31,65
Europe,Hungary,9768785,2020-04-26,57,10,2500,272,0.25591718929222007,0.1088,32,65
Europe,Hungary,9768785,2020-04-27,83,8,2583,280,0.26441363997672174,0.10840108401084012,33,65
Europe,Hungary,9768785,2020-04-28,66,11,2649,291,0.27116985377403635,0.10985277463193659,34,65
Europe,Hungary,9768785,2020-04-29,78,9,2727,300,0.27915447007995364,0.11001100110011001,35,65
Europe,Hungary,9768785,2020-04-30,48,12,2775,312,0.28406808011436424,0.11243243243243244,36,65
Europe,Hungary,9768785,2020-05-01,88,11,2863,323,0.29307636517745045,0.11281872162067762,37,65
Europe,Hungary,9768785,2020-05-02,79,12,2942,335,0.3011633483590846,0.11386811692726037,38,65
Europe,Hungary,9768785,2020-05-03,56,5,2998,340,0.3068958933992303,0.1134089392928619,39,65
Europe,Hungary,9768785,2020-05-04,37,11,3035,351,0.3106834678007552,0.1156507413509061,40,65
Europe,Hungary,9768785,2020-05-05,30,12,3065,363,0.3137544740722618,0.11843393148450244,41,65
Europe,Hungary,9768785,2020-05-06,46,10,3111,373,0.31846335035523865,0.11989713918354226,42,65
Europe,Hungary,9768785,2020-05-07,39,10,3150,383,0.3224556585081973,0.12158730158730159,43,65
Europe,Hungary,9768785,2020-05-08,28,9,3178,392,0.3253219310282702,0.12334801762114538,44,65
Europe,Hungary,9768785,2020-05-09,35,13,3213,405,0.32890477167836124,0.12605042016806722,45,65
Europe,Hungary,9768785,2020-05-10,50,8,3263,413,0.3340231154642056,0.12657064051486364,46,65
Europe,Hungary,9768785,2020-05-11,21,8,3284,421,0.33617281985426023,0.1281973203410475,47,65
Europe,Hungary,9768785,2020-05-12,29,4,3313,425,0.33914145925005,0.12828252339269544,48,65
Europe,Hungary,9768785,2020-05-13,28,5,3341,430,0.3420077317701229,0.12870398084405865,49,65
Europe,Hungary,9768785,2020-05-14,39,6,3380,436,0.3460000399230815,0.1289940828402367,50,65
Europe,Hungary,9768785,2020-05-15,37,6,3417,442,0.34978761432460637,0.12935323383084577,51,65
Europe,Hungary,9768785,2020-05-16,56,6,3473,448,0.3555201593647521,0.1289951050964584,52,65
Europe,Hungary,9768785,2020-05-17,36,3,3509,451,0.35920536689056004,0.12852664576802508,53,65
Europe,Hungary,9768785,2020-05-18,26,11,3535,462,0.3618669056591992,0.1306930693069307,54,65
Europe,Hungary,9768785,2020-05-19,21,5,3556,467,0.36401661004925384,0.1313273340832396,55,65
Europe,Hungary,9768785,2020-05-20,42,3,3598,470,0.36831601882936316,0.13062812673707616,56,65
Europe,Hungary,9768785,2020-05-21,43,3,3641,473,0.37271779448518927,0.1299093655589124,57,65
Europe,Hungary,9768785,2020-05-22,37,3,3678,476,0.37650536888671415,0.12941816204458945,58,65
Europe,Hungary,9768785,2020-05-23,35,6,3713,482,0.3800882095368052,0.12981416644223,59,65
Europe,Hungary,9768785,2020-05-24,28,4,3741,486,0.3829544820568781,0.12991178829190056,60,65
Europe,Hungary,9768785,2020-05-25,15,5,3756,491,0.38448998519263144,0.1307241746538871,61,65
Europe,Hungary,9768785,2020-05-26,15,8,3771,499,0.38602548832838474,0.13232564306549988,62,65
Europe,Hungary,9768785,2020-05-27,22,6,3793,505,0.3882775595941563,0.13313999472712892,63,65
Asia,India,1352617328,2020-04-27,1396,48,27892,872,0.020620762001653137,0.03126344471533056,0,67
Asia,India,1352617328,2020-04-28,1543,62,29435,934,0.021761513319900335,0.03173093256327501,1,67
Asia,India,1352617328,2020-04-29,1897,73,31332,1007,0.02316397945775836,0.032139665517681604,2,67
Asia,India,1352617328,2020-04-30,1718,67,33050,1074,0.024434109571010908,0.03249621785173979,3,67
Asia,India,1352617328,2020-05-01,1993,73,35043,1147,0.02590754921927187,0.032731215934708784,4,67
Asia,India,1352617328,2020-05-02,2293,71,37336,1218,0.027602781087542005,0.032622669809299336,5,67
Asia,India,1352617328,2020-05-03,2644,83,39980,1301,0.029557509853222877,0.03254127063531766,6,67
Asia,India,1352617328,2020-05-04,2553,72,42533,1373,0.031444961645500966,0.032280817247784074,7,67
Asia,India,1352617328,2020-05-05,3900,195,46433,1568,0.03432826050562025,0.033769086640966554,8,67
Asia,India,1352617328,2020-05-06,2958,126,49391,1694,0.036515131794910734,0.034297746553015734,9,67
Asia,India,1352617328,2020-05-07,3561,89,52952,1783,0.03914780544641965,0.03367200483456716,10,67
Asia,India,1352617328,2020-05-08,3390,103,56342,1886,0.041654057532523346,0.033474140073124846,11,67
Asia,India,1352617328,2020-05-09,3320,95,59662,1981,0.044108558100624896,0.033203714256980994,12,67
Asia,India,1352617328,2020-05-10,3277,128,62939,2109,0.046531268450525125,0.033508635345334374,13,67
Asia,India,1352617328,2020-05-11,4213,97,67152,2206,0.049645970526853996,0.032850845842268286,14,67
Asia,India,1352617328,2020-05-12,3604,87,70756,2293,0.05231043439656423,0.03240714568375827,15,67
Asia,India,1352617328,2020-05-13,3525,122,74281,2415,0.054916492981672047,0.03251167862575894,16,67
Asia,India,1352617328,2020-05-14,3722,134,78003,2549,0.057668195124585896,0.0326782303244747,17,67
Asia,India,1352617328,2020-05-15,3967,100,81970,2649,0.060601027580507234,0.03231670123215811,18,67
Asia,India,1352617328,2020-05-16,3970,103,85940,2752,0.06353607795862867,0.032022341168256925,19,67
Asia,India,1352617328,2020-05-17,4987,120,90927,2872,0.0672230039625812,0.03158577760181244,20,67
Asia,India,1352617328,2020-05-18,5242,157,96169,3029,0.07109845335354155,0.03149663613014589,21,67
Asia,India,1352617328,2020-05-19,4970,134,101139,3163,0.07477281113169355,0.03127379151464816,22,67
Asia,India,1352617328,2020-05-20,5611,140,106750,3303,0.07892106495326519,0.030941451990632318,23,67
Asia,India,1352617328,2020-05-21,5609,132,112359,3435,0.08306784016003675,0.030571649801084025,24,67
Asia,India,1352617328,2020-05-22,6088,148,118447,3583,0.08756874361142297,0.030249816373567925,25,67
Asia,India,1352617328,2020-05-23,6654,137,125101,3720,0.09248809505122649,0.029735973333546495,26,67
Asia,India,1352617328,2020-05-24,6767,147,131868,3867,0.09749098822723347,0.029324779324779324,27,67
Asia,India,1352617328,2020-05-25,6977,154,138845,4021,0.10264913595724688,0.028960351471064856,28,67
Asia,India,1352617328,2020-05-26,6535,146,145380,4167,0.10748050981644677,0.02866281469252992,29,67
Asia,India,1352617328,2020-05-27,6387,170,151767,4337,0.11220246618044213,0.02857669980957652,30,67
Asia,Indonesia,267663435,2020-04-17,380,27,5516,496,0.02060796985587516,0.08992023205221175,0,68
Asia,Indonesia,267663435,2020-04-18,407,24,5923,520,0.022128536159599088,0.08779334796555799,1,68
Asia,Indonesia,267663435,2020-04-19,325,15,6248,535,0.02334274758149166,0.08562740076824583,2,68
Asia,Indonesia,267663435,2020-04-20,327,47,6575,582,0.0245644310736728,0.0885171102661597,3,68
Asia,Indonesia,267663435,2020-04-21,185,8,6760,590,0.025255597575365496,0.08727810650887574,4,68
Asia,Indonesia,267663435,2020-04-22,375,26,7135,616,0.026656610754472308,0.08633496846531184,5,68
Asia,Indonesia,267663435,2020-04-23,283,19,7418,635,0.027713908700304917,0.08560258829873281,6,68
Asia,Indonesia,267663435,2020-04-24,357,12,7775,647,0.029047673246814606,0.08321543408360128,7,68
Asia,Indonesia,267663435,2020-04-25,436,42,8211,689,0.030676584569722797,0.08391182559980515,8,68
Asia,Indonesia,267663435,2020-04-26,396,31,8607,720,0.03215605448685959,0.08365284071104914,9,68
Asia,Indonesia,267663435,2020-04-27,275,23,8882,743,0.033183464151537924,0.08365233055618104,10,68
Asia,Indonesia,267663435,2020-04-28,214,22,9096,765,0.03398297567241488,0.08410290237467019,11,68
Asia,Indonesia,267663435,2020-04-29,415,8,9511,773,0.03553343025729309,0.0812743139522658,12,68
Asia,Indonesia,267663435,2020-04-30,260,11,9771,784,0.03650479939480714,0.0802374373145021,13,68
Asia,Indonesia,267663435,2020-05-01,347,8,10118,792,0.037801203589873975,0.07827633919746986,14,68
Asia,Indonesia,267663435,2020-05-02,433,8,10551,800,0.03941890680734931,0.07582219694815658,15,68
Asia,Indonesia,267663435,2020-05-03,292,31,10843,831,0.04050982906948048,0.07663930646500046,16,68
Asia,Indonesia,267663435,2020-05-04,349,14,11192,845,0.041813705334835895,0.07550035739814152,17,68
Asia,Indonesia,267663435,2020-05-05,395,19,11587,864,0.0432894392168284,0.07456632432898938,18,68
Asia,Indonesia,267663435,2020-05-06,484,8,12071,872,0.04509768022666226,0.07223925109767211,19,68
Asia,Indonesia,267663435,2020-05-07,367,23,12438,895,0.0464688051246148,0.07195690625502492,20,68
Asia,Indonesia,267663435,2020-05-08,338,35,12776,930,0.04773158500338307,0.07279273638071383,21,68
Asia,Indonesia,267663435,2020-05-09,336,13,13112,943,0.048986892811862776,0.07191885295912141,22,68
Asia,Indonesia,267663435,2020-05-10,533,16,13645,959,0.050978199543766596,0.07028215463539758,23,68
Asia,Indonesia,267663435,2020-05-11,387,14,14032,973,0.05242404514460483,0.06934150513112884,24,68
Asia,Indonesia,267663435,2020-05-12,233,18,14265,991,0.0532945413332232,0.06947073256221521,25,68
Asia,Indonesia,267663435,2020-05-13,484,16,14749,1007,0.05510278234305706,0.0682758153095125,26,68
Asia,Indonesia,267663435,2020-05-14,689,21,15438,1028,0.05767691055746931,0.06658893639072419,27,68
Asia,Indonesia,267663435,2020-05-15,568,15,16006,1043,0.0597989785194231,0.06516306385105586,28,68
Asia,Indonesia,267663435,2020-05-16,490,33,16496,1076,0.061629635740122674,0.06522793404461688,29,68
Asia,Indonesia,267663435,2020-05-17,529,13,17025,1089,0.06360599833144934,0.0639647577092511,30,68
Asia,Indonesia,267663435,2020-05-18,489,59,17514,1148,0.06543291951700463,0.06554756195043965,31,68
Asia,Indonesia,267663435,2020-05-19,496,43,18010,1191,0.06728599294856992,0.06612992781787895,32,68
Asia,Indonesia,267663435,2020-05-20,486,30,18496,1221,0.06910170602869234,0.06601427335640138,33,68
Asia,Indonesia,267663435,2020-05-21,693,21,19189,1242,0.07169077838368172,0.06472458179165147,34,68
Asia,Indonesia,267663435,2020-05-22,973,36,20162,1278,0.07532594057907087,0.0633865687927785,35,68
Asia,Indonesia,267663435,2020-05-23,634,48,20796,1326,0.07769458686054746,0.06376226197345643,36,68
Asia,Indonesia,267663435,2020-05-24,949,25,21745,1351,0.08124008421247378,0.06212922510922051,37,68
Asia,Indonesia,267663435,2020-05-25,526,21,22271,1372,0.08320523869836759,0.06160477751335818,38,68
Asia,Indonesia,267663435,2020-05-26,479,19,22750,1391,0.08499479953248004,0.061142857142857145,39,68
Asia,Indonesia,267663435,2020-05-27,415,27,23165,1418,0.08654525411735824,0.06121303690913015,40,68
Asia,Iran,81800269,2020-03-04,835,11,2336,77,0.028557363301580343,0.03296232876712329,0,69
Asia,Iran,81800269,2020-03-05,586,15,2922,92,0.035721153924322666,0.03148528405201916,1,69
Asia,Iran,81800269,2020-03-06,591,15,3513,107,0.042946069040433105,0.03045829775120979,2,69
Asia,Iran,81800269,2020-03-07,1234,17,4747,124,0.05803159400368231,0.02612176111228144,3,69
Asia,Iran,81800269,2020-03-08,1076,21,5823,145,0.07118558497649928,0.024901253649321657,4,69
Asia,Iran,81800269,2020-03-09,743,49,6566,194,0.08026868469100022,0.02954614681693573,5,69
Asia,Iran,81800269,2020-03-10,595,43,7161,237,0.08754249940180514,0.03309593632174277,6,69
Asia,Iran,81800269,2020-03-11,881,54,8042,291,0.09831263513326588,0.03618502859985078,7,69
Asia,Iran,81800269,2020-03-12,958,63,9000,354,0.11002408806259549,0.03933333333333333,8,69
Asia,Iran,81800269,2020-03-13,1075,75,10075,429,0.12316585413673885,0.04258064516129032,9,69
Asia,Iran,81800269,2020-03-14,1289,85,11364,514,0.13892374852703726,0.04523055262231609,10,69
Asia,Iran,81800269,2020-03-15,1365,97,12729,611,0.1556107352165309,0.048000628486134025,11,69
Asia,Iran,81800269,2020-03-16,1209,113,13938,724,0.17039063771293955,0.05194432486726933,12,69
Asia,Iran,81800269,2020-03-17,1053,129,14991,853,0.1832634560162632,0.056900807150957244,13,69
Asia,Iran,81800269,2020-03-18,1178,135,16169,988,0.1976643866537896,0.06110458284371328,14,69
Asia,Iran,81800269,2020-03-19,1192,147,17361,1135,0.2122364658727467,0.06537641840907782,15,69
Asia,Iran,81800269,2020-03-20,1046,149,18407,1284,0.225023709885355,0.06975607105992286,16,69
Asia,Iran,81800269,2020-03-21,1237,149,19644,1433,0.24014590954462509,0.07294848299735288,17,69
Asia,Iran,81800269,2020-03-22,966,123,20610,1556,0.2519551616633437,0.0754973313925279,18,69
Asia,Iran,81800269,2020-03-23,1028,129,21638,1685,0.2645223574998268,0.0778722617617155,19,69
Asia,Iran,81800269,2020-03-24,1411,127,23049,1812,0.28177168952830706,0.07861512430040349,20,69
Asia,Iran,81800269,2020-03-25,1762,122,24811,1934,0.3033119609912285,0.0779492966829229,21,69
Asia,Iran,81800269,2020-03-26,2206,143,27017,2077,0.330280087465238,0.07687752156049894,22,69
Asia,Iran,81800269,2020-03-27,2389,157,29406,2234,0.35948537039652034,0.07597089029449772,23,69
Asia,Iran,81800269,2020-03-28,2926,144,32332,2378,0.39525542391553753,0.0735494247185451,24,69
Asia,Iran,81800269,2020-03-29,3076,139,35408,2517,0.4328592122355979,0.07108563036601898,25,69
Asia,Iran,81800269,2020-03-30,2901,123,38309,2640,0.46832364328777454,0.06891331018820643,26,69
Asia,Iran,81800269,2020-03-31,3186,117,41495,2757,0.5072721704619333,0.06644173996867092,27,69
Asia,Iran,81800269,2020-04-01,3111,141,44606,2898,0.5453038302355705,0.06496883827287808,28,69
Asia,Iran,81800269,2020-04-02,2987,138,47593,3036,0.5818196025736786,0.06379089361880949,29,69
Asia,Iran,81800269,2020-04-03,2875,124,50468,3160,0.616966186260341,0.06261393358167552,30,69
Asia,Iran,81800269,2020-04-04,0,0,50468,3160,0.616966186260341,0.06261393358167552,31,69
Asia,Iran,81800269,2020-04-05,5275,292,55743,3452,0.6814525267636956,0.061927058105950526,32,69
Asia,Iran,81800269,2020-04-06,2483,151,58226,3603,0.7118069501702984,0.061879572699481335,33,69
Asia,Iran,81800269,2020-04-07,2274,136,60500,3739,0.7396063697541141,0.06180165289256198,34,69
Asia,Iran,81800269,2020-04-08,2089,133,62589,3872,0.76514418308331,0.061863905798143444,35,69
Asia,Iran,81800269,2020-04-09,1997,121,64586,3993,0.7895573057345325,0.06182454401882761,36,69
Asia,Iran,81800269,2020-04-10,1634,117,66220,4110,0.8095327901672303,0.062065841135608577,37,69
Asia,Iran,81800269,2020-04-11,1972,122,68192,4232,0.8336402903516124,0.06206006569685594,38,69
Asia,Iran,81800269,2020-04-12,1837,125,70029,4357,0.8560974292150555,0.06221708149480929,39,69
Asia,Iran,81800269,2020-04-13,1657,117,71686,4474,0.8763540863172468,0.06241107050191111,40,69
Asia,Iran,81800269,2020-04-14,1617,111,73303,4585,0.8961217474724931,0.06254859964803623,41,69
Asia,Iran,81800269,2020-04-15,1574,98,74877,4683,0.9153637379847737,0.06254256981449577,42,69
Asia,Iran,81800269,2020-04-16,1512,94,76389,4777,0.9338477847792896,0.06253518176700834,43,69
Asia,Iran,81800269,2020-04-17,1606,92,77995,4869,0.9534809720491261,0.06242707865888839,44,69
Asia,Iran,81800269,2020-04-18,1499,89,79494,4958,0.9718060951608851,0.062369487005308574,45,69
Asia,Iran,81800269,2020-04-19,1374,73,80868,5031,0.9886031059384414,0.062212494435376166,46,69
Asia,Iran,81800269,2020-04-20,1343,87,82211,5118,1.0050211448571154,0.06225444283611682,47,69
Asia,Iran,81800269,2020-04-21,1294,91,83505,5209,1.0208401637407818,0.062379498233638704,48,69
Asia,Iran,81800269,2020-04-22,1297,88,84802,5297,1.0366958573204692,0.06246314945402231,49,69
Asia,Iran,81800269,2020-04-23,1194,94,85996,5391,1.0512923863367734,0.06268896227731523,50,69
Asia,Iran,81800269,2020-04-24,1030,90,87026,5481,1.0638840319706038,0.06298117803874705,51,69
Asia,Iran,81800269,2020-04-25,1168,93,88194,5574,1.078162713621394,0.0632015783386625,52,69
Asia,Iran,81800269,2020-04-26,1134,76,89328,5650,1.092025748717281,0.06325004477879276,53,69
Asia,Iran,81800269,2020-04-27,1153,60,90481,5710,1.1061210568879671,0.06310717167140062,54,69
Asia,Iran,81800269,2020-04-28,991,96,91472,5806,1.1182359314735262,0.06347297533671506,55,69
Asia,Iran,81800269,2020-04-29,1112,71,92584,5877,1.1318300187985935,0.063477490711138,56,69
Asia,Iran,81800269,2020-04-30,1073,80,93657,5957,1.1449473350753896,0.06360442892682874,57,69
Asia,Iran,81800269,2020-05-01,983,71,94640,6028,1.1569644104715597,0.06369399830938292,58,69
Asia,Iran,81800269,2020-05-02,1006,63,95646,6091,1.1692626585372232,0.06368274679547498,59,69
Asia,Iran,81800269,2020-05-03,802,65,96448,6156,1.1790670272734678,0.0638271400132714,60,69
Asia,Iran,81800269,2020-05-04,976,47,97424,6203,1.1909985283789226,0.06367014288060437,61,69
Asia,Iran,81800269,2020-05-05,1223,74,98647,6277,1.2059495794567618,0.06363092643466096,62,69
Asia,Iran,81800269,2020-05-06,1323,63,99970,6340,1.2221231204019634,0.06341902570771231,63,69
Asia,Iran,81800269,2020-05-07,1680,78,101650,6418,1.2426609501736479,0.06313821938022626,64,69
Asia,Iran,81800269,2020-05-08,1485,68,103135,6486,1.2608149247039762,0.06288844718087944,65,69
Asia,Iran,81800269,2020-05-09,1556,55,104691,6541,1.2798368670401317,0.06247910517618516,66,69
Asia,Iran,81800269,2020-05-10,1529,48,106220,6589,1.2985287371120993,0.062031632460930144,67,69
Asia,Iran,81800269,2020-05-11,1383,51,107603,6640,1.315435771977718,0.061708316682620376,68,69
Asia,Iran,81800269,2020-05-12,1683,45,109286,6685,1.3360102764454236,0.06116977471954322,69,69
Asia,Iran,81800269,2020-05-13,1481,48,110767,6733,1.354115351381057,0.060785251925212384,70,69
Asia,Iran,81800269,2020-05-14,1958,50,112725,6783,1.3780517029840087,0.0601729873586161,71,69
Asia,Iran,81800269,2020-05-15,1808,71,114533,6854,1.4001543197859165,0.059843014676992656,72,69
Asia,Iran,81800269,2020-05-16,2102,48,116635,6902,1.4258510567978695,0.05917606207399151,73,69
Asia,Iran,81800269,2020-05-17,1757,35,118392,6937,1.4473302037674227,0.05859348604635448,74,69
Asia,Iran,81800269,2020-05-18,1806,51,120198,6988,1.4694083707719836,0.05813740661242284,75,69
Asia,Iran,81800269,2020-05-19,2294,69,122492,7057,1.497452288329272,0.05761192567677889,76,69
Asia,Iran,81800269,2020-05-20,2111,62,124603,7119,1.5232590494292875,0.057133455855798015,77,69
Asia,Iran,81800269,2020-05-21,2346,64,126949,7183,1.551938661717604,0.05658177693404438,78,69
Asia,Iran,81800269,2020-05-22,2392,66,129341,7249,1.5811806193449072,0.056045646778670334,79,69
Asia,Iran,81800269,2020-05-23,2311,51,131652,7300,1.6094323601796467,0.05544921459605627,80,69
Asia,Iran,81800269,2020-05-24,1869,59,133521,7359,1.632280695800646,0.05511492574201811,81,69
Asia,Iran,81800269,2020-05-25,2180,58,135701,7417,1.6589309749091412,0.05465692957310558,82,69
Asia,Iran,81800269,2020-05-26,2023,34,137724,7451,1.6836619449258778,0.05410095553425692,83,69
Asia,Iran,81800269,2020-05-27,1787,57,139511,7508,1.70550783885564,0.05381654493194085,84,69
Asia,Iraq,38433600,2020-04-03,78,4,772,54,0.02008659089962949,0.06994818652849741,0,70
Asia,Iraq,38433600,2020-04-04,0,0,772,54,0.02008659089962949,0.06994818652849741,1,70
Asia,Iraq,38433600,2020-04-05,106,2,878,56,0.022844594313309187,0.06378132118451026,2,70
Asia,Iraq,38433600,2020-04-06,83,5,961,61,0.025004163024020646,0.06347554630593132,3,70
Asia,Iraq,38433600,2020-04-07,70,3,1031,64,0.026825486033054412,0.06207565470417071,4,70
Asia,Iraq,38433600,2020-04-08,0,0,1031,64,0.026825486033054412,0.06207565470417071,5,70
Asia,Iraq,38433600,2020-04-09,171,5,1202,69,0.0312747179551226,0.05740432612312812,6,70
Asia,Iraq,38433600,2020-04-10,30,0,1232,69,0.03205528495899421,0.056006493506493504,7,70
Asia,Iraq,38433600,2020-04-11,47,1,1279,70,0.03327817326505974,0.054730258014073496,8,70
Asia,Iraq,38433600,2020-04-12,39,2,1318,72,0.034292910370092834,0.054628224582701064,9,70
Asia,Iraq,38433600,2020-04-13,34,4,1352,76,0.035177552974480664,0.05621301775147929,10,70
Asia,Iraq,38433600,2020-04-14,26,2,1378,78,0.03585404437783606,0.05660377358490566,11,70
Asia,Iraq,38433600,2020-04-15,22,0,1400,78,0.036426460180675246,0.055714285714285716,12,70
Asia,Iraq,38433600,2020-04-16,15,1,1415,79,0.03681674368261104,0.0558303886925795,13,70
Asia,Iraq,38433600,2020-04-17,19,1,1434,80,0.03731110278506307,0.05578800557880056,14,70
Asia,Iraq,38433600,2020-04-18,48,1,1482,81,0.03856000999125765,0.05465587044534413,15,70
Asia,Iraq,38433600,2020-04-19,0,0,1482,81,0.03856000999125765,0.05465587044534413,16,70
Asia,Iraq,38433600,2020-04-20,57,1,1539,82,0.040043087298613715,0.05328135152696556,17,70
Asia,Iraq,38433600,2020-04-21,35,0,1574,82,0.04095374880313059,0.052096569250317665,18,70
Asia,Iraq,38433600,2020-04-22,28,1,1602,83,0.0416822780067441,0.05181023720349563,19,70
Asia,Iraq,38433600,2020-04-23,0,0,1602,83,0.0416822780067441,0.05181023720349563,20,70
Asia,Iraq,38433600,2020-04-24,75,0,1677,83,0.04363369551642313,0.04949314251639833,21,70
Asia,Iraq,38433600,2020-04-25,31,3,1708,86,0.0444402814204238,0.05035128805620609,22,70
Asia,Iraq,38433600,2020-04-26,55,0,1763,86,0.04587132092752175,0.04878048780487805,23,70
Asia,Iraq,38433600,2020-04-27,57,1,1820,87,0.04735439823487782,0.0478021978021978,24,70
Asia,Iraq,38433600,2020-04-28,27,1,1847,88,0.04805690853836227,0.047644829453167295,25,70
Asia,Iraq,38433600,2020-04-29,0,0,1847,88,0.04805690853836227,0.047644829453167295,26,70
Asia,Iraq,38433600,2020-04-30,156,4,2003,92,0.05211585695849465,0.04593110334498253,27,70
Asia,Iraq,38433600,2020-05-01,82,1,2085,93,0.05424940676907705,0.04460431654676259,28,70
Asia,Iraq,38433600,2020-05-02,68,1,2153,94,0.05601869197785272,0.04366000928936368,29,70
Asia,Iraq,38433600,2020-05-03,66,1,2219,95,0.05773593938637026,0.04281207751239297,30,70
Asia,Iraq,38433600,2020-05-04,77,2,2296,97,0.059739394696307395,0.04224738675958188,31,70
Asia,Iraq,38433600,2020-05-05,50,1,2346,98,0.061040339702760085,0.041773231031543054,32,70
Asia,Iraq,38433600,2020-05-06,85,4,2431,102,0.06325194621372965,0.04195804195804196,33,70
Asia,Iraq,38433600,2020-05-07,49,0,2480,102,0.06452687232005327,0.04112903225806452,34,70
Asia,Iraq,38433600,2020-05-08,63,0,2543,102,0.06616606302818367,0.04011010617381046,35,70
Asia,Iraq,38433600,2020-05-09,60,2,2603,104,0.06772719703592689,0.039953899346907414,36,70
Asia,Iraq,38433600,2020-05-10,76,3,2679,107,0.06970463344573499,0.03994027622247107,37,70
Asia,Iraq,38433600,2020-05-11,88,2,2767,109,0.07199429665709171,0.03939284423563426,38,70
Asia,Iraq,38433600,2020-05-12,51,1,2818,110,0.07332126056367344,0.03903477643718949,39,70
Asia,Iraq,38433600,2020-05-13,95,2,2913,112,0.07579305607593355,0.03844833504977686,40,70
Asia,Iraq,38433600,2020-05-14,119,3,3032,115,0.07888930519129095,0.0379287598944591,41,70
Asia,Iraq,38433600,2020-05-15,111,0,3143,115,0.08177740310561592,0.03658924594336621,42,70
Asia,Iraq,38433600,2020-05-16,50,2,3193,117,0.08307834811206861,0.036642655809583466,43,70
Asia,Iraq,38433600,2020-05-17,67,4,3260,121,0.08482161442071522,0.037116564417177915,44,70
Asia,Iraq,38433600,2020-05-18,144,2,3404,123,0.08856833603929895,0.036133960047003526,45,70
Asia,Iraq,38433600,2020-05-19,150,4,3554,127,0.092471171058657,0.0357343837929094,46,70
Asia,Iraq,38433600,2020-05-20,57,4,3611,131,0.09395424836601307,0.0362780393242869,47,70
Asia,Iraq,38433600,2020-05-21,113,3,3724,134,0.09689438408059614,0.0359828141783029,48,70
Asia,Iraq,38433600,2020-05-22,153,6,3877,140,0.10087527580034138,0.036110394635027084,49,70
Asia,Iraq,38433600,2020-05-23,87,7,3964,147,0.10313892011156905,0.03708375378405651,50,70
Asia,Iraq,38433600,2020-05-24,308,5,4272,152,0.1111527413513176,0.035580524344569285,51,70
Asia,Iraq,38433600,2020-05-25,197,8,4469,160,0.11627846467674119,0.03580219288431417,52,70
Asia,Iraq,38433600,2020-05-26,163,3,4632,163,0.12051954539777696,0.035189982728842835,53,70
Asia,Iraq,38433600,2020-05-27,216,6,4848,169,0.12613962782565255,0.03485973597359736,54,70
Europe,Ireland,4853506,2020-03-15,38,1,129,2,0.026578724740424758,0.015503875968992248,0,71
Europe,Ireland,4853506,2020-03-16,40,0,169,2,0.03482018977621538,0.011834319526627219,1,71
Europe,Ireland,4853506,2020-03-17,54,0,223,2,0.045946167574532716,0.008968609865470852,2,71
Europe,Ireland,4853506,2020-03-18,69,0,292,2,0.06016269476127154,0.00684931506849315,3,71
Europe,Ireland,4853506,2020-03-19,74,0,366,2,0.0754094050774842,0.00546448087431694,4,71
Europe,Ireland,4853506,2020-03-20,191,1,557,3,0.11476240062338441,0.005385996409335727,5,71
Europe,Ireland,4853506,2020-03-21,126,0,683,3,0.14072301548612487,0.004392386530014641,6,71
Europe,Ireland,4853506,2020-03-22,102,0,785,3,0.16173875132739096,0.003821656050955414,7,71
Europe,Ireland,4853506,2020-03-23,121,1,906,4,0.1866691830606576,0.004415011037527594,8,71
Europe,Ireland,4853506,2020-03-24,219,2,1125,6,0.23179120413161125,0.005333333333333333,9,71
Europe,Ireland,4853506,2020-03-25,204,1,1329,7,0.27382267581414343,0.005267118133935289,10,71
Europe,Ireland,4853506,2020-03-26,235,2,1564,9,0.32224128289941334,0.005754475703324808,11,71
Europe,Ireland,4853506,2020-03-27,255,10,1819,19,0.37478062250257854,0.010445299615173173,12,71
Europe,Ireland,4853506,2020-03-28,302,3,2121,22,0.4370036835227978,0.010372465818010372,13,71
Europe,Ireland,4853506,2020-03-29,294,14,2415,36,0.4975784515358589,0.014906832298136646,14,71
Europe,Ireland,4853506,2020-03-30,200,10,2615,46,0.5387857767148119,0.017590822179732315,15,71
Europe,Ireland,4853506,2020-03-31,295,8,2910,54,0.5995665813537678,0.018556701030927835,16,71
Europe,Ireland,4853506,2020-04-01,325,17,3235,71,0.6665284847695666,0.02194744976816074,17,71
Europe,Ireland,4853506,2020-04-02,212,14,3447,85,0.7102082494592569,0.02465912387583406,18,71
Europe,Ireland,4853506,2020-04-03,402,13,3849,98,0.7930349730689527,0.025461158742530528,19,71
Europe,Ireland,4853506,2020-04-04,424,22,4273,120,0.8803945024483332,0.02808331383103206,20,71
Europe,Ireland,4853506,2020-04-05,331,17,4604,137,0.9485926256195006,0.029756733275412686,21,71
Europe,Ireland,4853506,2020-04-06,507,21,5111,158,1.0530531949481468,0.030913715515554687,22,71
Europe,Ireland,4853506,2020-04-07,253,16,5364,174,1.1051804612995226,0.03243847874720358,23,71
Europe,Ireland,4853506,2020-04-08,345,36,5709,210,1.1762630972332166,0.03678402522333158,24,71
Europe,Ireland,4853506,2020-04-09,515,25,6224,235,1.2823719595690208,0.03775706940874036,25,71
Europe,Ireland,4853506,2020-04-10,1169,28,7393,263,1.5232287752400018,0.035574191803056945,26,71
Europe,Ireland,4853506,2020-04-11,696,24,8089,287,1.6666302668627586,0.0354802818642601,27,71
Europe,Ireland,4853506,2020-04-12,839,33,8928,320,1.839494995988467,0.035842293906810034,28,71
Europe,Ireland,4853506,2020-04-13,727,14,9655,334,1.9892836230139612,0.03459347488348006,29,71
Europe,Ireland,4853506,2020-04-14,992,31,10647,365,2.1936719559015687,0.034281957358880434,30,71
Europe,Ireland,4853506,2020-04-15,832,41,11479,406,2.365094428646014,0.03536893457618259,31,71
Europe,Ireland,4853506,2020-04-16,1068,38,12547,444,2.5851415451016235,0.03538694508647485,32,71
Europe,Ireland,4853506,2020-04-17,724,42,13271,486,2.7343120622494337,0.036621204129304495,33,71
Europe,Ireland,4853506,2020-04-18,709,44,13980,530,2.8803920300088226,0.03791130185979971,34,71
Europe,Ireland,4853506,2020-04-19,778,41,14758,571,3.04068852495495,0.038690879522970595,35,71
Europe,Ireland,4853506,2020-04-20,493,39,15251,610,3.1422645815210695,0.03999737722116582,36,71
Europe,Ireland,4853506,2020-04-21,401,77,15652,687,3.2248852685048703,0.04389215435727064,37,71
Europe,Ireland,4853506,2020-04-22,388,43,16040,730,3.30482747935204,0.04551122194513716,38,71
Europe,Ireland,4853506,2020-04-23,631,39,16671,769,3.4348365902916362,0.046128006718253255,39,71
Europe,Ireland,4853506,2020-04-24,936,25,17607,794,3.6276868721291375,0.04509570057363549,40,71
Europe,Ireland,4853506,2020-04-25,577,35,18184,829,3.7465700052704167,0.04558952925648922,41,71
Europe,Ireland,4853506,2020-04-26,377,234,18561,1063,3.8242458132327437,0.05727062119497872,42,71
Europe,Ireland,4853506,2020-04-27,701,24,19262,1087,3.9686774879849738,0.056432353857335686,43,71
Europe,Ireland,4853506,2020-04-28,386,15,19648,1102,4.048207625580354,0.056087133550488597,44,71
Europe,Ireland,4853506,2020-04-29,229,57,19877,1159,4.095390012910255,0.0583085978769432,45,71
Europe,Ireland,4853506,2020-04-30,376,31,20253,1190,4.172859784246687,0.05875672739841011,46,71
Europe,Ireland,4853506,2020-05-01,359,42,20612,1232,4.246826932942907,0.05977100718028333,47,71
Europe,Ireland,4853506,2020-05-02,221,33,20833,1265,4.292361027265651,0.060720971535544566,48,71
Europe,Ireland,4853506,2020-05-03,343,0,21176,1265,4.363031589947555,0.05973743860974688,49,71
Europe,Ireland,4853506,2020-05-04,330,38,21506,1303,4.431023676492828,0.06058774295545429,50,71
Europe,Ireland,4853506,2020-05-05,216,16,21722,1319,4.475527587686098,0.06072184881686769,51,71
Europe,Ireland,4853506,2020-05-06,261,20,21983,1339,4.529303147044631,0.06091070372560615,52,71
Europe,Ireland,4853506,2020-05-07,265,36,22248,1375,4.5839028529067445,0.06180330816253146,53,71
Europe,Ireland,4853506,2020-05-08,137,28,22385,1403,4.612129870654327,0.06267589903953541,54,71
Europe,Ireland,4853506,2020-05-09,156,26,22541,1429,4.64427158429391,0.06339559025775254,55,71
Europe,Ireland,4853506,2020-05-10,219,17,22760,1446,4.689393605364864,0.06353251318101934,56,71
Europe,Ireland,4853506,2020-05-11,236,12,22996,1458,4.738018249076029,0.06340233084014611,57,71
Europe,Ireland,4853506,2020-05-12,139,9,23135,1467,4.766657340075401,0.06341041711692241,58,71
Europe,Ireland,4853506,2020-05-13,107,21,23242,1488,4.788703259046142,0.06402202908527665,59,71
Europe,Ireland,4853506,2020-05-14,159,9,23401,1497,4.821463082563409,0.06397162514422461,60,71
Europe,Ireland,4853506,2020-05-15,426,9,23827,1506,4.909234685194579,0.06320560708440005,61,71
Europe,Ireland,4853506,2020-05-16,129,12,23956,1518,4.935813409935004,0.0633661713140758,62,71
Europe,Ireland,4853506,2020-05-17,92,15,24048,1533,4.954768779517322,0.06374750499001997,63,71
Europe,Ireland,4853506,2020-05-18,64,10,24112,1543,4.967955123574587,0.06399303251493033,64,71
Europe,Ireland,4853506,2020-05-19,88,4,24200,1547,4.986086346653327,0.06392561983471075,65,71
Europe,Ireland,4853506,2020-05-20,51,14,24251,1561,4.9965942145739595,0.0643684796503237,66,71
Europe,Ireland,4853506,2020-05-21,64,10,24315,1571,5.009780558631225,0.06461032284597985,67,71
Europe,Ireland,4853506,2020-05-22,76,12,24391,1583,5.025439342199227,0.06490098806936985,68,71
Europe,Ireland,4853506,2020-05-23,115,9,24506,1592,5.049133554177125,0.06496368236350282,69,71
Europe,Ireland,4853506,2020-05-24,76,12,24582,1604,5.064792337745128,0.06525099666422586,70,71
Europe,Ireland,4853506,2020-05-25,57,2,24639,1606,5.0765364254211285,0.06518121677016113,71,71
Europe,Ireland,4853506,2020-05-26,59,0,24698,1606,5.08869258634892,0.06502550813831079,72,71
Europe,Ireland,4853506,2020-05-27,37,9,24735,1615,5.096315941507026,0.06529209621993128,73,71
Asia,Israel,8883800,2020-03-15,62,0,178,0,0.02003647087957856,0,0,72
Asia,Israel,8883800,2020-03-16,72,0,250,0,0.028141110785924944,0,1,72
Asia,Israel,8883800,2020-03-17,10,0,260,0,0.02926675521736194,0,2,72
Asia,Israel,8883800,2020-03-18,167,0,427,0,0.048065017222359806,0,3,72
Asia,Israel,8883800,2020-03-19,6,0,433,0,0.048740403881222,0,4,72
Asia,Israel,8883800,2020-03-20,244,0,677,0,0.07620612800828475,0,5,72
Asia,Israel,8883800,2020-03-21,35,1,712,1,0.08014588351831424,0.0014044943820224719,6,72
Asia,Israel,8883800,2020-03-22,171,0,883,1,0.09939440329588689,0.0011325028312570782,7,72
Asia,Israel,8883800,2020-03-23,188,0,1071,1,0.12055651860690245,9.337068160597573e-4,8,72
Asia,Israel,8883800,2020-03-24,371,0,1442,1,0.16231792701321507,6.934812760055479e-4,9,72
Asia,Israel,8883800,2020-03-25,488,2,1930,3,0.21724937526734056,0.0015544041450777201,10,72
Asia,Israel,8883800,2020-03-26,439,2,2369,5,0.2666651658074247,0.002110595187842972,11,72
Asia,Israel,8883800,2020-03-27,297,3,2666,8,0.30009680542110356,0.003000750187546887,12,72
Asia,Israel,8883800,2020-03-28,369,2,3035,10,0.34163308494112876,0.0032948929159802307,13,72
Asia,Israel,8883800,2020-03-29,584,2,3619,12,0.40737071973704947,0.0033158331030671458,14,72
Asia,Israel,8883800,2020-03-30,628,3,4247,15,0.4780611900312929,0.0035319048740287263,15,72
Asia,Israel,8883800,2020-03-31,226,2,4473,17,0.5035007541817691,0.0038005812653699976,16,72
Asia,Israel,8883800,2020-04-01,443,3,4916,20,0.553366802494428,0.0040683482506102524,17,72
Asia,Israel,8883800,2020-04-02,675,1,5591,21,0.6293478016164255,0.00375603648721159,18,72
Asia,Israel,8883800,2020-04-03,661,13,6252,34,0.7037528985344109,0.005438259756877799,19,72
Asia,Israel,8883800,2020-04-04,1176,5,7428,39,0.8361286836714018,0.005250403877221325,20,72
Asia,Israel,8883800,2020-04-05,590,7,8018,46,0.9025417051261847,0.005737091544025941,21,72
Asia,Israel,8883800,2020-04-06,412,3,8430,49,0.9489182557013891,0.005812574139976275,22,72
Asia,Israel,8883800,2020-04-07,474,8,8904,57,1.0022738017515027,0.006401617250673854,23,72
Asia,Israel,8883800,2020-04-08,344,8,9248,65,1.0409959701929354,0.007028546712802768,24,72
Asia,Israel,8883800,2020-04-09,156,6,9404,71,1.0585560233233526,0.007549978732454275,25,72
Asia,Israel,8883800,2020-04-10,564,15,9968,86,1.1220423692563992,0.00862760834670947,26,72
Asia,Israel,8883800,2020-04-11,440,9,10408,95,1.1715707242396274,0.009127594158339738,27,72
Asia,Israel,8883800,2020-04-12,335,6,10743,101,1.2092798126927666,0.009401470725123337,28,72
Asia,Israel,8883800,2020-04-13,402,2,11145,103,1.254530718836534,0.00924181247196052,29,72
Asia,Israel,8883800,2020-04-14,441,13,11586,116,1.3041716382629054,0.010012083549110996,30,72
Asia,Israel,8883800,2020-04-15,460,7,12046,123,1.3559512821090074,0.010210858376224473,31,72
Asia,Israel,8883800,2020-04-16,455,7,12501,130,1.4071681037393908,0.010399168066554675,32,72
Asia,Israel,8883800,2020-04-17,257,12,12758,142,1.4360971656273216,0.01113027120238282,33,72
Asia,Israel,8883800,2020-04-18,224,9,12982,151,1.4613116008915104,0.011631489755045448,34,72
Asia,Israel,8883800,2020-04-19,283,13,13265,164,1.4931673383011774,0.012363362231436111,35,72
Asia,Israel,8883800,2020-04-20,226,8,13491,172,1.5186069024516535,0.012749240234230227,36,72
Asia,Israel,8883800,2020-04-21,222,5,13713,177,1.543596208829555,0.012907460074381974,37,72
Asia,Israel,8883800,2020-04-22,229,7,13942,184,1.5693734663094623,0.013197532635202984,38,72
Asia,Israel,8883800,2020-04-23,650,7,14592,191,1.642540354352867,0.01308936403508772,39,72
Asia,Israel,8883800,2020-04-24,290,2,14882,193,1.67518404286454,0.012968687004434888,40,72
Asia,Israel,8883800,2020-04-25,176,1,15058,194,1.694995384857831,0.01288351706733962,41,72
Asia,Israel,8883800,2020-04-26,240,5,15298,199,1.7220108512123191,0.013008236370767421,42,72
Asia,Israel,8883800,2020-04-27,100,0,15398,199,1.733267295526689,0.012923756331991167,43,72
Asia,Israel,8883800,2020-04-28,68,3,15466,202,1.7409216776604606,0.013060907797749903,44,72
Asia,Israel,8883800,2020-04-29,123,6,15589,208,1.7547671041671355,0.013342741676823401,45,72
Asia,Israel,8883800,2020-04-30,245,7,15834,215,1.782345392737342,0.013578375647341165,46,72
Asia,Israel,8883800,2020-05-01,112,7,15946,222,1.7949526103694364,0.013921986705129813,47,72
Asia,Israel,8883800,2020-05-02,155,3,16101,225,1.81240009905671,0.013974287311347122,48,72
Asia,Israel,8883800,2020-05-03,84,4,16185,229,1.8218555122807807,0.014148903305529812,49,72
Asia,Israel,8883800,2020-05-04,23,3,16208,232,1.824444494473086,0.014313919052319843,50,72
Asia,Israel,8883800,2020-05-05,38,3,16246,235,1.8287219433125466,0.014465099101317247,51,72
Asia,Israel,8883800,2020-05-06,43,3,16289,238,1.8335622143677255,0.01461108723678556,52,72
Asia,Israel,8883800,2020-05-07,21,1,16310,239,1.8359260676737432,0.014653586756591048,53,72
Asia,Israel,8883800,2020-05-08,71,1,16381,240,1.8439181431369458,0.014651120200231975,54,72
Asia,Israel,8883800,2020-05-09,55,5,16436,245,1.8501091875098494,0.014906303236797274,55,72
Asia,Israel,8883800,2020-05-10,18,2,16454,247,1.8521353474864362,0.015011547344110854,56,72
Asia,Israel,8883800,2020-05-11,23,5,16477,252,1.854724329678741,0.015294046246282698,57,72
Asia,Israel,8883800,2020-05-12,29,6,16506,258,1.8579886985299083,0.015630679752817157,58,72
Asia,Israel,8883800,2020-05-13,23,2,16529,260,1.8605776807222134,0.01572992921531853,59,72
Asia,Israel,8883800,2020-05-14,19,4,16548,264,1.8627164051419438,0.01595358955765047,60,72
Asia,Israel,8883800,2020-05-15,31,1,16579,265,1.8662059028793985,0.015984076241027805,61,72
Asia,Israel,8883800,2020-05-16,10,1,16589,266,1.8673315473108354,0.0160347218036048,62,72
Asia,Israel,8883800,2020-05-17,19,2,16608,268,1.8694702717305658,0.01613680154142582,63,72
Asia,Israel,8883800,2020-05-18,9,4,16617,272,1.870483351718859,0.01636877896130469,64,72
Asia,Israel,8883800,2020-05-19,4,0,16621,272,1.870933609491434,0.016364839660670236,65,72
Asia,Israel,8883800,2020-05-20,29,5,16650,277,1.874197978342601,0.016636636636636636,66,72
Asia,Israel,8883800,2020-05-21,20,2,16670,279,1.8764492672054751,0.016736652669466105,67,72
Asia,Israel,8883800,2020-05-22,20,0,16690,279,1.8787005560683492,0.01671659676452966,68,72
Asia,Israel,8883800,2020-05-23,0,0,16690,279,1.8787005560683492,0.01671659676452966,69,72
Asia,Israel,8883800,2020-05-24,0,0,16690,279,1.8787005560683492,0.01671659676452966,70,72
Asia,Israel,8883800,2020-05-25,30,1,16720,280,1.8820774893626602,0.01674641148325359,71,72
Asia,Israel,8883800,2020-05-26,14,1,16734,281,1.883653391566672,0.01679215967491335,72,72
Asia,Israel,8883800,2020-05-27,23,0,16757,281,1.886242373758977,0.016769111416124603,73,72
Europe,Italy,60431283,2020-03-02,561,6,1689,35,0.02794910046837827,0.020722320899940794,0,73
Europe,Italy,60431283,2020-03-03,347,17,2036,52,0.03369115959361644,0.025540275049115914,1,73
Europe,Italy,60431283,2020-03-04,466,28,2502,80,0.04140239749667403,0.0319744204636291,2,73
Europe,Italy,60431283,2020-03-05,587,27,3089,107,0.05111590961919508,0.03463904176108773,3,73
Europe,Italy,60431283,2020-03-06,769,41,3858,148,0.0638411069313223,0.0383618455158113,4,73
Europe,Italy,60431283,2020-03-07,778,49,4636,197,0.07671523373084765,0.042493528904227786,5,73
Europe,Italy,60431283,2020-03-08,1247,36,5883,233,0.09735024159589661,0.039605643379228284,6,73
Europe,Italy,60431283,2020-03-09,1492,133,7375,366,0.12203944106233852,0.0496271186440678,7,73
Europe,Italy,60431283,2020-03-10,1797,98,9172,464,0.1517756953794941,0.05058874836458788,8,73
Europe,Italy,60431283,2020-03-11,977,167,10149,631,0.16794281862259983,0.062173613163858506,9,73
Europe,Italy,60431283,2020-03-12,2313,196,12462,827,0.2062176968839136,0.06636173968865351,10,73
Europe,Italy,60431283,2020-03-13,2651,189,15113,1016,0.2500857047830674,0.06722689075630252,11,73
Europe,Italy,60431283,2020-03-14,2547,252,17660,1268,0.29223274971673197,0.07180067950169876,12,73
Europe,Italy,60431283,2020-03-15,3497,173,21157,1441,0.35010012943130797,0.06810984544122513,13,73
Europe,Italy,60431283,2020-03-16,2823,370,23980,1811,0.39681434531184784,0.07552126772310258,14,73
Europe,Italy,60431283,2020-03-17,4000,347,27980,2158,0.46300522859989585,0.0771265189421015,15,73
Europe,Italy,60431283,2020-03-18,3526,347,31506,2505,0.5213524922183101,0.07950866501618739,16,73
Europe,Italy,60431283,2020-03-19,4207,473,35713,2978,0.5909687537165147,0.08338700193206955,17,73
Europe,Italy,60431283,2020-03-20,5322,429,41035,3407,0.6790357239312625,0.08302668453758986,18,73
Europe,Italy,60431283,2020-03-21,5986,625,47021,4032,0.7780903807718265,0.08574892069500861,19,73
Europe,Italy,60431283,2020-03-22,6557,795,53578,4827,0.8865937862017591,0.09009294859830527,20,73
Europe,Italy,60431283,2020-03-23,5560,649,59138,5476,0.9785991139721458,0.09259697656329263,21,73
Europe,Italy,60431283,2020-03-24,4789,601,63927,6077,1.0578461489887614,0.09506155458569931,22,73
Europe,Italy,60431283,2020-03-25,5249,743,69176,6820,1.1447051355835023,0.09858910604834047,23,73
Europe,Italy,60431283,2020-03-26,5210,685,74386,7505,1.2309187610661847,0.10089264108837684,24,73
Europe,Italy,60431283,2020-03-27,6153,660,80539,8165,1.3327368872840246,0.10137945591576751,25,73
Europe,Italy,60431283,2020-03-28,5959,971,86498,9136,1.4313447556623942,0.10562093921246735,26,73
Europe,Italy,60431283,2020-03-29,5974,887,92472,10023,1.530200839853094,0.10838956657150273,27,73
Europe,Italy,60431283,2020-03-30,5217,758,97689,10781,1.6165302993815305,0.11036042952635404,28,73
Europe,Italy,60431283,2020-03-31,4050,810,101739,11591,1.6835485687106793,0.11392877854116908,29,73
Europe,Italy,60431283,2020-04-01,4053,839,105792,12430,1.750616481202294,0.11749470659407138,30,73
Europe,Italy,60431283,2020-04-02,4782,727,110574,13157,1.8297476821731553,0.11898818890516757,31,73
Europe,Italy,60431283,2020-04-03,4668,760,115242,13917,1.9069924429703073,0.12076326339355443,32,73
Europe,Italy,60431283,2020-04-04,4585,764,119827,14681,1.9828637429392324,0.1225182972118137,33,73
Europe,Italy,60431283,2020-04-05,4805,681,124632,15362,2.0623755414889997,0.12325887412542526,34,73
Europe,Italy,60431283,2020-04-06,4316,527,128948,15889,2.133795504556804,0.12322021279895772,35,73
Europe,Italy,60431283,2020-04-07,3599,636,132547,16525,2.1933507517952253,0.1246727575878745,36,73
Europe,Italy,60431283,2020-04-08,3039,604,135586,17129,2.2436392753733196,0.12633310223769414,37,73
Europe,Italy,60431283,2020-04-09,3836,540,139422,17669,2.3071163324465576,0.12673035819311157,38,73
Europe,Italy,60431283,2020-04-10,4204,612,143626,18281,2.3766829507822957,0.12728196844582457,39,73
Europe,Italy,60431283,2020-04-11,3951,570,147577,18851,2.4420629957500655,0.12773670693942824,40,73
Europe,Italy,60431283,2020-04-12,4694,619,152271,19470,2.5197379972885896,0.12786413696632976,41,73
Europe,Italy,60431283,2020-04-13,4092,431,156363,19901,2.5874512708922626,0.12727435518632924,42,73
Europe,Italy,60431283,2020-04-14,3153,564,159516,20465,2.6396262346440666,0.12829434037964843,43,73
Europe,Italy,60431283,2020-04-15,2972,604,162488,21069,2.6888060609270865,0.12966495987395993,44,73
Europe,Italy,60431283,2020-04-16,2667,578,165155,21647,2.7329388323593924,0.13107081226726408,45,73
Europe,Italy,60431283,2020-04-17,3786,525,168941,22172,2.7955885033915298,0.1312410841654779,46,73
Europe,Italy,60431283,2020-04-18,3493,575,172434,22747,2.8533896922228177,0.13191713931127272,47,73
Europe,Italy,60431283,2020-04-19,3491,480,175925,23227,2.9111577856124615,0.13202785277817253,48,73
Europe,Italy,60431283,2020-04-20,3047,433,178972,23660,2.961578690957132,0.13219945019332632,49,73
Europe,Italy,60431283,2020-04-21,2256,454,181228,24114,2.998910349131591,0.13305890921932592,50,73
Europe,Italy,60431283,2020-04-22,2729,534,183957,24648,3.044069079254862,0.13398783411340695,51,73
Europe,Italy,60431283,2020-04-23,3370,437,187327,25085,3.0998348984250423,0.1339102211640607,52,73
Europe,Italy,60431283,2020-04-24,2646,464,189973,25549,3.143620167720086,0.13448753243882025,53,73
Europe,Italy,60431283,2020-04-25,3021,420,192994,25969,3.1936108323233845,0.13455858731359524,54,73
Europe,Italy,60431283,2020-04-26,2357,415,195351,26384,3.232613810300867,0.13505945707982042,55,73
Europe,Italy,60431283,2020-04-27,2324,260,197675,26644,3.271070713491223,0.13478689768559504,56,73
Europe,Italy,60431283,2020-04-28,1739,333,199414,26977,3.2998472000007015,0.13528137442707133,57,73
Europe,Italy,60431283,2020-04-29,2091,382,201505,27359,3.3344484842395286,0.13577330587330338,58,73
Europe,Italy,60431283,2020-04-30,2086,323,203591,27682,3.368967029874246,0.13596868230913942,59,73
Europe,Italy,60431283,2020-05-01,1872,285,205463,27967,3.3999443632530526,0.13611696509833887,60,73
Europe,Italy,60431283,2020-05-02,1965,269,207428,28236,3.4324606346683058,0.13612434194033593,61,73
Europe,Italy,60431283,2020-05-03,1900,474,209328,28710,3.4639013042301285,0.13715317587709241,62,73
Europe,Italy,60431283,2020-05-04,1389,174,210717,28884,3.4868860884519033,0.1370748444596307,63,73
Europe,Italy,60431283,2020-05-05,1221,195,211938,29079,3.50709085557558,0.13720522039464372,64,73
Europe,Italy,60431283,2020-05-06,1075,236,213013,29315,3.5248796554592428,0.13762070859525005,65,73
Europe,Italy,60431283,2020-05-07,1444,369,214457,29684,3.5487745643262283,0.13841469385471214,66,73
Europe,Italy,60431283,2020-05-08,1401,274,215858,29958,3.5719579211978667,0.13878568318060946,67,73
Europe,Italy,60431283,2020-05-09,1327,243,217185,30201,3.5939167467286772,0.1390565646798812,68,73
Europe,Italy,60431283,2020-05-10,1083,194,218268,30395,3.611837928378916,0.1392554107794088,69,73
Europe,Italy,60431283,2020-05-11,802,165,219070,30560,3.6251092004781698,0.1394987903409869,70,73
Europe,Italy,60431283,2020-05-12,744,179,219814,30739,3.6374207047697467,0.1398409564449944,71,73
Europe,Italy,60431283,2020-05-13,1402,172,221216,30911,3.660620609362207,0.13973220743526688,72,73
Europe,Italy,60431283,2020-05-14,888,195,222104,31106,3.6753149854521543,0.14005150740193784,73,73
Europe,Italy,60431283,2020-05-15,992,262,223096,31368,3.69173032450759,0.14060314842041094,74,73
Europe,Italy,60431283,2020-05-16,789,242,223885,31610,3.7047864762361575,0.14118855662505303,75,73
Europe,Italy,60431283,2020-05-17,875,153,224760,31763,3.719265731955418,0.14131962982737142,76,73
Europe,Italy,60431283,2020-05-18,675,145,225435,31908,3.730435443510276,0.1415396899327966,77,73
Europe,Italy,60431283,2020-05-19,451,99,225886,32007,3.7378984656010035,0.14169536846019673,78,73
Europe,Italy,60431283,2020-05-20,813,162,226699,32169,3.751351762629299,0.14190181694670026,79,73
Europe,Italy,60431283,2020-05-21,665,161,227364,32330,3.762355996975937,0.1421948945303566,80,73
Europe,Italy,60431283,2020-05-22,642,156,228006,32486,3.772979633743669,0.14247870670070087,81,73
Europe,Italy,60431283,2020-05-23,652,130,228658,32616,3.7837687477196202,0.1426409747308207,82,73
Europe,Italy,60431283,2020-05-24,669,119,229327,32735,3.7948391729495468,0.14274376763311777,83,73
Europe,Italy,60431283,2020-05-25,531,50,229858,32785,3.803626012706035,0.14263153773199105,84,73
Europe,Italy,60431283,2020-05-26,300,92,230158,32877,3.8085903289526386,0.14284534971628185,85,73
Europe,Italy,60431283,2020-05-27,397,78,230555,32955,3.8151597741189773,0.14293769382576826,86,73
America,Jamaica,2934855,2020-04-07,1,0,59,3,0.020103207824577366,0.05084745762711865,0,74
America,Jamaica,2934855,2020-04-08,4,0,63,3,0.021466137168616506,0.047619047619047616,1,74
America,Jamaica,2934855,2020-04-09,0,1,63,4,0.021466137168616506,0.06349206349206349,2,74
America,Jamaica,2934855,2020-04-10,0,0,63,4,0.021466137168616506,0.06349206349206349,3,74
America,Jamaica,2934855,2020-04-11,2,0,65,4,0.02214760184063608,0.06153846153846154,4,74
America,Jamaica,2934855,2020-04-12,4,0,69,4,0.02351053118467522,0.057971014492753624,5,74
America,Jamaica,2934855,2020-04-13,3,0,72,4,0.024532728192704578,0.05555555555555555,6,74
America,Jamaica,2934855,2020-04-14,1,0,73,4,0.024873460528714367,0.0547945205479452,7,74
America,Jamaica,2934855,2020-04-15,32,1,105,5,0.03577689528102751,0.047619047619047616,8,74
America,Jamaica,2934855,2020-04-16,20,0,125,5,0.042591542001223226,0.04,9,74
America,Jamaica,2934855,2020-04-17,18,0,143,5,0.04872472404939937,0.03496503496503497,10,74
America,Jamaica,2934855,2020-04-18,20,0,163,5,0.055539370769595094,0.03067484662576687,11,74
America,Jamaica,2934855,2020-04-19,10,0,173,5,0.058946694129692945,0.028901734104046242,12,74
America,Jamaica,2934855,2020-04-20,23,0,196,5,0.06678353785791802,0.025510204081632654,13,74
America,Jamaica,2934855,2020-04-21,27,1,223,6,0.07598331093018225,0.026905829596412557,14,74
America,Jamaica,2934855,2020-04-22,10,0,233,6,0.0793906342902801,0.02575107296137339,15,74
America,Jamaica,2934855,2020-04-23,19,0,252,6,0.08586454867446602,0.023809523809523808,16,74
America,Jamaica,2934855,2020-04-24,0,0,252,6,0.08586454867446602,0.023809523809523808,17,74
America,Jamaica,2934855,2020-04-25,36,1,288,7,0.09813091277081831,0.024305555555555556,18,74
America,Jamaica,2934855,2020-04-26,17,0,305,7,0.10392336248298469,0.022950819672131147,19,74
America,Jamaica,2934855,2020-04-27,45,0,350,7,0.11925631760342505,0.02,20,74
America,Jamaica,2934855,2020-04-28,14,0,364,7,0.12402657030756203,0.019230769230769232,21,74
America,Jamaica,2934855,2020-04-29,17,0,381,7,0.1298190200197284,0.01837270341207349,22,74
America,Jamaica,2934855,2020-04-30,15,0,396,7,0.13493000505987518,0.017676767676767676,23,74
America,Jamaica,2934855,2020-05-01,26,1,422,8,0.14378904579612964,0.018957345971563982,24,74
America,Jamaica,2934855,2020-05-02,10,0,432,8,0.14719636915622747,0.018518518518518517,25,74
America,Jamaica,2934855,2020-05-03,31,0,463,8,0.15775907157253086,0.017278617710583154,26,74
America,Jamaica,2934855,2020-05-04,6,1,469,9,0.15980346558858954,0.019189765458422176,27,74
America,Jamaica,2934855,2020-05-05,2,0,471,9,0.16048493026060912,0.01910828025477707,28,74
America,Jamaica,2934855,2020-05-06,2,0,473,9,0.1611663949326287,0.019027484143763214,29,74
America,Jamaica,2934855,2020-05-07,5,0,478,9,0.16287005661267762,0.01882845188284519,30,74
America,Jamaica,2934855,2020-05-08,10,0,488,9,0.16627737997277547,0.018442622950819672,31,74
America,Jamaica,2934855,2020-05-09,2,0,490,9,0.16695884464479507,0.018367346938775512,32,74
America,Jamaica,2934855,2020-05-10,8,0,498,9,0.16968470333287336,0.018072289156626505,33,74
America,Jamaica,2934855,2020-05-11,4,0,502,9,0.17104763267691248,0.017928286852589643,34,74
America,Jamaica,2934855,2020-05-12,3,0,505,9,0.17206982968494186,0.01782178217821782,35,74
America,Jamaica,2934855,2020-05-13,2,0,507,9,0.17275129435696143,0.01775147928994083,36,74
America,Jamaica,2934855,2020-05-14,2,0,509,9,0.173432759028981,0.01768172888015717,37,74
America,Jamaica,2934855,2020-05-15,0,0,509,9,0.173432759028981,0.01768172888015717,38,74
America,Jamaica,2934855,2020-05-16,2,0,511,9,0.17411422370100055,0.01761252446183953,39,74
America,Jamaica,2934855,2020-05-17,6,0,517,9,0.17615861771705926,0.017408123791102514,40,74
America,Jamaica,2934855,2020-05-18,3,0,520,9,0.17718081472508865,0.01730769230769231,41,74
America,Jamaica,2934855,2020-05-19,0,0,520,9,0.17718081472508865,0.01730769230769231,42,74
America,Jamaica,2934855,2020-05-20,0,0,520,9,0.17718081472508865,0.01730769230769231,43,74
America,Jamaica,2934855,2020-05-21,9,0,529,9,0.18024740574917672,0.017013232514177693,44,74
America,Jamaica,2934855,2020-05-22,5,0,534,9,0.18195106742922562,0.016853932584269662,45,74
America,Jamaica,2934855,2020-05-23,10,0,544,9,0.1853583907893235,0.016544117647058824,46,74
America,Jamaica,2934855,2020-05-24,6,0,550,9,0.1874027848053822,0.016363636363636365,47,74
America,Jamaica,2934855,2020-05-25,2,0,552,9,0.18808424947740177,0.016304347826086956,48,74
America,Jamaica,2934855,2020-05-26,4,0,556,9,0.1894471788214409,0.01618705035971223,49,74
America,Jamaica,2934855,2020-05-27,8,0,564,9,0.19217303750951922,0.015957446808510637,50,74
Asia,Japan,126529100,2020-04-03,439,6,2617,63,0.020682989130563642,0.02407336645013374,0,75
Asia,Japan,126529100,2020-04-04,318,6,2935,69,0.023196244974476227,0.023509369676320273,1,75
Asia,Japan,126529100,2020-04-05,336,1,3271,70,0.02585176058313858,0.021400183430143688,2,75
Asia,Japan,126529100,2020-04-06,383,3,3654,73,0.02887873224420311,0.019978106185002738,3,75
Asia,Japan,126529100,2020-04-07,163,7,3817,80,0.03016697344721491,0.020958868221116058,4,75
Asia,Japan,126529100,2020-04-08,89,0,3906,80,0.030870368950699882,0.02048131080389145,5,75
Asia,Japan,126529100,2020-04-09,351,1,4257,81,0.033644434363320375,0.019027484143763214,6,75
Asia,Japan,126529100,2020-04-10,410,4,4667,85,0.036884795671509554,0.018212984786800942,7,75
Asia,Japan,126529100,2020-04-11,680,3,5347,88,0.04225905345094528,0.016457826818776885,8,75
Asia,Japan,126529100,2020-04-12,1401,10,6748,98,0.05333160514063563,0.014522821576763486,9,75
Asia,Japan,126529100,2020-04-13,507,4,7255,102,0.057338588514420794,0.014059269469331495,10,75
Asia,Japan,126529100,2020-04-14,390,7,7645,109,0.06042088341733246,0.014257684761281884,11,75
Asia,Japan,126529100,2020-04-15,455,10,8100,119,0.06401689413739606,0.014691358024691358,12,75
Asia,Japan,126529100,2020-04-16,482,17,8582,136,0.06782629450458431,0.015847121883010955,13,75
Asia,Japan,126529100,2020-04-17,585,12,9167,148,0.07244973685895181,0.016144867459365116,14,75
Asia,Japan,126529100,2020-04-18,628,6,9795,154,0.07741302198466597,0.015722307299642673,15,75
Asia,Japan,126529100,2020-04-19,566,7,10361,161,0.08188630125401983,0.015539040633143519,16,75
Asia,Japan,126529100,2020-04-20,390,10,10751,171,0.08496859615693148,0.0159054971630546,17,75
Asia,Japan,126529100,2020-04-21,367,15,11118,186,0.08786911469377401,0.01672962763086886,18,75
Asia,Japan,126529100,2020-04-22,378,0,11496,186,0.09085656975351916,0.016179540709812108,19,75
Asia,Japan,126529100,2020-04-23,276,101,11772,287,0.09303788614634893,0.024379884471627592,20,75
Asia,Japan,126529100,2020-04-24,468,30,12240,317,0.09673664002984295,0.025898692810457518,21,75
Asia,Japan,126529100,2020-04-25,652,17,12892,334,0.10188960484189012,0.025907539559416694,22,75
Asia,Japan,126529100,2020-04-26,290,14,13182,348,0.10418156771841419,0.02639963586709149,23,75
Asia,Japan,126529100,2020-04-27,203,3,13385,351,0.10578594173198101,0.026223384385506164,24,75
Asia,Japan,126529100,2020-04-28,191,25,13576,376,0.10729547590238135,0.02769593400117855,25,75
Asia,Japan,126529100,2020-04-29,276,13,13852,389,0.10947679229521114,0.02808258735200693,26,75
Asia,Japan,126529100,2020-04-30,236,26,14088,415,0.1113419758774859,0.02945769449176604,27,75
Asia,Japan,126529100,2020-05-01,193,17,14281,432,0.11286731668841396,0.030249982494223095,28,75
Asia,Japan,126529100,2020-05-02,263,26,14544,458,0.11494588991781336,0.03149064906490649,29,75
Asia,Japan,126529100,2020-05-03,295,34,14839,492,0.11727736939565682,0.033155873037266664,30,75
Asia,Japan,126529100,2020-05-04,218,18,15057,510,0.1190002932131818,0.033871289101414626,31,75
Asia,Japan,126529100,2020-05-05,174,11,15231,521,0.12037547093909622,0.03420655242597334,32,75
Asia,Japan,126529100,2020-05-06,123,22,15354,543,0.12134757933155298,0.035365377100429855,33,75
Asia,Japan,126529100,2020-05-07,109,8,15463,551,0.12220904124031547,0.035633447584556686,34,75
Asia,Japan,126529100,2020-05-08,84,6,15547,557,0.12287292014248107,0.03582684762333569,35,75
Asia,Japan,126529100,2020-05-09,81,44,15628,601,0.12351308908385503,0.038456616329664704,36,75
Asia,Japan,126529100,2020-05-10,119,12,15747,613,0.12445358419525628,0.03892804978726107,37,75
Asia,Japan,126529100,2020-05-11,51,8,15798,621,0.12485665352871396,0.039308773262438285,38,75
Asia,Japan,126529100,2020-05-12,76,22,15874,643,0.12545730586876852,0.04050648859770694,39,75
Asia,Japan,126529100,2020-05-13,150,25,16024,668,0.12664280390834992,0.041687468796804794,40,75
Asia,Japan,126529100,2020-05-14,55,19,16079,687,0.1270774865228631,0.042726537720007465,41,75
Asia,Japan,126529100,2020-05-15,114,23,16193,710,0.127978465032945,0.04384610634224665,42,75
Asia,Japan,126529100,2020-05-16,44,15,16237,725,0.12832621112455553,0.04465110549978444,43,75
Asia,Japan,126529100,2020-05-17,48,19,16285,744,0.1287055704972216,0.04568621430764507,44,75
Asia,Japan,126529100,2020-05-18,20,5,16305,749,0.1288636369024991,0.045936829193498924,45,75
Asia,Japan,126529100,2020-05-19,60,14,16365,763,0.12933783611833166,0.04662389245340666,46,75
Asia,Japan,126529100,2020-05-20,20,8,16385,771,0.12949590252360918,0.04705523344522429,47,75
Asia,Japan,126529100,2020-05-21,39,6,16424,777,0.12980413201390034,0.04730881636629323,48,75
Asia,Japan,126529100,2020-05-22,89,19,16513,796,0.1305075275173853,0.048204444982740874,49,75
Asia,Japan,126529100,2020-05-23,23,12,16536,808,0.13068930388345448,0.04886308659893566,50,75
Asia,Japan,126529100,2020-05-24,14,12,16550,820,0.13079995036714873,0.04954682779456193,51,75
Asia,Japan,126529100,2020-05-25,31,10,16581,830,0.13104495329532892,0.050057294493697606,52,75
Asia,Japan,126529100,2020-05-26,42,16,16623,846,0.1313768927464117,0.05089334055224689,53,75
Asia,Japan,126529100,2020-05-27,28,12,16651,858,0.13159818571380025,0.0515284367305267,54,75
Europe,Jersey,106800,2020-03-20,5,0,5,0,0.04681647940074907,0,0,76
Europe,Jersey,106800,2020-03-21,7,0,12,0,0.11235955056179776,0,1,76
Europe,Jersey,106800,2020-03-22,0,0,12,0,0.11235955056179776,0,2,76
Europe,Jersey,106800,2020-03-23,3,0,15,0,0.1404494382022472,0,3,76
Europe,Jersey,106800,2020-03-24,3,0,18,0,0.16853932584269662,0,4,76
Europe,Jersey,106800,2020-03-25,0,0,18,0,0.16853932584269662,0,5,76
Europe,Jersey,106800,2020-03-26,0,0,18,0,0.16853932584269662,0,6,76
Europe,Jersey,106800,2020-03-27,14,1,32,1,0.299625468164794,0.03125,7,76
Europe,Jersey,106800,2020-03-28,20,0,52,1,0.48689138576779023,0.019230769230769232,8,76
Europe,Jersey,106800,2020-03-29,9,0,61,1,0.5711610486891386,0.01639344262295082,9,76
Europe,Jersey,106800,2020-03-30,2,1,63,2,0.5898876404494382,0.031746031746031744,10,76
Europe,Jersey,106800,2020-03-31,0,0,63,2,0.5898876404494382,0.031746031746031744,11,76
Europe,Jersey,106800,2020-04-01,18,0,81,2,0.7584269662921348,0.024691358024691357,12,76
Europe,Jersey,106800,2020-04-02,0,0,81,2,0.7584269662921348,0.024691358024691357,13,76
Europe,Jersey,106800,2020-04-03,0,0,81,2,0.7584269662921348,0.024691358024691357,14,76
Europe,Jersey,106800,2020-04-04,37,0,118,2,1.104868913857678,0.01694915254237288,15,76
Europe,Jersey,106800,2020-04-05,5,1,123,3,1.151685393258427,0.024390243902439025,16,76
Europe,Jersey,106800,2020-04-06,32,0,155,3,1.4513108614232209,0.01935483870967742,17,76
Europe,Jersey,106800,2020-04-07,14,0,169,3,1.5823970037453183,0.01775147928994083,18,76
Europe,Jersey,106800,2020-04-08,1,0,170,3,1.591760299625468,0.01764705882352941,19,76
Europe,Jersey,106800,2020-04-09,0,0,170,3,1.591760299625468,0.01764705882352941,20,76
Europe,Jersey,106800,2020-04-10,13,0,183,3,1.7134831460674158,0.01639344262295082,21,76
Europe,Jersey,106800,2020-04-11,15,1,198,4,1.853932584269663,0.020202020202020204,22,76
Europe,Jersey,106800,2020-04-12,0,0,198,4,1.853932584269663,0.020202020202020204,23,76
Europe,Jersey,106800,2020-04-13,15,0,213,4,1.99438202247191,0.018779342723004695,24,76
Europe,Jersey,106800,2020-04-14,4,0,217,4,2.0318352059925098,0.018433179723502304,25,76
Europe,Jersey,106800,2020-04-15,0,0,217,4,2.0318352059925098,0.018433179723502304,26,76
Europe,Jersey,106800,2020-04-16,0,2,217,6,2.0318352059925098,0.027649769585253458,27,76
Europe,Jersey,106800,2020-04-17,6,4,223,10,2.088014981273408,0.04484304932735426,28,76
Europe,Jersey,106800,2020-04-18,1,1,224,11,2.097378277153558,0.049107142857142856,29,76
Europe,Jersey,106800,2020-04-19,21,1,245,12,2.2940074906367043,0.04897959183673469,30,76
Europe,Jersey,106800,2020-04-20,4,0,249,12,2.331460674157303,0.04819277108433735,31,76
Europe,Jersey,106800,2020-04-21,0,2,249,14,2.331460674157303,0.05622489959839357,32,76
Europe,Jersey,106800,2020-04-22,6,0,255,14,2.3876404494382024,0.054901960784313725,33,76
Europe,Jersey,106800,2020-04-23,0,4,255,18,2.3876404494382024,0.07058823529411765,34,76
Europe,Jersey,106800,2020-04-24,21,1,276,19,2.584269662921348,0.06884057971014493,35,76
Europe,Jersey,106800,2020-04-25,2,0,278,19,2.602996254681648,0.0683453237410072,36,76
Europe,Jersey,106800,2020-04-26,2,0,280,19,2.6217228464419478,0.06785714285714285,37,76
Europe,Jersey,106800,2020-04-27,1,0,281,19,2.631086142322097,0.06761565836298933,38,76
Europe,Jersey,106800,2020-04-28,2,0,283,19,2.649812734082397,0.06713780918727916,39,76
Europe,Jersey,106800,2020-04-29,1,1,284,20,2.6591760299625467,0.07042253521126761,40,76
Europe,Jersey,106800,2020-04-30,2,1,286,21,2.6779026217228465,0.07342657342657342,41,76
Europe,Jersey,106800,2020-05-01,0,2,286,23,2.6779026217228465,0.08041958041958042,42,76
Europe,Jersey,106800,2020-05-02,0,1,286,24,2.6779026217228465,0.08391608391608392,43,76
Europe,Jersey,106800,2020-05-03,5,0,291,24,2.7247191011235956,0.08247422680412371,44,76
Europe,Jersey,106800,2020-05-04,1,0,292,24,2.7340823970037453,0.0821917808219178,45,76
Europe,Jersey,106800,2020-05-05,1,0,293,24,2.743445692883895,0.08191126279863481,46,76
Europe,Jersey,106800,2020-05-06,0,0,293,24,2.743445692883895,0.08191126279863481,47,76
Europe,Jersey,106800,2020-05-07,0,1,293,25,2.743445692883895,0.08532423208191127,48,76
Europe,Jersey,106800,2020-05-08,0,0,293,25,2.743445692883895,0.08532423208191127,49,76
Europe,Jersey,106800,2020-05-09,0,0,293,25,2.743445692883895,0.08532423208191127,50,76
Europe,Jersey,106800,2020-05-10,0,0,293,25,2.743445692883895,0.08532423208191127,51,76
Europe,Jersey,106800,2020-05-11,1,0,294,25,2.752808988764045,0.08503401360544217,52,76
Europe,Jersey,106800,2020-05-12,0,0,294,25,2.752808988764045,0.08503401360544217,53,76
Europe,Jersey,106800,2020-05-13,1,1,295,26,2.762172284644195,0.08813559322033898,54,76
Europe,Jersey,106800,2020-05-14,1,1,296,27,2.7715355805243447,0.09121621621621621,55,76
Europe,Jersey,106800,2020-05-15,1,0,297,27,2.7808988764044944,0.09090909090909091,56,76
Europe,Jersey,106800,2020-05-16,0,0,297,27,2.7808988764044944,0.09090909090909091,57,76
Europe,Jersey,106800,2020-05-17,5,0,302,27,2.8277153558052435,0.08940397350993377,58,76
Europe,Jersey,106800,2020-05-18,0,0,302,27,2.8277153558052435,0.08940397350993377,59,76
Europe,Jersey,106800,2020-05-19,1,0,303,27,2.837078651685393,0.0891089108910891,60,76
Europe,Jersey,106800,2020-05-20,0,1,303,28,2.837078651685393,0.0924092409240924,61,76
Europe,Jersey,106800,2020-05-21,3,1,306,29,2.865168539325843,0.09477124183006536,62,76
Europe,Jersey,106800,2020-05-22,0,0,306,29,2.865168539325843,0.09477124183006536,63,76
Europe,Jersey,106800,2020-05-23,0,0,306,29,2.865168539325843,0.09477124183006536,64,76
Europe,Jersey,106800,2020-05-24,0,0,306,29,2.865168539325843,0.09477124183006536,65,76
Europe,Jersey,106800,2020-05-25,0,0,306,29,2.865168539325843,0.09477124183006536,66,76
Europe,Jersey,106800,2020-05-26,1,0,307,29,2.8745318352059925,0.09446254071661238,67,76
Europe,Jersey,106800,2020-05-27,0,0,307,29,2.8745318352059925,0.09446254071661238,68,76
Asia,Jordan,9956011,2020-03-28,40,0,212,0,0.02129366871932946,0,0,77
Asia,Jordan,9956011,2020-03-29,23,1,235,1,0.023603830891709542,0.00425531914893617,1,77
Asia,Jordan,9956011,2020-03-30,24,0,259,1,0.026014434897671367,0.003861003861003861,2,77
Asia,Jordan,9956011,2020-03-31,9,4,268,5,0.026918411399907048,0.018656716417910446,3,77
Asia,Jordan,9956011,2020-04-01,6,0,274,5,0.027521062401397508,0.01824817518248175,4,77
Asia,Jordan,9956011,2020-04-02,4,0,278,5,0.027922829735724478,0.017985611510791366,5,77
Asia,Jordan,9956011,2020-04-03,21,0,299,5,0.030032108240941074,0.016722408026755852,6,77
Asia,Jordan,9956011,2020-04-04,0,0,299,5,0.030032108240941074,0.016722408026755852,7,77
Asia,Jordan,9956011,2020-04-05,24,0,323,5,0.0324427122469029,0.015479876160990712,8,77
Asia,Jordan,9956011,2020-04-06,22,0,345,5,0.03465243258570124,0.014492753623188406,9,77
Asia,Jordan,9956011,2020-04-07,4,1,349,6,0.035054199920028214,0.017191977077363897,10,77
Asia,Jordan,9956011,2020-04-08,0,0,349,6,0.035054199920028214,0.017191977077363897,11,77
Asia,Jordan,9956011,2020-04-09,9,0,358,6,0.0359581764222639,0.01675977653631285,12,77
Asia,Jordan,9956011,2020-04-10,14,1,372,7,0.037364362092408294,0.01881720430107527,13,77
Asia,Jordan,9956011,2020-04-11,0,0,372,7,0.037364362092408294,0.01881720430107527,14,77
Asia,Jordan,9956011,2020-04-12,9,0,381,7,0.03826833859464398,0.01837270341207349,15,77
Asia,Jordan,9956011,2020-04-13,8,0,389,7,0.039071873263297925,0.017994858611825194,16,77
Asia,Jordan,9956011,2020-04-14,2,0,391,7,0.0392727569304614,0.017902813299232736,17,77
Asia,Jordan,9956011,2020-04-15,6,0,397,7,0.039875407931951865,0.017632241813602016,18,77
Asia,Jordan,9956011,2020-04-16,4,0,401,7,0.04027717526627883,0.017456359102244388,19,77
Asia,Jordan,9956011,2020-04-17,1,0,402,7,0.040377617099860576,0.017412935323383085,20,77
Asia,Jordan,9956011,2020-04-18,5,0,407,7,0.040879826267769294,0.0171990171990172,21,77
Asia,Jordan,9956011,2020-04-19,6,0,413,7,0.04148247726925974,0.01694915254237288,22,77
Asia,Jordan,9956011,2020-04-20,4,0,417,7,0.041884244603586716,0.016786570743405275,23,77
Asia,Jordan,9956011,2020-04-21,8,0,425,7,0.04268777927224066,0.01647058823529412,24,77
Asia,Jordan,9956011,2020-04-22,0,0,425,7,0.04268777927224066,0.01647058823529412,25,77
Asia,Jordan,9956011,2020-04-23,3,0,428,7,0.042989104772985884,0.016355140186915886,26,77
Asia,Jordan,9956011,2020-04-24,9,0,437,7,0.043893081275221575,0.016018306636155607,27,77
Asia,Jordan,9956011,2020-04-25,4,0,441,7,0.04429484860954854,0.015873015873015872,28,77
Asia,Jordan,9956011,2020-04-26,3,0,444,7,0.044596174110293776,0.015765765765765764,29,77
Asia,Jordan,9956011,2020-04-27,3,0,447,7,0.044897499611039,0.015659955257270694,30,77
Asia,Jordan,9956011,2020-04-28,2,0,449,7,0.04509838327820249,0.015590200445434299,31,77
Asia,Jordan,9956011,2020-04-29,0,1,449,8,0.04509838327820249,0.017817371937639197,32,77
Asia,Jordan,9956011,2020-04-30,2,0,451,8,0.04529926694536597,0.017738359201773836,33,77
Asia,Jordan,9956011,2020-05-01,2,0,453,8,0.045500150612529454,0.017660044150110375,34,77
Asia,Jordan,9956011,2020-05-02,6,0,459,8,0.04610280161401992,0.017429193899782137,35,77
Asia,Jordan,9956011,2020-05-03,1,1,460,9,0.046203243447601655,0.01956521739130435,36,77
Asia,Jordan,9956011,2020-05-04,1,0,461,9,0.04630368528118339,0.019522776572668113,37,77
Asia,Jordan,9956011,2020-05-05,4,0,465,9,0.046705452615510366,0.01935483870967742,38,77
Asia,Jordan,9956011,2020-05-06,6,0,471,9,0.04730810361700082,0.01910828025477707,39,77
Asia,Jordan,9956011,2020-05-07,2,0,473,9,0.04750898728416431,0.019027484143763214,40,77
Asia,Jordan,9956011,2020-05-08,21,0,494,9,0.04961826578938091,0.018218623481781375,41,77
Asia,Jordan,9956011,2020-05-09,14,0,508,9,0.051024451459525305,0.017716535433070866,42,77
Asia,Jordan,9956011,2020-05-10,14,0,522,9,0.05243063712966971,0.017241379310344827,43,77
Asia,Jordan,9956011,2020-05-11,18,0,540,9,0.054238590134141076,0.016666666666666666,44,77
Asia,Jordan,9956011,2020-05-12,22,0,562,9,0.05644831047293941,0.01601423487544484,45,77
Asia,Jordan,9956011,2020-05-13,14,0,576,9,0.05785449614308381,0.015625,46,77
Asia,Jordan,9956011,2020-05-14,6,0,582,9,0.05845714714457427,0.015463917525773196,47,77
Asia,Jordan,9956011,2020-05-15,4,0,586,9,0.058858914478901236,0.015358361774744027,48,77
Asia,Jordan,9956011,2020-05-16,10,0,596,9,0.059863332814718666,0.015100671140939598,49,77
Asia,Jordan,9956011,2020-05-17,11,0,607,9,0.06096819298411784,0.014827018121911038,50,77
Asia,Jordan,9956011,2020-05-18,6,0,613,9,0.061570843985608296,0.01468189233278956,51,77
Asia,Jordan,9956011,2020-05-19,16,0,629,9,0.06317791332291618,0.014308426073131956,52,77
Asia,Jordan,9956011,2020-05-20,20,0,649,9,0.06518674999455103,0.01386748844375963,53,77
Asia,Jordan,9956011,2020-05-21,23,0,672,9,0.06749691216693111,0.013392857142857142,54,77
Asia,Jordan,9956011,2020-05-22,12,0,684,9,0.06870221416991203,0.013157894736842105,55,77
Asia,Jordan,9956011,2020-05-23,16,0,700,9,0.0703092835072199,0.012857142857142857,56,77
Asia,Jordan,9956011,2020-05-24,4,0,704,9,0.07071105084154689,0.01278409090909091,57,77
Asia,Jordan,9956011,2020-05-25,4,0,708,9,0.07111281817587385,0.012711864406779662,58,77
Asia,Jordan,9956011,2020-05-26,3,0,711,9,0.07141414367661908,0.012658227848101266,59,77
Asia,Jordan,9956011,2020-05-27,7,0,718,9,0.07211723651169129,0.012534818941504178,60,77
Asia,Kazakhstan,18276499,2020-04-03,38,1,386,3,0.02112001866440613,0.007772020725388601,0,78
Asia,Kazakhstan,18276499,2020-04-04,74,0,460,3,0.025168934159654977,0.006521739130434782,1,78
Asia,Kazakhstan,18276499,2020-04-05,0,0,460,3,0.025168934159654977,0.006521739130434782,2,78
Asia,Kazakhstan,18276499,2020-04-06,71,2,531,5,0.02905370443212346,0.009416195856873822,3,78
Asia,Kazakhstan,18276499,2020-04-07,139,1,670,6,0.036659099754280076,0.008955223880597015,4,78
Asia,Kazakhstan,18276499,2020-04-08,34,0,704,6,0.038519412279124136,0.008522727272727272,5,78
Asia,Kazakhstan,18276499,2020-04-09,55,1,759,7,0.04152874136343071,0.00922266139657444,6,78
Asia,Kazakhstan,18276499,2020-04-10,43,2,802,9,0.043881489556615846,0.011221945137157107,7,78
Asia,Kazakhstan,18276499,2020-04-11,38,1,840,10,0.04596066237850039,0.011904761904761904,8,78
Asia,Kazakhstan,18276499,2020-04-12,40,0,880,10,0.04814926534890517,0.011363636363636364,9,78
Asia,Kazakhstan,18276499,2020-04-13,81,0,961,10,0.05258118636397485,0.01040582726326743,10,78
Asia,Kazakhstan,18276499,2020-04-14,218,4,1179,14,0.0645090725526809,0.011874469889737066,11,78
Asia,Kazakhstan,18276499,2020-04-15,88,0,1267,14,0.06932399908757142,0.011049723756906077,12,78
Asia,Kazakhstan,18276499,2020-04-16,64,2,1331,16,0.07282576384021908,0.012021036814425245,13,78
Asia,Kazakhstan,18276499,2020-04-17,139,1,1470,17,0.08043115916237568,0.011564625850340135,14,78
Asia,Kazakhstan,18276499,2020-04-18,121,0,1591,17,0.08705168314785014,0.010685103708359522,15,78
Asia,Kazakhstan,18276499,2020-04-19,63,0,1654,17,0.09049873282623767,0.010278113663845224,16,78
Asia,Kazakhstan,18276499,2020-04-20,81,2,1735,19,0.09493065384130735,0.01095100864553314,17,78
Asia,Kazakhstan,18276499,2020-04-21,214,0,1949,19,0.10663967973297293,0.009748589020010261,18,78
Asia,Kazakhstan,18276499,2020-04-22,76,0,2025,19,0.11079802537674201,0.009382716049382716,19,78
Asia,Kazakhstan,18276499,2020-04-23,166,0,2191,19,0.11988072770392184,0.00867183934276586,20,78
Asia,Kazakhstan,18276499,2020-04-24,143,3,2334,22,0.12770498332311894,0.009425878320479864,21,78
Asia,Kazakhstan,18276499,2020-04-25,148,3,2482,25,0.13580281431361663,0.010072522159548751,22,78
Asia,Kazakhstan,18276499,2020-04-26,170,0,2652,25,0.14510437693783693,0.00942684766214178,23,78
Asia,Kazakhstan,18276499,2020-04-27,65,0,2717,25,0.14866085676474472,0.009201324990798674,24,78
Asia,Kazakhstan,18276499,2020-04-28,143,0,2860,25,0.1564851123839418,0.008741258741258742,25,78
Asia,Kazakhstan,18276499,2020-04-29,203,0,3063,25,0.16759227245874606,0.008161932745674175,26,78
Asia,Kazakhstan,18276499,2020-04-30,142,0,3205,25,0.17536181300368303,0.0078003120124804995,27,78
Asia,Kazakhstan,18276499,2020-05-01,299,0,3504,25,0.19172162020745878,0.007134703196347032,28,78
Asia,Kazakhstan,18276499,2020-05-02,167,0,3671,25,0.20085903760889873,0.006810133478616181,29,78
Asia,Kazakhstan,18276499,2020-05-03,206,0,3877,25,0.21213034290648333,0.006448284756254836,30,78
Asia,Kazakhstan,18276499,2020-05-04,87,2,3964,27,0.21689055436711377,0.006811301715438951,31,78
Asia,Kazakhstan,18276499,2020-05-05,157,2,4121,29,0.22548082102595252,0.007037126910943946,32,78
Asia,Kazakhstan,18276499,2020-05-06,156,0,4277,29,0.23401637261053115,0.006780453588964227,33,78
Asia,Kazakhstan,18276499,2020-05-07,225,1,4502,30,0.24632726431905802,0.006663705019991115,34,78
Asia,Kazakhstan,18276499,2020-05-08,188,1,4690,31,0.25661369827996056,0.006609808102345416,35,78
Asia,Kazakhstan,18276499,2020-05-09,144,0,4834,31,0.2644926689734177,0.006412908564335954,36,78
Asia,Kazakhstan,18276499,2020-05-10,202,0,5036,31,0.27554511397396186,0.006155679110405083,37,78
Asia,Kazakhstan,18276499,2020-05-11,90,0,5126,31,0.2804694706573726,0.006047600468201327,38,78
Asia,Kazakhstan,18276499,2020-05-12,114,1,5240,32,0.2867069891230262,0.0061068702290076335,39,78
Asia,Kazakhstan,18276499,2020-05-13,177,0,5417,32,0.2963915572670674,0.005907328779767399,40,78
Asia,Kazakhstan,18276499,2020-05-14,154,0,5571,32,0.3048176787031258,0.005744031592173757,41,78
Asia,Kazakhstan,18276499,2020-05-15,0,0,5571,32,0.3048176787031258,0.005744031592173757,42,78
Asia,Kazakhstan,18276499,2020-05-16,279,2,5850,34,0.32008318442169914,0.005811965811965812,43,78
Asia,Kazakhstan,18276499,2020-05-17,307,0,6157,34,0.33688071221955584,0.0055221698879324346,44,78
Asia,Kazakhstan,18276499,2020-05-18,283,0,6440,34,0.35236507823516966,0.005279503105590062,45,78
Asia,Kazakhstan,18276499,2020-05-19,311,1,6751,35,0.3693814663300668,0.005184417123389127,46,78
Asia,Kazakhstan,18276499,2020-05-20,218,0,6969,35,0.3813093525187729,0.00502224135457024,47,78
Asia,Kazakhstan,18276499,2020-05-21,265,0,7234,35,0.39580884719770454,0.004838263754492674,48,78
Asia,Kazakhstan,18276499,2020-05-22,363,0,7597,35,0.41567041915412795,0.004607081742793208,49,78
Asia,Kazakhstan,18276499,2020-05-23,322,0,7919,35,0.4332886730658864,0.004419749968430357,50,78
Asia,Kazakhstan,18276499,2020-05-24,403,0,8322,35,0.45533884799271457,0.004205719778899303,51,78
Asia,Kazakhstan,18276499,2020-05-25,209,0,8531,35,0.46677429851307956,0.004102684327745868,52,78
Asia,Kazakhstan,18276499,2020-05-26,438,0,8969,35,0.4907395010390119,0.0039023302486341843,53,78
Asia,Kazakhstan,18276499,2020-05-27,335,2,9304,37,0.509069050916152,0.003976784178847808,54,78
Europe,Kosovo,1845300,2020-03-24,30,0,61,1,0.03305695550858939,0.01639344262295082,0,79
Europe,Kosovo,1845300,2020-03-25,2,0,63,1,0.034140790115428386,0.015873015873015872,1,79
Europe,Kosovo,1845300,2020-03-26,8,0,71,1,0.03847612854278437,0.014084507042253521,2,79
Europe,Kosovo,1845300,2020-03-27,8,0,79,1,0.042811466970140356,0.012658227848101266,3,79
Europe,Kosovo,1845300,2020-03-28,7,0,86,1,0.04660488809407685,0.011627906976744186,4,79
Europe,Kosovo,1845300,2020-03-29,2,0,88,1,0.04768872270091584,0.011363636363636364,5,79
Europe,Kosovo,1845300,2020-03-30,3,0,91,1,0.04931447461117433,0.01098901098901099,6,79
Europe,Kosovo,1845300,2020-03-31,15,0,106,1,0.05744323416246681,0.009433962264150943,7,79
Europe,Kosovo,1845300,2020-04-01,6,0,112,1,0.0606947379829838,0.008928571428571428,8,79
Europe,Kosovo,1845300,2020-04-02,0,0,112,1,0.0606947379829838,0.008928571428571428,9,79
Europe,Kosovo,1845300,2020-04-03,13,0,125,1,0.06773966292743729,0.008,10,79
Europe,Kosovo,1845300,2020-04-04,1,0,126,1,0.06828158023085677,0.007936507936507936,11,79
Europe,Kosovo,1845300,2020-04-05,6,0,132,1,0.07153308405137376,0.007575757575757576,12,79
Europe,Kosovo,1845300,2020-04-06,8,0,140,1,0.07586842247872974,0.007142857142857143,13,79
Europe,Kosovo,1845300,2020-04-07,5,2,145,3,0.07857800899582724,0.020689655172413793,14,79
Europe,Kosovo,1845300,2020-04-08,39,2,184,5,0.09971278382918768,0.02717391304347826,15,79
Europe,Kosovo,1845300,2020-04-09,0,0,184,5,0.09971278382918768,0.02717391304347826,16,79
Europe,Kosovo,1845300,2020-04-10,43,2,227,7,0.12301522787622608,0.030837004405286344,17,79
Europe,Kosovo,1845300,2020-04-11,23,0,250,7,0.13547932585487457,0.028,18,79
Europe,Kosovo,1845300,2020-04-12,33,0,283,7,0.153362596867718,0.024734982332155476,19,79
Europe,Kosovo,1845300,2020-04-13,79,0,362,7,0.19617406383785835,0.019337016574585635,20,79
Europe,Kosovo,1845300,2020-04-14,15,1,377,8,0.20430282338915082,0.021220159151193633,21,79
Europe,Kosovo,1845300,2020-04-15,10,0,387,8,0.2097219964233458,0.020671834625323,22,79
Europe,Kosovo,1845300,2020-04-16,36,1,423,9,0.22923101934644774,0.02127659574468085,23,79
Europe,Kosovo,1845300,2020-04-17,26,2,449,11,0.2433208692353547,0.024498886414253896,24,79
Europe,Kosovo,1845300,2020-04-18,31,1,480,12,0.26012030564135913,0.025,25,79
Europe,Kosovo,1845300,2020-04-19,30,0,510,12,0.27637782474394407,0.023529411764705882,26,79
Europe,Kosovo,1845300,2020-04-20,0,0,510,12,0.27637782474394407,0.023529411764705882,27,79
Europe,Kosovo,1845300,2020-04-21,88,3,598,15,0.3240665474448599,0.02508361204013378,28,79
Europe,Kosovo,1845300,2020-04-22,6,3,604,18,0.32731805126537694,0.029801324503311258,29,79
Europe,Kosovo,1845300,2020-04-23,26,0,630,18,0.3414079011542839,0.02857142857142857,30,79
Europe,Kosovo,1845300,2020-04-24,39,1,669,19,0.3625426759876443,0.028400597907324365,31,79
Europe,Kosovo,1845300,2020-04-25,34,0,703,19,0.3809678643039072,0.02702702702702703,32,79
Europe,Kosovo,1845300,2020-04-26,28,1,731,20,0.39614154879965313,0.027359781121751026,33,79
Europe,Kosovo,1845300,2020-04-27,32,1,763,21,0.41348290250907715,0.027522935779816515,34,79
Europe,Kosovo,1845300,2020-04-28,17,1,780,22,0.42269549666720857,0.028205128205128206,35,79
Europe,Kosovo,1845300,2020-04-29,10,0,790,22,0.42811466970140355,0.027848101265822784,36,79
Europe,Kosovo,1845300,2020-04-30,9,0,799,22,0.43299192543217907,0.02753441802252816,37,79
Europe,Kosovo,1845300,2020-05-01,0,0,799,22,0.43299192543217907,0.02753441802252816,38,79
Europe,Kosovo,1845300,2020-05-02,14,0,813,22,0.440578767680052,0.02706027060270603,39,79
Europe,Kosovo,1845300,2020-05-03,10,0,823,22,0.44599794071424703,0.026731470230862697,40,79
Europe,Kosovo,1845300,2020-05-04,28,0,851,22,0.46117162520999294,0.025851938895417155,41,79
Europe,Kosovo,1845300,2020-05-05,4,4,855,26,0.46333929442367094,0.0304093567251462,42,79
Europe,Kosovo,1845300,2020-05-06,1,0,856,26,0.4638812117270904,0.030373831775700934,43,79
Europe,Kosovo,1845300,2020-05-07,4,0,860,26,0.46604888094076846,0.030232558139534883,44,79
Europe,Kosovo,1845300,2020-05-08,1,1,861,27,0.4665907982441879,0.0313588850174216,45,79
Europe,Kosovo,1845300,2020-05-09,1,1,862,28,0.46713271554760744,0.03248259860788863,46,79
Europe,Kosovo,1845300,2020-05-10,8,0,870,28,0.4714680539749634,0.03218390804597701,47,79
Europe,Kosovo,1845300,2020-05-11,0,0,870,28,0.4714680539749634,0.03218390804597701,48,79
Europe,Kosovo,1845300,2020-05-12,14,0,884,28,0.4790548962228364,0.03167420814479638,49,79
Europe,Kosovo,1845300,2020-05-13,35,1,919,29,0.4980220018425188,0.031556039173014146,50,79
Europe,Kosovo,1845300,2020-05-14,0,0,919,29,0.4980220018425188,0.031556039173014146,51,79
Europe,Kosovo,1845300,2020-05-15,25,0,944,29,0.5115699344280062,0.03072033898305085,52,79
Europe,Kosovo,1845300,2020-05-16,0,0,944,29,0.5115699344280062,0.03072033898305085,53,79
Europe,Kosovo,1845300,2020-05-17,0,0,944,29,0.5115699344280062,0.03072033898305085,54,79
Europe,Kosovo,1845300,2020-05-18,11,0,955,29,0.5175310247656207,0.030366492146596858,55,79
Europe,Kosovo,1845300,2020-05-19,0,0,955,29,0.5175310247656207,0.030366492146596858,56,79
Europe,Kosovo,1845300,2020-05-20,34,0,989,29,0.5359562130818837,0.029322548028311426,57,79
Europe,Kosovo,1845300,2020-05-21,0,0,989,29,0.5359562130818837,0.029322548028311426,58,79
Europe,Kosovo,1845300,2020-05-22,14,0,1003,29,0.5435430553297567,0.028913260219341975,59,79
Europe,Kosovo,1845300,2020-05-23,1,0,1004,29,0.5440849726331761,0.02888446215139442,60,79
Europe,Kosovo,1845300,2020-05-24,21,0,1025,29,0.5554652360049857,0.02829268292682927,61,79
Europe,Kosovo,1845300,2020-05-25,7,0,1032,29,0.5592586571289221,0.02810077519379845,62,79
Europe,Kosovo,1845300,2020-05-26,6,1,1038,30,0.5625101609494391,0.028901734104046242,63,79
Europe,Kosovo,1845300,2020-05-27,0,0,1038,30,0.5625101609494391,0.028901734104046242,64,79
Asia,Kuwait,4137309,2020-03-14,20,0,100,0,0.024170300067024243,0,0,80
Asia,Kuwait,4137309,2020-03-15,4,0,104,0,0.02513711206970521,0,1,80
Asia,Kuwait,4137309,2020-03-16,8,0,112,0,0.02707073607506715,0,2,80
Asia,Kuwait,4137309,2020-03-17,11,0,123,0,0.029729469082439817,0,3,80
Asia,Kuwait,4137309,2020-03-18,7,0,130,0,0.03142139008713152,0,4,80
Asia,Kuwait,4137309,2020-03-19,12,0,142,0,0.034321826095174424,0,5,80
Asia,Kuwait,4137309,2020-03-20,6,0,148,0,0.03577204409919588,0,6,80
Asia,Kuwait,4137309,2020-03-21,11,0,159,0,0.038430777106568545,0,7,80
Asia,Kuwait,4137309,2020-03-22,17,0,176,0,0.042539728117962666,0,8,80
Asia,Kuwait,4137309,2020-03-23,12,0,188,0,0.04544016412600558,0,9,80
Asia,Kuwait,4137309,2020-03-24,1,0,189,0,0.045681867126675824,0,10,80
Asia,Kuwait,4137309,2020-03-25,2,0,191,0,0.0461652731280163,0,11,80
Asia,Kuwait,4137309,2020-03-26,4,0,195,0,0.04713208513069728,0,12,80
Asia,Kuwait,4137309,2020-03-27,13,0,208,0,0.05027422413941042,0,13,80
Asia,Kuwait,4137309,2020-03-28,17,0,225,0,0.05438317515080454,0,14,80
Asia,Kuwait,4137309,2020-03-29,10,0,235,0,0.056800205157506965,0,15,80
Asia,Kuwait,4137309,2020-03-30,20,0,255,0,0.06163426517091181,0,16,80
Asia,Kuwait,4137309,2020-03-31,11,0,266,0,0.06429299817828447,0,17,80
Asia,Kuwait,4137309,2020-04-01,23,0,289,0,0.06985216719370005,0,18,80
Asia,Kuwait,4137309,2020-04-02,28,0,317,0,0.07661985121246685,0,19,80
Asia,Kuwait,4137309,2020-04-03,25,0,342,0,0.08266242622922292,0,20,80
Asia,Kuwait,4137309,2020-04-04,0,0,342,0,0.08266242622922292,0,21,80
Asia,Kuwait,4137309,2020-04-05,137,1,479,1,0.11577573732104612,0.0020876826722338203,22,80
Asia,Kuwait,4137309,2020-04-06,77,0,556,1,0.13438686837265476,0.0017985611510791368,23,80
Asia,Kuwait,4137309,2020-04-07,109,0,665,1,0.16073249544571122,0.0015037593984962407,24,80
Asia,Kuwait,4137309,2020-04-08,78,0,743,1,0.17958532949799014,0.0013458950201884253,25,80
Asia,Kuwait,4137309,2020-04-09,112,0,855,1,0.20665606557305727,0.0011695906432748538,26,80
Asia,Kuwait,4137309,2020-04-10,55,0,910,1,0.2199497306099206,0.001098901098901099,27,80
Asia,Kuwait,4137309,2020-04-11,83,0,993,1,0.24001107966555074,0.0010070493454179255,28,80
Asia,Kuwait,4137309,2020-04-12,161,0,1154,1,0.27892526277345975,8.665511265164644e-4,29,80
Asia,Kuwait,4137309,2020-04-13,80,0,1234,1,0.29826150282707914,8.103727714748784e-4,30,80
Asia,Kuwait,4137309,2020-04-14,66,1,1300,2,0.3142139008713151,0.0015384615384615385,31,80
Asia,Kuwait,4137309,2020-04-15,55,1,1355,3,0.3275075659081785,0.002214022140221402,32,80
Asia,Kuwait,4137309,2020-04-16,50,0,1405,3,0.3395927159416906,0.002135231316725979,33,80
Asia,Kuwait,4137309,2020-04-17,119,0,1524,3,0.36835537302144944,0.001968503937007874,34,80
Asia,Kuwait,4137309,2020-04-18,134,2,1658,5,0.40074357511126196,0.0030156815440289505,35,80
Asia,Kuwait,4137309,2020-04-19,94,1,1752,6,0.4234636571742647,0.003424657534246575,36,80
Asia,Kuwait,4137309,2020-04-20,163,1,1915,7,0.4628612462835142,0.0036553524804177544,37,80
Asia,Kuwait,4137309,2020-04-21,80,2,1995,9,0.4821974863371336,0.004511278195488722,38,80
Asia,Kuwait,4137309,2020-04-22,85,2,2080,11,0.5027422413941043,0.005288461538461539,39,80
Asia,Kuwait,4137309,2020-04-23,168,2,2248,13,0.543348345506705,0.005782918149466192,40,80
Asia,Kuwait,4137309,2020-04-24,151,1,2399,14,0.5798454986079116,0.005835764902042517,41,80
Asia,Kuwait,4137309,2020-04-25,215,1,2614,15,0.6318116437520136,0.005738332058148432,42,80
Asia,Kuwait,4137309,2020-04-26,278,4,2892,19,0.6990050779383411,0.00656984785615491,43,80
Asia,Kuwait,4137309,2020-04-27,183,1,3075,20,0.7432367270609955,0.0065040650406504065,44,80
Asia,Kuwait,4137309,2020-04-28,213,2,3288,22,0.7947194662037571,0.006690997566909975,45,80
Asia,Kuwait,4137309,2020-04-29,152,1,3440,23,0.8314583223056339,0.006686046511627907,46,80
Asia,Kuwait,4137309,2020-04-30,300,1,3740,24,0.9039692225067066,0.006417112299465241,47,80
Asia,Kuwait,4137309,2020-05-01,284,2,4024,26,0.9726128746970555,0.0064612326043737576,48,80
Asia,Kuwait,4137309,2020-05-02,353,4,4377,30,1.057934033933651,0.006854009595613434,49,80
Asia,Kuwait,4137309,2020-05-03,242,3,4619,33,1.1164261600958498,0.007144403550552067,50,80
Asia,Kuwait,4137309,2020-05-04,364,5,4983,38,1.204406052339818,0.00762592815572948,51,80
Asia,Kuwait,4137309,2020-05-05,295,2,5278,40,1.2757084375375396,0.007578628268283441,52,80
Asia,Kuwait,4137309,2020-05-06,526,0,5804,40,1.402844215890087,0.006891798759476223,53,80
Asia,Kuwait,4137309,2020-05-07,485,2,6289,42,1.5200701712151545,0.0066783272380346636,54,80
Asia,Kuwait,4137309,2020-05-08,278,2,6567,44,1.587263605401482,0.006700167504187605,55,80
Asia,Kuwait,4137309,2020-05-09,641,3,7208,47,1.7421952288311076,0.006520532741398446,56,80
Asia,Kuwait,4137309,2020-05-10,415,2,7623,49,1.8425019741092579,0.006427915518824609,57,80
Asia,Kuwait,4137309,2020-05-11,1065,9,8688,58,2.099915669823066,0.006675874769797422,58,80
Asia,Kuwait,4137309,2020-05-12,598,7,9286,65,2.244454064223871,0.006999784622011631,59,80
Asia,Kuwait,4137309,2020-05-13,991,10,10277,75,2.4839817378880813,0.007297849566994259,60,80
Asia,Kuwait,4137309,2020-05-14,751,7,11028,82,2.6655006913914336,0.007435618425825173,61,80
Asia,Kuwait,4137309,2020-05-15,947,6,11975,88,2.894393433026153,0.007348643006263048,62,80
Asia,Kuwait,4137309,2020-05-16,885,8,12860,96,3.1083005886193176,0.007465007776049767,63,80
Asia,Kuwait,4137309,2020-05-17,942,11,13802,107,3.335984815250686,0.007752499637733661,64,80
Asia,Kuwait,4137309,2020-05-18,1048,5,14850,112,3.5892895599531,0.007542087542087542,65,80
Asia,Kuwait,4137309,2020-05-19,841,6,15691,118,3.7925617835167738,0.007520234529348034,66,80
Asia,Kuwait,4137309,2020-05-20,1073,3,16764,121,4.0519091032359444,0.007217847769028871,67,80
Asia,Kuwait,4137309,2020-05-21,804,3,17568,124,4.246238315774819,0.007058287795992714,68,80
Asia,Kuwait,4137309,2020-05-22,1041,5,18609,129,4.497851139472541,0.006932129614702564,69,80
Asia,Kuwait,4137309,2020-05-23,955,9,19564,138,4.728677505112622,0.0070537722347168265,70,80
Asia,Kuwait,4137309,2020-05-24,900,10,20464,148,4.946210205715841,0.007232212666145426,71,80
Asia,Kuwait,4137309,2020-05-25,838,8,21302,156,5.148757320277504,0.007323256032297437,72,80
Asia,Kuwait,4137309,2020-05-26,665,9,21967,165,5.309489815723215,0.007511266900350526,73,80
Asia,Kuwait,4137309,2020-05-27,608,7,22575,172,5.456445240130723,0.007619047619047619,74,80
Asia,Kyrgyzstan,6315800,2020-04-04,19,0,144,1,0.02279996200006333,0.006944444444444444,0,81
Asia,Kyrgyzstan,6315800,2020-04-05,0,0,144,1,0.02279996200006333,0.006944444444444444,1,81
Asia,Kyrgyzstan,6315800,2020-04-06,72,3,216,4,0.034199943000095,0.018518518518518517,2,81
Asia,Kyrgyzstan,6315800,2020-04-07,12,0,228,4,0.03609993983343361,0.017543859649122806,3,81
Asia,Kyrgyzstan,6315800,2020-04-08,42,0,270,4,0.04274992875011875,0.014814814814814815,4,81
Asia,Kyrgyzstan,6315800,2020-04-09,10,0,280,4,0.04433325944456759,0.014285714285714285,5,81
Asia,Kyrgyzstan,6315800,2020-04-10,18,1,298,5,0.04718325469457551,0.016778523489932886,6,81
Asia,Kyrgyzstan,6315800,2020-04-11,41,0,339,5,0.053674910541815765,0.014749262536873156,7,81
Asia,Kyrgyzstan,6315800,2020-04-12,38,0,377,5,0.05969156718072136,0.013262599469496022,8,81
Asia,Kyrgyzstan,6315800,2020-04-13,42,0,419,5,0.06634155609740651,0.011933174224343675,9,81
Asia,Kyrgyzstan,6315800,2020-04-14,11,0,430,5,0.06808321986130023,0.011627906976744186,10,81
Asia,Kyrgyzstan,6315800,2020-04-15,19,0,449,5,0.07109154818075303,0.011135857461024499,11,81
Asia,Kyrgyzstan,6315800,2020-04-16,17,0,466,5,0.07378321036131606,0.01072961373390558,12,81
Asia,Kyrgyzstan,6315800,2020-04-17,23,0,489,5,0.0774248709585484,0.010224948875255624,13,81
Asia,Kyrgyzstan,6315800,2020-04-18,17,0,506,5,0.08011653313911143,0.009881422924901186,14,81
Asia,Kyrgyzstan,6315800,2020-04-19,48,0,554,5,0.08771652047246588,0.009025270758122744,15,81
Asia,Kyrgyzstan,6315800,2020-04-20,14,2,568,7,0.08993318344469425,0.01232394366197183,16,81
Asia,Kyrgyzstan,6315800,2020-04-21,22,0,590,7,0.09341651097248171,0.011864406779661017,17,81
Asia,Kyrgyzstan,6315800,2020-04-22,22,0,612,7,0.09689983850026918,0.011437908496732025,18,81
Asia,Kyrgyzstan,6315800,2020-04-23,19,1,631,8,0.09990816681972196,0.012678288431061807,19,81
Asia,Kyrgyzstan,6315800,2020-04-24,25,0,656,8,0.10386649355584407,0.012195121951219513,20,81
Asia,Kyrgyzstan,6315800,2020-04-25,9,0,665,8,0.10529149118084803,0.012030075187969926,21,81
Asia,Kyrgyzstan,6315800,2020-04-26,17,0,682,8,0.10798315336141107,0.011730205278592375,22,81
Asia,Kyrgyzstan,6315800,2020-04-27,13,0,695,8,0.11004148326419455,0.011510791366906475,23,81
Asia,Kyrgyzstan,6315800,2020-04-28,13,0,708,8,0.11209981316697806,0.011299435028248588,24,81
Asia,Kyrgyzstan,6315800,2020-04-29,21,0,729,8,0.11542480762532062,0.010973936899862825,25,81
Asia,Kyrgyzstan,6315800,2020-04-30,17,0,746,8,0.11811646980588365,0.010723860589812333,26,81
Asia,Kyrgyzstan,6315800,2020-05-01,0,0,746,8,0.11811646980588365,0.010723860589812333,27,81
Asia,Kyrgyzstan,6315800,2020-05-02,23,0,769,8,0.12175813040311599,0.010403120936280884,28,81
Asia,Kyrgyzstan,6315800,2020-05-03,26,2,795,10,0.12587479020868297,0.012578616352201259,29,81
Asia,Kyrgyzstan,6315800,2020-05-04,35,0,830,10,0.13141644763925392,0.012048192771084338,30,81
Asia,Kyrgyzstan,6315800,2020-05-05,13,1,843,11,0.13347477754203743,0.013048635824436536,31,81
Asia,Kyrgyzstan,6315800,2020-05-06,28,1,871,12,0.13790810348649418,0.013777267508610792,32,81
Asia,Kyrgyzstan,6315800,2020-05-07,24,0,895,12,0.1417080971531714,0.013407821229050279,33,81
Asia,Kyrgyzstan,6315800,2020-05-08,11,0,906,12,0.14344976091706516,0.013245033112582781,34,81
Asia,Kyrgyzstan,6315800,2020-05-09,25,0,931,12,0.14740808765318725,0.01288936627282492,35,81
Asia,Kyrgyzstan,6315800,2020-05-10,71,0,1002,12,0.15864973558377404,0.011976047904191617,36,81
Asia,Kyrgyzstan,6315800,2020-05-11,14,0,1016,12,0.1608663985560024,0.011811023622047244,37,81
Asia,Kyrgyzstan,6315800,2020-05-12,21,0,1037,12,0.16419139301434496,0.011571841851494697,38,81
Asia,Kyrgyzstan,6315800,2020-05-13,7,0,1044,12,0.16529972450045916,0.011494252873563218,39,81
Asia,Kyrgyzstan,6315800,2020-05-14,38,0,1082,12,0.1713163811393648,0.011090573012939002,40,81
Asia,Kyrgyzstan,6315800,2020-05-15,29,2,1111,14,0.17590804015326642,0.012601260126012601,41,81
Asia,Kyrgyzstan,6315800,2020-05-16,6,0,1117,14,0.1768580385699357,0.012533572068039392,42,81
Asia,Kyrgyzstan,6315800,2020-05-17,21,0,1138,14,0.1801830330282783,0.012302284710017574,43,81
Asia,Kyrgyzstan,6315800,2020-05-18,78,0,1216,14,0.19253301244497925,0.011513157894736841,44,81
Asia,Kyrgyzstan,6315800,2020-05-19,27,0,1243,14,0.19680800531999115,0.011263073209975865,45,81
Asia,Kyrgyzstan,6315800,2020-05-20,27,0,1270,14,0.201082998195003,0.011023622047244094,46,81
Asia,Kyrgyzstan,6315800,2020-05-21,43,0,1313,14,0.20789132018113302,0.010662604722010662,47,81
Asia,Kyrgyzstan,6315800,2020-05-22,37,0,1350,14,0.21374964375059374,0.01037037037037037,48,81
Asia,Kyrgyzstan,6315800,2020-05-23,14,0,1364,14,0.21596630672282213,0.010263929618768328,49,81
Asia,Kyrgyzstan,6315800,2020-05-24,39,0,1403,14,0.2221412964311726,0.009978617248752673,50,81
Asia,Kyrgyzstan,6315800,2020-05-25,30,2,1433,16,0.22689128851451915,0.011165387299371946,51,81
Asia,Kyrgyzstan,6315800,2020-05-26,35,0,1468,16,0.2324329459450901,0.010899182561307902,52,81
Asia,Kyrgyzstan,6315800,2020-05-27,52,0,1520,16,0.24066626555622406,0.010526315789473684,53,81
Europe,Latvia,1926542,2020-03-18,25,0,61,0,0.03166294843299549,0,0,82
Europe,Latvia,1926542,2020-03-19,10,0,71,0,0.03685359571709312,0,1,82
Europe,Latvia,1926542,2020-03-20,15,0,86,0,0.044639566643239544,0,2,82
Europe,Latvia,1926542,2020-03-21,25,0,111,0,0.0576161848534836,0,3,82
Europe,Latvia,1926542,2020-03-22,13,0,124,0,0.0643640263228105,0,4,82
Europe,Latvia,1926542,2020-03-23,15,0,139,0,0.07214999724895693,0,5,82
Europe,Latvia,1926542,2020-03-24,41,0,180,0,0.09343165111375719,0,6,82
Europe,Latvia,1926542,2020-03-25,17,0,197,0,0.10225575149672314,0,7,82
Europe,Latvia,1926542,2020-03-26,24,0,221,0,0.11471330497855743,0,8,82
Europe,Latvia,1926542,2020-03-27,23,0,244,0,0.12665179373198196,0,9,82
Europe,Latvia,1926542,2020-03-28,36,0,280,0,0.1453381239547334,0,10,82
Europe,Latvia,1926542,2020-03-29,25,0,305,0,0.15831474216497746,0,11,82
Europe,Latvia,1926542,2020-03-30,71,0,376,0,0.19516833788207055,0,12,82
Europe,Latvia,1926542,2020-03-31,0,0,376,0,0.19516833788207055,0,13,82
Europe,Latvia,1926542,2020-04-01,22,0,398,0,0.20658776190708536,0,14,82
Europe,Latvia,1926542,2020-04-02,48,0,446,0,0.23150286887075394,0,15,82
Europe,Latvia,1926542,2020-04-03,12,0,458,0,0.23773164561167107,0,16,82
Europe,Latvia,1926542,2020-04-04,35,1,493,1,0.25589891110601276,0.002028397565922921,17,82
Europe,Latvia,1926542,2020-04-05,16,0,509,1,0.26420394676056896,0.0019646365422396855,18,82
Europe,Latvia,1926542,2020-04-06,24,0,533,1,0.2766615002424032,0.001876172607879925,19,82
Europe,Latvia,1926542,2020-04-07,9,0,542,1,0.28133308279809105,0.0018450184501845018,20,82
Europe,Latvia,1926542,2020-04-08,6,1,548,2,0.2844474711685497,0.0036496350364963502,21,82
Europe,Latvia,1926542,2020-04-09,29,0,577,2,0.29950034829243277,0.0034662045060658577,22,82
Europe,Latvia,1926542,2020-04-10,12,0,589,2,0.3057291250333499,0.003395585738539898,23,82
Europe,Latvia,1926542,2020-04-11,23,0,612,2,0.31766761378677444,0.0032679738562091504,24,82
Europe,Latvia,1926542,2020-04-12,18,1,630,3,0.32701077889815017,0.004761904761904762,25,82
Europe,Latvia,1926542,2020-04-13,21,2,651,5,0.33791113819475516,0.007680491551459293,26,82
Europe,Latvia,1926542,2020-04-14,4,0,655,5,0.3399873971083942,0.007633587786259542,27,82
Europe,Latvia,1926542,2020-04-15,2,0,657,5,0.34102552656521373,0.0076103500761035,28,82
Europe,Latvia,1926542,2020-04-16,9,0,666,5,0.3456971091209016,0.0075075075075075074,29,82
Europe,Latvia,1926542,2020-04-17,9,0,675,5,0.35036869167658946,0.007407407407407408,30,82
Europe,Latvia,1926542,2020-04-18,7,0,682,5,0.35400214477545783,0.007331378299120235,31,82
Europe,Latvia,1926542,2020-04-19,30,0,712,5,0.36957408662775065,0.007022471910112359,32,82
Europe,Latvia,1926542,2020-04-20,15,0,727,5,0.37736005755389707,0.0068775790921595595,33,82
Europe,Latvia,1926542,2020-04-21,12,0,739,5,0.3835888342948143,0.006765899864682003,34,82
Europe,Latvia,1926542,2020-04-22,9,4,748,9,0.3882604168505021,0.012032085561497326,35,82
Europe,Latvia,1926542,2020-04-23,13,2,761,11,0.395008258319829,0.01445466491458607,36,82
Europe,Latvia,1926542,2020-04-24,17,0,778,11,0.403832358702795,0.014138817480719794,37,82
Europe,Latvia,1926542,2020-04-25,6,1,784,12,0.4069467470732535,0.015306122448979591,38,82
Europe,Latvia,1926542,2020-04-26,20,0,804,12,0.41732804164144877,0.014925373134328358,39,82
Europe,Latvia,1926542,2020-04-27,8,0,812,12,0.42148055946872687,0.014778325123152709,40,82
Europe,Latvia,1926542,2020-04-28,6,1,818,13,0.42459494783918544,0.01589242053789731,41,82
Europe,Latvia,1926542,2020-04-29,18,0,836,13,0.43393811295056117,0.01555023923444976,42,82
Europe,Latvia,1926542,2020-04-30,13,2,849,15,0.44068595441988806,0.0176678445229682,43,82
Europe,Latvia,1926542,2020-05-01,9,0,858,15,0.44535753697557595,0.017482517482517484,44,82
Europe,Latvia,1926542,2020-05-02,12,1,870,16,0.45158631371649305,0.01839080459770115,45,82
Europe,Latvia,1926542,2020-05-03,1,0,871,16,0.45210537844490284,0.018369690011481057,46,82
Europe,Latvia,1926542,2020-05-04,8,0,879,16,0.45625789627218094,0.01820250284414107,47,82
Europe,Latvia,1926542,2020-05-05,17,0,896,16,0.4650819966551469,0.017857142857142856,48,82
Europe,Latvia,1926542,2020-05-06,0,1,896,17,0.4650819966551469,0.018973214285714284,49,82
Europe,Latvia,1926542,2020-05-07,4,0,900,17,0.46715825556878593,0.01888888888888889,50,82
Europe,Latvia,1926542,2020-05-08,9,1,909,18,0.47182983812447377,0.019801980198019802,51,82
Europe,Latvia,1926542,2020-05-09,19,0,928,18,0.48169206796425923,0.01939655172413793,52,82
Europe,Latvia,1926542,2020-05-10,2,0,930,18,0.4827301974210788,0.01935483870967742,53,82
Europe,Latvia,1926542,2020-05-11,9,0,939,18,0.48740177997676665,0.019169329073482427,54,82
Europe,Latvia,1926542,2020-05-12,7,0,946,18,0.49103523307563496,0.019027484143763214,55,82
Europe,Latvia,1926542,2020-05-13,4,0,950,18,0.49311149198927406,0.018947368421052633,56,82
Europe,Latvia,1926542,2020-05-14,1,1,951,19,0.4936305567176838,0.019978969505783387,57,82
Europe,Latvia,1926542,2020-05-15,11,0,962,19,0.4993402687301912,0.01975051975051975,58,82
Europe,Latvia,1926542,2020-05-16,8,0,970,19,0.5034927865574692,0.01958762886597938,59,82
Europe,Latvia,1926542,2020-05-17,27,0,997,19,0.5175075342245329,0.01905717151454363,60,82
Europe,Latvia,1926542,2020-05-18,11,0,1008,19,0.5232172462370402,0.018849206349206348,61,82
Europe,Latvia,1926542,2020-05-19,1,0,1009,19,0.52373631096545,0.018830525272547076,62,82
Europe,Latvia,1926542,2020-05-20,3,2,1012,21,0.5252935051506793,0.020750988142292492,63,82
Europe,Latvia,1926542,2020-05-21,4,0,1016,21,0.5273697640643183,0.02066929133858268,64,82
Europe,Latvia,1926542,2020-05-22,9,1,1025,22,0.5320413466200061,0.021463414634146343,65,82
Europe,Latvia,1926542,2020-05-23,5,0,1030,22,0.5346366702620551,0.021359223300970873,66,82
Europe,Latvia,1926542,2020-05-24,16,0,1046,22,0.5429417059166112,0.021032504780114723,67,82
Europe,Latvia,1926542,2020-05-25,1,0,1047,22,0.543460770645021,0.021012416427889206,68,82
Europe,Latvia,1926542,2020-05-26,2,0,1049,22,0.5444989001018405,0.020972354623450904,69,82
Europe,Latvia,1926542,2020-05-27,4,0,1053,22,0.5465751590154796,0.020892687559354226,70,82
Asia,Lebanon,6848925,2020-03-20,16,0,149,4,0.021755238960858823,0.026845637583892617,0,83
Asia,Lebanon,6848925,2020-03-21,14,0,163,4,0.02379935537328851,0.024539877300613498,1,83
Asia,Lebanon,6848925,2020-03-22,67,0,230,4,0.0335819124899163,0.017391304347826087,2,83
Asia,Lebanon,6848925,2020-03-23,18,0,248,4,0.03621006216304019,0.016129032258064516,3,83
Asia,Lebanon,6848925,2020-03-24,19,0,267,4,0.03898422015133762,0.0149812734082397,4,83
Asia,Lebanon,6848925,2020-03-25,37,0,304,4,0.04438652781275894,0.013157894736842105,5,83
Asia,Lebanon,6848925,2020-03-26,29,0,333,4,0.04862076895279186,0.012012012012012012,6,83
Asia,Lebanon,6848925,2020-03-27,35,2,368,6,0.053731059983866084,0.016304347826086956,7,83
Asia,Lebanon,6848925,2020-03-28,23,1,391,7,0.05708925123285771,0.017902813299232736,8,83
Asia,Lebanon,6848925,2020-03-29,21,1,412,8,0.06015542585150224,0.019417475728155338,9,83
Asia,Lebanon,6848925,2020-03-30,26,2,438,10,0.06395164204601453,0.0228310502283105,10,83
Asia,Lebanon,6848925,2020-03-31,8,1,446,11,0.06511970856740291,0.02466367713004484,11,83
Asia,Lebanon,6848925,2020-04-01,17,1,463,12,0.06760184992535324,0.02591792656587473,12,83
Asia,Lebanon,6848925,2020-04-02,16,0,479,12,0.06993798296813003,0.025052192066805846,13,83
Asia,Lebanon,6848925,2020-04-03,15,4,494,16,0.07212810769573327,0.032388663967611336,14,83
Asia,Lebanon,6848925,2020-04-04,0,0,494,16,0.07212810769573327,0.032388663967611336,15,83
Asia,Lebanon,6848925,2020-04-05,26,1,520,17,0.07592432389024555,0.032692307692307694,16,83
Asia,Lebanon,6848925,2020-04-06,7,1,527,18,0.07694638209646039,0.03415559772296015,17,83
Asia,Lebanon,6848925,2020-04-07,14,1,541,19,0.07899049850889008,0.03512014787430684,18,83
Asia,Lebanon,6848925,2020-04-08,7,0,548,19,0.08001255671510493,0.03467153284671533,19,83
Asia,Lebanon,6848925,2020-04-09,27,0,575,19,0.08395478122479075,0.03304347826086956,20,83
Asia,Lebanon,6848925,2020-04-10,7,0,582,19,0.08497683943100559,0.03264604810996564,21,83
Asia,Lebanon,6848925,2020-04-11,27,1,609,20,0.08891906394069142,0.03284072249589491,22,83
Asia,Lebanon,6848925,2020-04-12,10,0,619,20,0.0903791470924269,0.03231017770597738,23,83
Asia,Lebanon,6848925,2020-04-13,11,0,630,20,0.09198523855933595,0.031746031746031744,24,83
Asia,Lebanon,6848925,2020-04-14,2,0,632,20,0.09227725518968305,0.03164556962025317,25,83
Asia,Lebanon,6848925,2020-04-15,9,1,641,21,0.09359133002624499,0.0327613104524181,26,83
Asia,Lebanon,6848925,2020-04-16,17,0,658,21,0.09607347138419534,0.031914893617021274,27,83
Asia,Lebanon,6848925,2020-04-17,5,0,663,21,0.09680351296006308,0.03167420814479638,28,83
Asia,Lebanon,6848925,2020-04-18,5,0,668,21,0.09753355453593082,0.03143712574850299,29,83
Asia,Lebanon,6848925,2020-04-19,4,0,672,21,0.09811758779662502,0.03125,30,83
Asia,Lebanon,6848925,2020-04-20,1,0,673,21,0.09826359611179858,0.031203566121842496,31,83
Asia,Lebanon,6848925,2020-04-21,4,0,677,21,0.09884762937249277,0.0310192023633678,32,83
Asia,Lebanon,6848925,2020-04-22,0,0,677,21,0.09884762937249277,0.0310192023633678,33,83
Asia,Lebanon,6848925,2020-04-23,5,1,682,22,0.09957767094836051,0.03225806451612903,34,83
Asia,Lebanon,6848925,2020-04-24,6,0,688,22,0.10045372083940181,0.03197674418604651,35,83
Asia,Lebanon,6848925,2020-04-25,8,0,696,22,0.1016217873607902,0.031609195402298854,36,83
Asia,Lebanon,6848925,2020-04-26,8,2,704,24,0.1027898538821786,0.03409090909090909,37,83
Asia,Lebanon,6848925,2020-04-27,3,0,707,24,0.10322787882769924,0.033946251768033946,38,83
Asia,Lebanon,6848925,2020-04-28,3,0,710,24,0.10366590377321988,0.03380281690140845,39,83
Asia,Lebanon,6848925,2020-04-29,7,0,717,24,0.10468796197943474,0.03347280334728033,40,83
Asia,Lebanon,6848925,2020-04-30,4,0,721,24,0.10527199524012894,0.033287101248266296,41,83
Asia,Lebanon,6848925,2020-05-01,4,0,725,24,0.10585602850082312,0.03310344827586207,42,83
Asia,Lebanon,6848925,2020-05-02,4,0,729,24,0.10644006176151732,0.03292181069958848,43,83
Asia,Lebanon,6848925,2020-05-03,4,1,733,25,0.10702409502221152,0.034106412005457026,44,83
Asia,Lebanon,6848925,2020-05-04,4,0,737,25,0.10760812828290571,0.033921302578018994,45,83
Asia,Lebanon,6848925,2020-05-05,3,0,740,25,0.10804615322842635,0.033783783783783786,46,83
Asia,Lebanon,6848925,2020-05-06,1,0,741,25,0.10819216154359991,0.033738191632928474,47,83
Asia,Lebanon,6848925,2020-05-07,9,0,750,25,0.10950623638016185,0.03333333333333333,48,83
Asia,Lebanon,6848925,2020-05-08,34,0,784,25,0.11447051909606251,0.03188775510204082,49,83
Asia,Lebanon,6848925,2020-05-09,12,1,796,26,0.11622261887814511,0.032663316582914576,50,83
Asia,Lebanon,6848925,2020-05-10,13,0,809,26,0.11812072697540126,0.032138442521631644,51,83
Asia,Lebanon,6848925,2020-05-11,36,0,845,26,0.12337702632164903,0.03076923076923077,52,83
Asia,Lebanon,6848925,2020-05-12,14,0,859,26,0.1254211427340787,0.030267753201396973,53,83
Asia,Lebanon,6848925,2020-05-13,11,0,870,26,0.12702723420098774,0.029885057471264367,54,83
Asia,Lebanon,6848925,2020-05-14,8,0,878,26,0.12819530072237614,0.029612756264236904,55,83
Asia,Lebanon,6848925,2020-05-15,8,0,886,26,0.12936336724376452,0.029345372460496615,56,83
Asia,Lebanon,6848925,2020-05-16,5,0,891,26,0.13009340881963227,0.029180695847362513,57,83
Asia,Lebanon,6848925,2020-05-17,11,0,902,26,0.13169950028654132,0.028824833702882482,58,83
Asia,Lebanon,6848925,2020-05-18,9,0,911,26,0.13301357512310327,0.02854006586169045,59,83
Asia,Lebanon,6848925,2020-05-19,20,0,931,26,0.13593374142657424,0.027926960257787327,60,83
Asia,Lebanon,6848925,2020-05-20,23,0,954,26,0.13929193267556586,0.027253668763102725,61,83
Asia,Lebanon,6848925,2020-05-21,7,0,961,26,0.1403139908817807,0.027055150884495317,62,83
Asia,Lebanon,6848925,2020-05-22,63,0,1024,26,0.14951251473771432,0.025390625,63,83
Asia,Lebanon,6848925,2020-05-23,62,0,1086,26,0.15856503027847435,0.02394106813996317,64,83
Asia,Lebanon,6848925,2020-05-24,11,0,1097,26,0.16017112174538342,0.023701002734731084,65,83
Asia,Lebanon,6848925,2020-05-25,17,0,1114,26,0.16265326310333372,0.02333931777378815,66,83
Asia,Lebanon,6848925,2020-05-26,5,0,1119,26,0.16338330467920148,0.02323503127792672,67,83
Asia,Lebanon,6848925,2020-05-27,21,0,1140,26,0.166449479297846,0.02280701754385965,68,83
Africa,Liberia,4818977,2020-04-21,8,0,99,8,0.020543779312497238,0.08080808080808081,0,84
Africa,Liberia,4818977,2020-04-22,2,0,101,8,0.02095880515719415,0.07920792079207921,1,84
Africa,Liberia,4818977,2020-04-23,0,0,101,8,0.02095880515719415,0.07920792079207921,2,84
Africa,Liberia,4818977,2020-04-24,0,0,101,8,0.02095880515719415,0.07920792079207921,3,84
Africa,Liberia,4818977,2020-04-25,16,0,117,8,0.024279011914769465,0.06837606837606838,4,84
Africa,Liberia,4818977,2020-04-26,3,3,120,11,0.024901550681814832,0.09166666666666666,5,84
Africa,Liberia,4818977,2020-04-27,4,1,124,12,0.02573160237120866,0.0967741935483871,6,84
Africa,Liberia,4818977,2020-04-28,9,4,133,16,0.027599218672344772,0.12030075187969924,7,84
Africa,Liberia,4818977,2020-04-29,8,0,141,16,0.02925932205113243,0.11347517730496454,8,84
Africa,Liberia,4818977,2020-04-30,0,0,141,16,0.02925932205113243,0.11347517730496454,9,84
Africa,Liberia,4818977,2020-05-01,0,0,141,16,0.02925932205113243,0.11347517730496454,10,84
Africa,Liberia,4818977,2020-05-02,11,2,152,18,0.03154196419696546,0.11842105263157894,11,84
Africa,Liberia,4818977,2020-05-03,2,0,154,18,0.03195699004166237,0.11688311688311688,12,84
Africa,Liberia,4818977,2020-05-04,4,0,158,18,0.0327870417310562,0.11392405063291139,13,84
Africa,Liberia,4818977,2020-05-05,8,0,166,18,0.03444714510984385,0.10843373493975904,14,84
Africa,Liberia,4818977,2020-05-06,4,2,170,20,0.03527719679923768,0.11764705882352941,15,84
Africa,Liberia,4818977,2020-05-07,8,0,178,20,0.03693730017802534,0.11235955056179775,16,84
Africa,Liberia,4818977,2020-05-08,11,0,189,20,0.03921994232385836,0.10582010582010581,17,84
Africa,Liberia,4818977,2020-05-09,10,0,199,20,0.04129507154734293,0.10050251256281408,18,84
Africa,Liberia,4818977,2020-05-10,0,0,199,20,0.04129507154734293,0.10050251256281408,19,84
Africa,Liberia,4818977,2020-05-11,0,0,199,20,0.04129507154734293,0.10050251256281408,20,84
Africa,Liberia,4818977,2020-05-12,12,0,211,20,0.04378522661552441,0.0947867298578199,21,84
Africa,Liberia,4818977,2020-05-13,1,0,212,20,0.04399273953787287,0.09433962264150944,22,84
Africa,Liberia,4818977,2020-05-14,1,0,213,20,0.04420025246022133,0.09389671361502347,23,84
Africa,Liberia,4818977,2020-05-15,2,0,215,20,0.04461527830491824,0.09302325581395349,24,84
Africa,Liberia,4818977,2020-05-16,4,0,219,20,0.04544532999431207,0.091324200913242,25,84
Africa,Liberia,4818977,2020-05-17,4,0,223,20,0.0462753816837059,0.08968609865470852,26,84
Africa,Liberia,4818977,2020-05-18,3,1,226,21,0.04689792045075127,0.09292035398230089,27,84
Africa,Liberia,4818977,2020-05-19,3,1,229,22,0.04752045921779664,0.09606986899563319,28,84
Africa,Liberia,4818977,2020-05-20,4,1,233,23,0.04835051090719047,0.09871244635193133,29,84
Africa,Liberia,4818977,2020-05-21,5,0,238,23,0.04938807551893275,0.09663865546218488,30,84
Africa,Liberia,4818977,2020-05-22,2,0,240,23,0.049803101363629664,0.09583333333333334,31,84
Africa,Liberia,4818977,2020-05-23,9,1,249,24,0.05167071766476578,0.0963855421686747,32,84
Africa,Liberia,4818977,2020-05-24,6,2,255,26,0.05291579519885652,0.10196078431372549,33,84
Africa,Liberia,4818977,2020-05-25,10,0,265,26,0.05499092442234109,0.09811320754716982,34,84
Africa,Liberia,4818977,2020-05-26,0,0,265,26,0.05499092442234109,0.09811320754716982,35,84
Africa,Liberia,4818977,2020-05-27,1,0,266,26,0.055198437344689544,0.09774436090225563,36,84
Europe,Lithuania,2789533,2020-03-21,21,1,69,1,0.02473532308096015,0.014492753623188406,0,85
Europe,Lithuania,2789533,2020-03-22,36,0,105,1,0.0376407090362437,0.009523809523809525,1,85
Europe,Lithuania,2789533,2020-03-23,38,0,143,1,0.0512630608779319,0.006993006993006993,2,85
Europe,Lithuania,2789533,2020-03-24,36,0,179,1,0.06416844683321545,0.00558659217877095,3,85
Europe,Lithuania,2789533,2020-03-25,30,1,209,2,0.07492293512928508,0.009569377990430622,4,85
Europe,Lithuania,2789533,2020-03-26,65,2,274,4,0.09822432643743595,0.014598540145985401,5,85
Europe,Lithuania,2789533,2020-03-27,25,0,299,4,0.10718640001749397,0.013377926421404682,6,85
Europe,Lithuania,2789533,2020-03-28,59,1,358,5,0.1283368936664309,0.013966480446927373,7,85
Europe,Lithuania,2789533,2020-03-29,36,2,394,7,0.14124227962171446,0.017766497461928935,8,85
Europe,Lithuania,2789533,2020-03-30,90,0,484,7,0.17350574450992334,0.014462809917355372,9,85
Europe,Lithuania,2789533,2020-03-31,0,0,484,7,0.17350574450992334,0.014462809917355372,10,85
Europe,Lithuania,2789533,2020-04-01,49,0,533,7,0.1910714087268371,0.013133208255159476,11,85
Europe,Lithuania,2789533,2020-04-02,48,1,581,8,0.20827859000054846,0.013769363166953529,12,85
Europe,Lithuania,2789533,2020-04-03,68,1,649,9,0.2326554301383063,0.01386748844375963,13,85
Europe,Lithuania,2789533,2020-04-04,122,0,771,9,0.27639034920898947,0.011673151750972763,14,85
Europe,Lithuania,2789533,2020-04-05,0,0,771,9,0.27639034920898947,0.011673151750972763,15,85
Europe,Lithuania,2789533,2020-04-06,40,4,811,13,0.2907296669370823,0.016029593094944512,16,85
Europe,Lithuania,2789533,2020-04-07,32,1,843,14,0.3022011211195566,0.0166073546856465,17,85
Europe,Lithuania,2789533,2020-04-08,37,1,880,15,0.3154649900180424,0.017045454545454544,18,85
Europe,Lithuania,2789533,2020-04-09,32,0,912,15,0.3269364442005167,0.01644736842105263,19,85
Europe,Lithuania,2789533,2020-04-10,43,0,955,15,0.3423512107582165,0.015706806282722512,20,85
Europe,Lithuania,2789533,2020-04-11,44,2,999,17,0.35812446025911865,0.01701701701701702,21,85
Europe,Lithuania,2789533,2020-04-12,54,6,1053,23,0.377482539192044,0.02184235517568851,22,85
Europe,Lithuania,2789533,2020-04-13,9,1,1062,24,0.38070888568086486,0.022598870056497175,23,85
Europe,Lithuania,2789533,2020-04-14,8,0,1070,24,0.38357674922648344,0.022429906542056073,24,85
Europe,Lithuania,2789533,2020-04-15,0,0,1070,24,0.38357674922648344,0.022429906542056073,25,85
Europe,Lithuania,2789533,2020-04-16,21,5,1091,29,0.3911048910337322,0.026581118240146653,26,85
Europe,Lithuania,2789533,2020-04-17,58,3,1149,32,0.41189690173946675,0.0278503046127067,27,85
Europe,Lithuania,2789533,2020-04-18,90,1,1239,33,0.44416036662767566,0.026634382566585957,28,85
Europe,Lithuania,2789533,2020-04-19,59,0,1298,33,0.4653108602766126,0.025423728813559324,29,85
Europe,Lithuania,2789533,2020-04-20,28,3,1326,36,0.4753483826862776,0.027149321266968326,30,85
Europe,Lithuania,2789533,2020-04-21,24,1,1350,37,0.4839519733231333,0.027407407407407408,31,85
Europe,Lithuania,2789533,2020-04-22,20,1,1370,38,0.49112163218717975,0.027737226277372264,32,85
Europe,Lithuania,2789533,2020-04-23,28,0,1398,38,0.5011591545968447,0.027181688125894134,33,85
Europe,Lithuania,2789533,2020-04-24,12,2,1410,40,0.5054609499152726,0.028368794326241134,34,85
Europe,Lithuania,2789533,2020-04-25,0,0,1410,40,0.5054609499152726,0.028368794326241134,35,85
Europe,Lithuania,2789533,2020-04-26,16,1,1426,41,0.5111966770065096,0.028751753155680224,36,85
Europe,Lithuania,2789533,2020-04-27,12,0,1438,41,0.5154984723249375,0.02851182197496523,37,85
Europe,Lithuania,2789533,2020-04-28,11,0,1449,41,0.5194417847001631,0.028295376121463076,38,85
Europe,Lithuania,2789533,2020-04-30,31,1,1375,45,0.4929140469031913,0.03272727272727273,40,85
Europe,Lithuania,2789533,2020-05-01,10,0,1385,45,0.4964988763352145,0.032490974729241874,41,85
Europe,Lithuania,2789533,2020-05-02,14,0,1399,45,0.5015176375400471,0.032165832737669764,42,85
Europe,Lithuania,2789533,2020-05-03,7,1,1406,46,0.5040270181424633,0.032716927453769556,43,85
Europe,Lithuania,2789533,2020-05-04,4,0,1410,46,0.5054609499152726,0.032624113475177303,44,85
Europe,Lithuania,2789533,2020-05-05,9,0,1419,46,0.5086872964040934,0.03241719520789288,45,85
Europe,Lithuania,2789533,2020-05-06,4,0,1423,46,0.5101212281769028,0.03232607167955025,46,85
Europe,Lithuania,2789533,2020-05-07,5,2,1428,48,0.5119136428929144,0.03361344537815126,47,85
Europe,Lithuania,2789533,2020-05-08,5,1,1433,49,0.513706057608926,0.034193998604326585,48,85
Europe,Lithuania,2789533,2020-05-09,3,0,1436,49,0.5147815064385329,0.034122562674094706,49,85
Europe,Lithuania,2789533,2020-05-10,8,1,1444,50,0.5176493699841516,0.03462603878116344,50,85
Europe,Lithuania,2789533,2020-05-11,35,0,1479,50,0.5301962729962327,0.03380662609871535,51,85
Europe,Lithuania,2789533,2020-05-12,6,0,1485,50,0.5323471706554467,0.03367003367003367,52,85
Europe,Lithuania,2789533,2020-05-13,6,0,1491,50,0.5344980683146606,0.0335345405767941,53,85
Europe,Lithuania,2789533,2020-05-14,14,4,1505,54,0.539516829519493,0.035880398671096346,54,85
Europe,Lithuania,2789533,2020-05-15,6,0,1511,54,0.541667727178707,0.0357379219060225,55,85
Europe,Lithuania,2789533,2020-05-16,12,0,1523,54,0.5459695224971348,0.03545633617859488,56,85
Europe,Lithuania,2789533,2020-05-17,11,1,1534,55,0.5499128348723603,0.03585397653194263,57,85
Europe,Lithuania,2789533,2020-05-18,7,1,1541,56,0.5524222154747765,0.036340038935756006,58,85
Europe,Lithuania,2789533,2020-05-19,6,3,1547,59,0.5545731131339905,0.03813833225597932,59,85
Europe,Lithuania,2789533,2020-05-20,15,1,1562,60,0.5599503572820254,0.03841229193341869,60,85
Europe,Lithuania,2789533,2020-05-21,15,0,1577,60,0.5653276014300602,0.03804692454026633,61,85
Europe,Lithuania,2789533,2020-05-22,17,1,1594,61,0.5714218114644996,0.038268506900878296,62,85
Europe,Lithuania,2789533,2020-05-23,10,0,1604,61,0.5750066408965228,0.038029925187032416,63,85
Europe,Lithuania,2789533,2020-05-24,12,2,1616,63,0.5793084362149508,0.038985148514851485,64,85
Europe,Lithuania,2789533,2020-05-25,7,0,1623,63,0.5818178168173669,0.038817005545286505,65,85
Europe,Lithuania,2789533,2020-05-26,12,0,1635,63,0.5861196121357948,0.03853211009174312,66,85
Europe,Lithuania,2789533,2020-05-27,4,2,1639,65,0.587553543908604,0.03965832824893228,67,85
Europe,Luxembourg,607728,2020-03-13,19,0,26,0,0.04278229734354843,0,0,86
Europe,Luxembourg,607728,2020-03-14,12,1,38,1,0.06252797304057078,0.02631578947368421,1,86
Europe,Luxembourg,607728,2020-03-16,39,0,77,1,0.12670141905589344,0.012987012987012988,2,86
Europe,Luxembourg,607728,2020-03-17,4,0,81,1,0.13328331095490087,0.012345679012345678,3,86
Europe,Luxembourg,607728,2020-03-18,59,0,140,1,0.2303662164652608,0.007142857142857143,4,86
Europe,Luxembourg,607728,2020-03-19,70,1,210,2,0.3455493246978911,0.009523809523809525,5,86
Europe,Luxembourg,607728,2020-03-20,135,2,345,4,0.5676881762893926,0.011594202898550725,6,86
Europe,Luxembourg,607728,2020-03-21,139,1,484,5,0.7964089197799015,0.010330578512396695,7,86
Europe,Luxembourg,607728,2020-03-22,186,3,670,8,1.102466893083748,0.011940298507462687,8,86
Europe,Luxembourg,607728,2020-03-23,128,0,798,8,1.3130874338519865,0.010025062656641603,9,86
Europe,Luxembourg,607728,2020-03-24,77,0,875,8,1.4397888529078797,0.009142857142857144,10,86
Europe,Luxembourg,607728,2020-03-25,224,0,1099,8,1.8083747992522972,0.007279344858962694,11,86
Europe,Luxembourg,607728,2020-03-26,234,0,1333,8,2.1934154753442328,0.006001500375093774,12,86
Europe,Luxembourg,607728,2020-03-27,120,1,1453,9,2.3908722323144564,0.006194081211286993,13,86
Europe,Luxembourg,607728,2020-03-28,152,6,1605,15,2.6409841244767396,0.009345794392523364,14,86
Europe,Luxembourg,607728,2020-03-29,226,3,1831,18,3.012861016770661,0.009830693610049153,15,86
Europe,Luxembourg,607728,2020-03-30,119,3,1950,21,3.208672300766132,0.010769230769230769,16,86
Europe,Luxembourg,607728,2020-03-31,38,1,1988,22,3.271200273806703,0.011066398390342052,17,86
Europe,Luxembourg,607728,2020-04-01,190,1,2178,23,3.583840139009557,0.010560146923783287,18,86
Europe,Luxembourg,607728,2020-04-02,141,6,2319,29,3.8158518284495697,0.01250539025442001,19,86
Europe,Luxembourg,607728,2020-04-03,168,1,2487,30,4.092291288207883,0.012062726176115802,20,86
Europe,Luxembourg,607728,2020-04-04,125,1,2612,31,4.2979754100518655,0.011868300153139357,21,86
Europe,Luxembourg,607728,2020-04-05,117,0,2729,31,4.490495748097834,0.011359472334188348,22,86
Europe,Luxembourg,607728,2020-04-06,75,5,2804,36,4.613906221204223,0.012838801711840228,23,86
Europe,Luxembourg,607728,2020-04-07,39,5,2843,41,4.678079667219545,0.014421385860007034,24,86
Europe,Luxembourg,607728,2020-04-08,127,3,2970,44,4.887054735013033,0.014814814814814815,25,86
Europe,Luxembourg,607728,2020-04-09,64,2,3034,46,4.992365005397151,0.015161502966381015,26,86
Europe,Luxembourg,607728,2020-04-10,81,6,3115,52,5.125648316352052,0.016693418940609953,27,86
Europe,Luxembourg,607728,2020-04-11,108,2,3223,54,5.303359397625254,0.016754576481538937,28,86
Europe,Luxembourg,607728,2020-04-12,47,8,3270,62,5.38069662743859,0.018960244648318043,29,86
Europe,Luxembourg,607728,2020-04-13,11,4,3281,66,5.398796830160861,0.020115818348064616,30,86
Europe,Luxembourg,607728,2020-04-14,11,1,3292,67,5.416897032883132,0.020352369380315916,31,86
Europe,Luxembourg,607728,2020-04-15,15,0,3307,67,5.44157912750441,0.020260054429996975,32,86
Europe,Luxembourg,607728,2020-04-16,66,2,3373,69,5.550180343838033,0.020456566854432257,33,86
Europe,Luxembourg,607728,2020-04-17,71,0,3444,69,5.6670089250454145,0.02003484320557491,34,86
Europe,Luxembourg,607728,2020-04-18,36,3,3480,72,5.726245952136482,0.020689655172413793,35,86
Europe,Luxembourg,607728,2020-04-19,57,0,3537,72,5.820037911697338,0.020356234096692113,36,86
Europe,Luxembourg,607728,2020-04-20,13,1,3550,73,5.841429060369113,0.02056338028169014,37,86
Europe,Luxembourg,607728,2020-04-21,8,2,3558,75,5.8545928441671276,0.021079258010118045,38,86
Europe,Luxembourg,607728,2020-04-22,60,3,3618,78,5.953321222652239,0.02155887230514096,39,86
Europe,Luxembourg,607728,2020-04-23,36,2,3654,80,6.012558249743306,0.021893814997263273,40,86
Europe,Luxembourg,607728,2020-04-24,11,3,3665,83,6.030658452465577,0.022646657571623464,41,86
Europe,Luxembourg,607728,2020-04-25,30,2,3695,85,6.0800226417081324,0.023004059539918808,42,86
Europe,Luxembourg,607728,2020-04-26,16,0,3711,85,6.106350209304162,0.02290487739153867,43,86
Europe,Luxembourg,607728,2020-04-27,12,3,3723,88,6.126095885001185,0.0236368520010744,44,86
Europe,Luxembourg,607728,2020-04-28,6,0,3729,88,6.135968722849697,0.02359882005899705,45,86
Europe,Luxembourg,607728,2020-04-29,12,1,3741,89,6.155714398546719,0.023790430366212242,46,86
Europe,Luxembourg,607728,2020-04-30,28,0,3769,89,6.201787641839771,0.023613690634120457,47,86
Europe,Luxembourg,607728,2020-05-01,15,1,3784,90,6.226469736461048,0.023784355179704016,48,86
Europe,Luxembourg,607728,2020-05-02,18,2,3802,92,6.256088250006583,0.0241977906365071,49,86
Europe,Luxembourg,607728,2020-05-03,10,0,3812,92,6.272542979754101,0.024134312696747113,50,86
Europe,Luxembourg,607728,2020-05-04,12,4,3824,96,6.292288655451123,0.02510460251046025,51,86
Europe,Luxembourg,607728,2020-05-05,4,0,3828,96,6.2988705473501305,0.025078369905956112,52,86
Europe,Luxembourg,607728,2020-05-06,12,0,3840,96,6.318616223047153,0.025,53,86
Europe,Luxembourg,607728,2020-05-07,11,2,3851,98,6.336716425769423,0.02544793560114256,54,86
Europe,Luxembourg,607728,2020-05-08,8,2,3859,100,6.349880209567438,0.025913449080072558,55,86
Europe,Luxembourg,607728,2020-05-09,12,0,3871,100,6.36962588526446,0.025833118057349523,56,86
Europe,Luxembourg,607728,2020-05-10,6,1,3877,101,6.379498723112971,0.026051070415269537,57,86
Europe,Luxembourg,607728,2020-05-11,9,0,3886,101,6.394307979885738,0.025990735975295935,58,86
Europe,Luxembourg,607728,2020-05-12,2,0,3888,101,6.397598925835242,0.025977366255144033,59,86
Europe,Luxembourg,607728,2020-05-13,6,1,3894,102,6.407471763683753,0.026194144838212634,60,86
Europe,Luxembourg,607728,2020-05-14,10,1,3904,103,6.423926493431272,0.026383196721311477,61,86
Europe,Luxembourg,607728,2020-05-15,11,0,3915,103,6.442026696153543,0.026309067688378034,62,86
Europe,Luxembourg,607728,2020-05-16,8,1,3923,104,6.455190479951558,0.02651032373183788,63,86
Europe,Luxembourg,607728,2020-05-17,7,0,3930,104,6.46670879077482,0.026463104325699746,64,86
Europe,Luxembourg,607728,2020-05-18,15,3,3945,107,6.491390885396098,0.02712294043092522,65,86
Europe,Luxembourg,607728,2020-05-19,2,0,3947,107,6.494681831345602,0.027109196858373447,66,86
Europe,Luxembourg,607728,2020-05-20,11,2,3958,109,6.512782034067873,0.027539161192521474,67,86
Europe,Luxembourg,607728,2020-05-21,13,0,3971,109,6.534173182739647,0.027449005288340468,68,86
Europe,Luxembourg,607728,2020-05-22,9,0,3980,109,6.548982439512414,0.027386934673366833,69,86
Europe,Luxembourg,607728,2020-05-23,1,0,3981,109,6.550627912487165,0.02738005526249686,70,86
Europe,Luxembourg,607728,2020-05-24,9,0,3990,109,6.565437169259932,0.02731829573934837,71,86
Europe,Luxembourg,607728,2020-05-25,2,1,3992,110,6.568728115209436,0.02755511022044088,72,86
Europe,Luxembourg,607728,2020-05-26,1,0,3993,110,6.570373588184188,0.027548209366391185,73,86
Europe,Luxembourg,607728,2020-05-27,2,0,3995,110,6.573664534133691,0.02753441802252816,74,86
Asia,Malaysia,31528585,2020-03-18,120,2,673,2,0.021345708981230845,0.0029717682020802376,0,87
Asia,Malaysia,31528585,2020-03-19,117,0,790,2,0.025056627184505742,0.002531645569620253,1,87
Asia,Malaysia,31528585,2020-03-20,110,0,900,2,0.028545524640576164,0.0022222222222222222,2,87
Asia,Malaysia,31528585,2020-03-21,130,0,1030,2,0.03266876708865939,0.001941747572815534,3,87
Asia,Malaysia,31528585,2020-03-22,153,2,1183,4,0.037521506277557334,0.0033812341504649195,4,87
Asia,Malaysia,31528585,2020-03-23,123,6,1306,10,0.041422727978436075,0.007656967840735069,5,87
Asia,Malaysia,31528585,2020-03-24,212,4,1518,14,0.04814678489377179,0.00922266139657444,6,87
Asia,Malaysia,31528585,2020-03-25,106,1,1624,15,0.051508813351439656,0.009236453201970444,7,87
Asia,Malaysia,31528585,2020-03-26,172,4,1796,19,0.056964180282749764,0.010579064587973273,8,87
Asia,Malaysia,31528585,2020-03-27,235,4,2031,23,0.0644177339389002,0.011324470704086657,9,87
Asia,Malaysia,31528585,2020-03-28,130,3,2161,26,0.06854097638698343,0.012031466913465988,10,87
Asia,Malaysia,31528585,2020-03-29,159,1,2320,27,0.07358401907348522,0.01163793103448276,11,87
Asia,Malaysia,31528585,2020-03-30,150,7,2470,34,0.07834160651358126,0.013765182186234818,12,87
Asia,Malaysia,31528585,2020-03-31,156,3,2626,37,0.08328949745128111,0.01408987052551409,13,87
Asia,Malaysia,31528585,2020-04-01,140,6,2766,43,0.08772991239537073,0.01554591467823572,14,87
Asia,Malaysia,31528585,2020-04-02,142,2,2908,45,0.09223376183866165,0.015474552957359009,15,87
Asia,Malaysia,31528585,2020-04-03,208,5,3116,50,0.09883094975559481,0.016046213093709884,16,87
Asia,Malaysia,31528585,2020-04-04,217,3,3333,53,0.10571359291893373,0.0159015901590159,17,87
Asia,Malaysia,31528585,2020-04-05,150,4,3483,57,0.11047118035902975,0.01636520241171404,18,87
Asia,Malaysia,31528585,2020-04-06,179,4,3662,61,0.11614856803754434,0.016657564172583288,19,87
Asia,Malaysia,31528585,2020-04-07,131,1,3793,62,0.1203035277352282,0.01634590034273662,20,87
Asia,Malaysia,31528585,2020-04-08,170,1,3963,63,0.12569546016733704,0.015897047691143074,21,87
Asia,Malaysia,31528585,2020-04-09,156,2,4119,65,0.1306433511050369,0.015780529254673464,22,87
Asia,Malaysia,31528585,2020-04-10,109,2,4228,67,0.13410053131150668,0.015846736045411543,23,87
Asia,Malaysia,31528585,2020-04-11,118,3,4346,70,0.13784316676438224,0.016106764841233318,24,87
Asia,Malaysia,31528585,2020-04-12,184,3,4530,73,0.14367914069090004,0.016114790286975718,25,87
Asia,Malaysia,31528585,2020-04-13,153,3,4683,76,0.14853187987979796,0.016228913089899637,26,87
Asia,Malaysia,31528585,2020-04-14,134,1,4817,77,0.15278199132628376,0.015985052937512977,27,87
Asia,Malaysia,31528585,2020-04-15,170,5,4987,82,0.1581739237583926,0.016442751152997793,28,87
Asia,Malaysia,31528585,2020-04-16,85,1,5072,83,0.160869889974447,0.016364353312302838,29,87
Asia,Malaysia,31528585,2020-04-17,110,1,5182,84,0.1643587874305174,0.016209957545349287,30,87
Asia,Malaysia,31528585,2020-04-18,69,2,5251,86,0.1665472776529616,0.01637783279375357,31,87
Asia,Malaysia,31528585,2020-04-19,54,2,5305,88,0.16826000913139616,0.016588124410933082,32,87
Asia,Malaysia,31528585,2020-04-20,84,1,5389,89,0.17092425809784992,0.016515123399517537,33,87
Asia,Malaysia,31528585,2020-04-21,36,0,5425,89,0.172066079083473,0.01640552995391705,34,87
Asia,Malaysia,31528585,2020-04-22,57,3,5482,92,0.17387396231070948,0.01678219627873039,35,87
Asia,Malaysia,31528585,2020-04-23,50,1,5532,93,0.17545982479074146,0.016811279826464208,36,87
Asia,Malaysia,31528585,2020-04-24,71,2,5603,95,0.17771174951238694,0.01695520257005176,37,87
Asia,Malaysia,31528585,2020-04-25,88,1,5691,96,0.18050286747724328,0.01686874011597259,38,87
Asia,Malaysia,31528585,2020-04-26,51,2,5742,98,0.18212044720687592,0.017067223963775687,39,87
Asia,Malaysia,31528585,2020-04-27,38,0,5780,98,0.18332570269170023,0.016955017301038062,40,87
Asia,Malaysia,31528585,2020-04-28,40,1,5820,99,0.18459439267572583,0.017010309278350514,41,87
Asia,Malaysia,31528585,2020-04-29,31,1,5851,100,0.18557762741334569,0.017091095539224065,42,87
Asia,Malaysia,31528585,2020-04-30,94,0,5945,100,0.18855904887580585,0.01682085786375105,43,87
Asia,Malaysia,31528585,2020-05-01,57,2,6002,102,0.19036693210304237,0.016994335221592802,44,87
Asia,Malaysia,31528585,2020-05-02,69,1,6071,103,0.19255542232548653,0.01696590347553945,45,87
Asia,Malaysia,31528585,2020-05-03,105,0,6176,103,0.19588573353355374,0.016677461139896373,46,87
Asia,Malaysia,31528585,2020-05-04,122,2,6298,105,0.19975523798483186,0.016671959352175292,47,87
Asia,Malaysia,31528585,2020-05-05,55,0,6353,105,0.20149968671286708,0.016527624744215333,48,87
Asia,Malaysia,31528585,2020-05-06,30,1,6383,106,0.20245120420088628,0.01660661131129563,49,87
Asia,Malaysia,31528585,2020-05-07,45,1,6428,107,0.20387848043291507,0.016645924082140634,50,87
Asia,Malaysia,31528585,2020-05-08,39,0,6467,107,0.20511545316734003,0.01654553888974795,51,87
Asia,Malaysia,31528585,2020-05-09,68,0,6535,107,0.2072722261401836,0.01637337413925019,52,87
Asia,Malaysia,31528585,2020-05-10,54,1,6589,108,0.20898495761861813,0.016390954621338594,53,87
Asia,Malaysia,31528585,2020-05-11,67,0,6656,108,0.21111001334186105,0.01622596153846154,54,87
Asia,Malaysia,31528585,2020-05-12,70,1,6726,109,0.21333022081390587,0.016205768658935474,55,87
Asia,Malaysia,31528585,2020-05-13,16,0,6742,109,0.2138376968075161,0.016167309403737763,56,87
Asia,Malaysia,31528585,2020-05-14,37,2,6779,111,0.21501123504273978,0.016374096474406255,57,87
Asia,Malaysia,31528585,2020-05-15,40,1,6819,112,0.21627992502676538,0.016424695703182286,58,87
Asia,Malaysia,31528585,2020-05-16,36,0,6855,112,0.21742174601238845,0.016338439095550692,59,87
Asia,Malaysia,31528585,2020-05-17,17,1,6872,113,0.21796093925559934,0.016443538998835855,60,87
Asia,Malaysia,31528585,2020-05-18,22,0,6894,113,0.21865871874681342,0.016391064693936756,61,87
Asia,Malaysia,31528585,2020-05-19,47,0,6941,113,0.22014942947804347,0.01628007491715891,62,87
Asia,Malaysia,31528585,2020-05-20,37,1,6978,114,0.2213229677132672,0.01633705932932072,63,87
Asia,Malaysia,31528585,2020-05-21,31,0,7009,114,0.22230620245088703,0.016264802396918247,64,87
Asia,Malaysia,31528585,2020-05-22,50,0,7059,114,0.22389206493091904,0.016149596260093498,65,87
Asia,Malaysia,31528585,2020-05-23,78,1,7137,115,0.22636601039976897,0.01611321283452431,66,87
Asia,Malaysia,31528585,2020-05-24,48,0,7185,115,0.22788843838059972,0.016005567153792623,67,87
Asia,Malaysia,31528585,2020-05-25,60,0,7245,115,0.2297914733566381,0.015873015873015872,68,87
Asia,Malaysia,31528585,2020-05-26,172,0,7417,115,0.23524684028794823,0.015504921127140353,69,87
Asia,Malaysia,31528585,2020-05-27,187,0,7604,115,0.24117796596326796,0.015123619147816939,70,87
Asia,Maldives,515696,2020-03-16,4,0,13,0,0.025208650057398155,0,0,88
Asia,Maldives,515696,2020-03-17,0,0,13,0,0.025208650057398155,0,1,88
Asia,Maldives,515696,2020-03-18,0,0,13,0,0.025208650057398155,0,2,88
Asia,Maldives,515696,2020-03-19,0,0,13,0,0.025208650057398155,0,3,88
Asia,Maldives,515696,2020-03-20,0,0,13,0,0.025208650057398155,0,4,88
Asia,Maldives,515696,2020-03-21,0,0,13,0,0.025208650057398155,0,5,88
Asia,Maldives,515696,2020-03-22,0,0,13,0,0.025208650057398155,0,6,88
Asia,Maldives,515696,2020-03-23,0,0,13,0,0.025208650057398155,0,7,88
Asia,Maldives,515696,2020-03-24,0,0,13,0,0.025208650057398155,0,8,88
Asia,Maldives,515696,2020-03-25,0,0,13,0,0.025208650057398155,0,9,88
Asia,Maldives,515696,2020-03-26,0,0,13,0,0.025208650057398155,0,10,88
Asia,Maldives,515696,2020-03-27,0,0,13,0,0.025208650057398155,0,11,88
Asia,Maldives,515696,2020-03-28,1,0,14,0,0.027147776984890324,0,12,88
Asia,Maldives,515696,2020-03-29,2,0,16,0,0.03102603083987466,0,13,88
Asia,Maldives,515696,2020-03-30,1,0,17,0,0.03296515776736682,0,14,88
Asia,Maldives,515696,2020-03-31,0,0,17,0,0.03296515776736682,0,15,88
Asia,Maldives,515696,2020-04-01,1,0,18,0,0.034904284694858984,0,16,88
Asia,Maldives,515696,2020-04-02,1,0,19,0,0.036843411622351156,0,17,88
Asia,Maldives,515696,2020-04-03,0,0,19,0,0.036843411622351156,0,18,88
Asia,Maldives,515696,2020-04-04,0,0,19,0,0.036843411622351156,0,19,88
Asia,Maldives,515696,2020-04-05,0,0,19,0,0.036843411622351156,0,20,88
Asia,Maldives,515696,2020-04-06,0,0,19,0,0.036843411622351156,0,21,88
Asia,Maldives,515696,2020-04-07,0,0,19,0,0.036843411622351156,0,22,88
Asia,Maldives,515696,2020-04-08,0,0,19,0,0.036843411622351156,0,23,88
Asia,Maldives,515696,2020-04-09,0,0,19,0,0.036843411622351156,0,24,88
Asia,Maldives,515696,2020-04-10,0,0,19,0,0.036843411622351156,0,25,88
Asia,Maldives,515696,2020-04-11,0,0,19,0,0.036843411622351156,0,26,88
Asia,Maldives,515696,2020-04-12,0,0,19,0,0.036843411622351156,0,27,88
Asia,Maldives,515696,2020-04-13,1,0,20,0,0.03878253854984332,0,28,88
Asia,Maldives,515696,2020-04-14,0,0,20,0,0.03878253854984332,0,29,88
Asia,Maldives,515696,2020-04-15,1,0,21,0,0.04072166547733549,0,30,88
Asia,Maldives,515696,2020-04-16,0,0,21,0,0.04072166547733549,0,31,88
Asia,Maldives,515696,2020-04-17,4,0,25,0,0.04847817318730415,0,32,88
Asia,Maldives,515696,2020-04-18,4,0,29,0,0.056234680897272814,0,33,88
Asia,Maldives,515696,2020-04-19,6,0,35,0,0.0678694424622258,0,34,88
Asia,Maldives,515696,2020-04-20,17,0,52,0,0.10083460022959262,0,35,88
Asia,Maldives,515696,2020-04-21,17,0,69,0,0.13379975799695945,0,36,88
Asia,Maldives,515696,2020-04-22,16,0,85,0,0.1648257888368341,0,37,88
Asia,Maldives,515696,2020-04-23,0,0,85,0,0.1648257888368341,0,38,88
Asia,Maldives,515696,2020-04-24,25,0,110,0,0.21330396202413826,0,39,88
Asia,Maldives,515696,2020-04-25,18,0,128,0,0.24820824671899727,0,40,88
Asia,Maldives,515696,2020-04-26,9,0,137,0,0.26566038906642675,0,41,88
Asia,Maldives,515696,2020-04-27,77,0,214,0,0.4149731624833235,0,42,88
Asia,Maldives,515696,2020-04-28,0,0,214,0,0.4149731624833235,0,43,88
Asia,Maldives,515696,2020-04-29,31,0,245,0,0.47508609723558065,0,44,88
Asia,Maldives,515696,2020-04-30,32,0,277,0,0.5371381589153299,0,45,88
Asia,Maldives,515696,2020-05-01,191,1,468,1,0.9075114020663336,0.002136752136752137,46,88
Asia,Maldives,515696,2020-05-02,23,0,491,1,0.9521113213986535,0.002036659877800407,47,88
Asia,Maldives,515696,2020-05-03,28,0,519,1,1.006406875368434,0.0019267822736030828,48,88
Asia,Maldives,515696,2020-05-04,8,0,527,1,1.0219198907883715,0.0018975332068311196,49,88
Asia,Maldives,515696,2020-05-05,24,0,551,1,1.0684589370481834,0.0018148820326678765,50,88
Asia,Maldives,515696,2020-05-06,22,0,573,1,1.111119729453011,0.0017452006980802793,51,88
Asia,Maldives,515696,2020-05-07,44,1,617,2,1.1964413142626664,0.0032414910858995136,52,88
Asia,Maldives,515696,2020-05-08,25,1,642,3,1.2449194874499705,0.004672897196261682,53,88
Asia,Maldives,515696,2020-05-09,2,0,644,3,1.2487977413049547,0.004658385093167702,54,88
Asia,Maldives,515696,2020-05-10,146,0,790,3,1.5319102727188112,0.0037974683544303796,55,88
Asia,Maldives,515696,2020-05-11,45,0,835,3,1.6191709844559585,0.003592814371257485,56,88
Asia,Maldives,515696,2020-05-12,62,0,897,3,1.739396853960473,0.0033444816053511705,57,88
Asia,Maldives,515696,2020-05-13,7,0,904,3,1.752970742452918,0.00331858407079646,58,88
Asia,Maldives,515696,2020-05-14,51,1,955,4,1.8518662157550185,0.004188481675392671,59,88
Asia,Maldives,515696,2020-05-15,27,0,982,4,1.904222642797307,0.004073319755600814,60,88
Asia,Maldives,515696,2020-05-16,49,0,1031,4,1.999239862244423,0.0038797284190106693,61,88
Asia,Maldives,515696,2020-05-17,47,0,1078,4,2.0903788278365547,0.0037105751391465678,62,88
Asia,Maldives,515696,2020-05-18,16,0,1094,4,2.121404858676429,0.003656307129798903,63,88
Asia,Maldives,515696,2020-05-19,12,0,1106,4,2.144674381806335,0.003616636528028933,64,88
Asia,Maldives,515696,2020-05-20,37,0,1143,4,2.216422078123546,0.003499562554680665,65,88
Asia,Maldives,515696,2020-05-21,43,0,1186,4,2.299804536005709,0.003372681281618887,66,88
Asia,Maldives,515696,2020-05-22,30,0,1216,4,2.357978343830474,0.003289473684210526,67,88
Asia,Maldives,515696,2020-05-23,58,0,1274,4,2.4704477056250194,0.0031397174254317113,68,88
Asia,Maldives,515696,2020-05-24,29,0,1303,4,2.526682386522292,0.0030698388334612432,69,88
Asia,Maldives,515696,2020-05-25,68,0,1371,4,2.6585430175917595,0.0029175784099197666,70,88
Asia,Maldives,515696,2020-05-26,24,0,1395,4,2.705082063851571,0.002867383512544803,71,88
Asia,Maldives,515696,2020-05-27,43,1,1438,5,2.7884645217337343,0.0034770514603616135,72,88
Africa,Mali,19077690,2020-04-27,19,2,389,23,0.020390309308936247,0.05912596401028278,0,89
Africa,Mali,19077690,2020-04-28,19,0,408,23,0.021386237012971696,0.056372549019607844,1,89
Africa,Mali,19077690,2020-04-29,16,1,424,24,0.022224912974264703,0.05660377358490566,2,89
Africa,Mali,19077690,2020-04-30,58,1,482,25,0.025265113333951855,0.05186721991701245,3,89
Africa,Mali,19077690,2020-05-01,8,1,490,26,0.025684451314598362,0.053061224489795916,4,89
Africa,Mali,19077690,2020-05-02,18,0,508,26,0.026627961771052994,0.051181102362204724,5,89
Africa,Mali,19077690,2020-05-03,36,0,544,26,0.02851498268396226,0.04779411764705882,6,89
Africa,Mali,19077690,2020-05-04,19,1,563,27,0.029510910387997708,0.047957371225577264,7,89
Africa,Mali,19077690,2020-05-05,17,2,580,29,0.030402003596871532,0.05,8,89
Africa,Mali,19077690,2020-05-06,32,3,612,32,0.03207935551945754,0.05228758169934641,9,89
Africa,Mali,19077690,2020-05-07,19,0,631,32,0.03307528322349299,0.05071315372424723,10,89
Africa,Mali,19077690,2020-05-08,19,0,650,32,0.03407121092752844,0.04923076923076923,11,89
Africa,Mali,19077690,2020-05-09,18,3,668,35,0.03501472138398307,0.05239520958083832,12,89
Africa,Mali,19077690,2020-05-10,24,2,692,37,0.03627273532592258,0.05346820809248555,13,89
Africa,Mali,19077690,2020-05-11,12,1,704,38,0.03690174229689234,0.05397727272727273,14,89
Africa,Mali,19077690,2020-05-12,8,1,712,39,0.037321080277538846,0.054775280898876406,15,89
Africa,Mali,19077690,2020-05-13,18,1,730,40,0.03826459073399348,0.0547945205479452,16,89
Africa,Mali,19077690,2020-05-14,28,4,758,44,0.03973227366625624,0.05804749340369393,17,89
Africa,Mali,19077690,2020-05-15,21,2,779,46,0.04083303586545332,0.059050064184852376,18,89
Africa,Mali,19077690,2020-05-16,27,0,806,46,0.042248301550135266,0.05707196029776675,19,89
Africa,Mali,19077690,2020-05-17,29,2,835,48,0.04376840172997884,0.05748502994011976,20,89
Africa,Mali,19077690,2020-05-18,25,4,860,52,0.045078832919499164,0.06046511627906977,21,89
Africa,Mali,19077690,2020-05-19,14,0,874,52,0.045812674385630546,0.059496567505720827,22,89
Africa,Mali,19077690,2020-05-20,27,1,901,53,0.047227940070312495,0.058823529411764705,23,89
Africa,Mali,19077690,2020-05-21,30,2,931,55,0.048800457497736885,0.05907626208378088,24,89
Africa,Mali,19077690,2020-05-22,16,5,947,60,0.0496391334590299,0.06335797254487856,25,89
Africa,Mali,19077690,2020-05-23,22,2,969,62,0.05079231290580778,0.06398348813209494,26,89
Africa,Mali,19077690,2020-05-24,46,1,1015,63,0.05320350629452518,0.06206896551724138,27,89
Africa,Mali,19077690,2020-05-25,15,2,1030,65,0.05398976500823737,0.06310679611650485,28,89
Africa,Mali,19077690,2020-05-26,29,2,1059,67,0.055509865188080945,0.06326723323890462,29,89
Africa,Mali,19077690,2020-05-27,18,3,1077,70,0.056453375644535585,0.06499535747446611,30,89
Europe,Malta,483530,2020-03-14,10,0,18,0,0.03722623208487581,0,0,90
Europe,Malta,483530,2020-03-15,2,0,20,0,0.04136248009430645,0,1,90
Europe,Malta,483530,2020-03-16,10,0,30,0,0.06204372014145968,0,2,90
Europe,Malta,483530,2020-03-17,8,0,38,0,0.07858871217918226,0,3,90
Europe,Malta,483530,2020-03-18,10,0,48,0,0.09926995222633549,0,4,90
Europe,Malta,483530,2020-03-19,4,0,52,0,0.10754244824519679,0,5,90
Europe,Malta,483530,2020-03-20,12,0,64,0,0.13235993630178064,0,6,90
Europe,Malta,483530,2020-03-21,9,0,73,0,0.15097305234421854,0,7,90
Europe,Malta,483530,2020-03-22,17,0,90,0,0.18613116042437905,0,8,90
Europe,Malta,483530,2020-03-23,17,0,107,0,0.22128926850453953,0,9,90
Europe,Malta,483530,2020-03-24,5,0,112,0,0.23162988852811614,0,10,90
Europe,Malta,483530,2020-03-25,17,0,129,0,0.2667879966082766,0,11,90
Europe,Malta,483530,2020-03-26,5,0,134,0,0.27712861663185323,0,12,90
Europe,Malta,483530,2020-03-27,5,0,139,0,0.28746923665542984,0,13,90
Europe,Malta,483530,2020-03-28,10,0,149,0,0.3081504767025831,0,14,90
Europe,Malta,483530,2020-03-29,2,0,151,0,0.3122867247120137,0,15,90
Europe,Malta,483530,2020-03-30,5,0,156,0,0.32262734473559035,0,16,90
Europe,Malta,483530,2020-03-31,9,0,165,0,0.3412404607780282,0,17,90
Europe,Malta,483530,2020-04-01,19,0,184,0,0.38053481686761936,0,18,90
Europe,Malta,483530,2020-04-02,10,0,194,0,0.40121605691477263,0,19,90
Europe,Malta,483530,2020-04-03,7,0,201,0,0.4156929249477799,0,20,90
Europe,Malta,483530,2020-04-04,5,0,206,0,0.4260335449713565,0,21,90
Europe,Malta,483530,2020-04-05,12,0,218,0,0.45085103302794033,0,22,90
Europe,Malta,483530,2020-04-06,17,0,235,0,0.48600914110810084,0,23,90
Europe,Malta,483530,2020-04-07,19,0,254,0,0.525303497197692,0,24,90
Europe,Malta,483530,2020-04-08,44,0,298,0,0.6163009534051662,0,25,90
Europe,Malta,483530,2020-04-09,9,1,307,1,0.6349140694476041,0.003257328990228013,26,90
Europe,Malta,483530,2020-04-10,35,1,342,2,0.7072984096126403,0.005847953216374269,27,90
Europe,Malta,483530,2020-04-11,18,0,360,2,0.7445246416975162,0.005555555555555556,28,90
Europe,Malta,483530,2020-04-12,13,1,373,3,0.7714102537588153,0.00804289544235925,29,90
Europe,Malta,483530,2020-04-13,11,0,384,3,0.7941596178106839,0.0078125,30,90
Europe,Malta,483530,2020-04-14,1,0,385,3,0.7962277418153993,0.007792207792207792,31,90
Europe,Malta,483530,2020-04-15,8,0,393,3,0.8127727338531219,0.007633587786259542,32,90
Europe,Malta,483530,2020-04-16,15,0,408,3,0.8437945939238517,0.007352941176470588,33,90
Europe,Malta,483530,2020-04-17,5,0,413,3,0.8541352139474282,0.007263922518159807,34,90
Europe,Malta,483530,2020-04-18,9,0,422,3,0.8727483299898662,0.0071090047393364926,35,90
Europe,Malta,483530,2020-04-19,4,0,426,3,0.8810208260087276,0.007042253521126761,36,90
Europe,Malta,483530,2020-04-20,2,0,428,3,0.8851570740181581,0.007009345794392523,37,90
Europe,Malta,483530,2020-04-21,5,0,433,3,0.8954976940417347,0.006928406466512702,38,90
Europe,Malta,483530,2020-04-22,11,0,444,3,0.9182470580936033,0.006756756756756757,39,90
Europe,Malta,483530,2020-04-23,1,0,445,3,0.9203151820983186,0.006741573033707865,40,90
Europe,Malta,483530,2020-04-24,1,0,446,3,0.9223833061030339,0.006726457399103139,41,90
Europe,Malta,483530,2020-04-25,1,0,447,3,0.9244514301077493,0.006711409395973154,42,90
Europe,Malta,483530,2020-04-26,1,1,448,4,0.9265195541124646,0.008928571428571428,43,90
Europe,Malta,483530,2020-04-27,0,0,448,4,0.9265195541124646,0.008928571428571428,44,90
Europe,Malta,483530,2020-04-28,2,0,450,4,0.9306558021218952,0.008888888888888889,45,90
Europe,Malta,483530,2020-04-29,0,0,450,4,0.9306558021218952,0.008888888888888889,46,90
Europe,Malta,483530,2020-04-30,13,0,463,4,0.9575414141831944,0.008639308855291577,47,90
Europe,Malta,483530,2020-05-01,2,0,465,4,0.9616776621926251,0.008602150537634409,48,90
Europe,Malta,483530,2020-05-02,2,0,467,4,0.9658139102020556,0.008565310492505354,49,90
Europe,Malta,483530,2020-05-03,0,0,467,4,0.9658139102020556,0.008565310492505354,50,90
Europe,Malta,483530,2020-05-04,10,0,477,4,0.9864951502492089,0.008385744234800839,51,90
Europe,Malta,483530,2020-05-05,3,0,480,4,0.9926995222633549,0.008333333333333333,52,90
Europe,Malta,483530,2020-05-06,2,1,482,5,0.9968357702727856,0.01037344398340249,53,90
Europe,Malta,483530,2020-05-07,2,0,484,5,1.0009720182822162,0.010330578512396695,54,90
Europe,Malta,483530,2020-05-08,2,0,486,5,1.0051082662916468,0.0102880658436214,55,90
Europe,Malta,483530,2020-05-09,3,0,489,5,1.0113126383057929,0.010224948875255624,56,90
Europe,Malta,483530,2020-05-10,1,0,490,5,1.013380762310508,0.01020408163265306,57,90
Europe,Malta,483530,2020-05-11,6,0,496,5,1.0257895063388,0.010080645161290322,58,90
Europe,Malta,483530,2020-05-12,7,0,503,5,1.0402663743718075,0.009940357852882704,59,90
Europe,Malta,483530,2020-05-13,0,0,503,5,1.0402663743718075,0.009940357852882704,60,90
Europe,Malta,483530,2020-05-14,5,1,508,6,1.050606994395384,0.011811023622047244,61,90
Europe,Malta,483530,2020-05-15,14,0,522,6,1.0795607304613983,0.011494252873563218,62,90
Europe,Malta,483530,2020-05-16,10,0,532,6,1.1002419705085515,0.011278195488721804,63,90
Europe,Malta,483530,2020-05-17,14,0,546,6,1.1291957065745661,0.01098901098901099,64,90
Europe,Malta,483530,2020-05-18,7,0,553,6,1.1436725746075733,0.0108499095840868,65,90
Europe,Malta,483530,2020-05-19,5,0,558,6,1.15401319463115,0.010752688172043012,66,90
Europe,Malta,483530,2020-05-20,2,0,560,6,1.1581494426405807,0.010714285714285714,67,90
Europe,Malta,483530,2020-05-21,24,0,584,6,1.2077844187537483,0.010273972602739725,68,90
Europe,Malta,483530,2020-05-22,15,0,599,6,1.2388062788244782,0.01001669449081803,69,90
Europe,Malta,483530,2020-05-23,1,0,600,6,1.2408744028291938,0.01,70,90
Europe,Malta,483530,2020-05-24,9,0,609,6,1.2594875188716315,0.009852216748768473,71,90
Europe,Malta,483530,2020-05-25,1,0,610,6,1.2615556428763468,0.009836065573770493,72,90
Europe,Malta,483530,2020-05-26,1,0,611,6,1.2636237668810621,0.009819967266775777,73,90
Europe,Malta,483530,2020-05-27,0,0,611,6,1.2636237668810621,0.009819967266775777,74,90
Africa,Mauritius,1265303,2020-03-23,14,1,28,2,0.02212908686694017,0.07142857142857142,0,91
Africa,Mauritius,1265303,2020-03-24,8,0,36,2,0.02845168311463736,0.05555555555555555,1,91
Africa,Mauritius,1265303,2020-03-25,6,0,42,2,0.03319363030041026,0.047619047619047616,2,91
Africa,Mauritius,1265303,2020-03-26,6,0,48,2,0.03793557748618315,0.041666666666666664,3,91
Africa,Mauritius,1265303,2020-03-27,33,0,81,2,0.06401628700793406,0.024691358024691357,4,91
Africa,Mauritius,1265303,2020-03-28,13,0,94,2,0.074290505910442,0.02127659574468085,5,91
Africa,Mauritius,1265303,2020-03-29,8,0,102,2,0.0806131021581392,0.0196078431372549,6,91
Africa,Mauritius,1265303,2020-03-30,8,1,110,3,0.08693569840583638,0.02727272727272727,7,91
Africa,Mauritius,1265303,2020-03-31,18,0,128,3,0.10116153996315506,0.0234375,8,91
Africa,Mauritius,1265303,2020-04-01,15,0,143,3,0.1130164079275873,0.02097902097902098,9,91
Africa,Mauritius,1265303,2020-04-02,11,2,154,5,0.12170997776817095,0.032467532467532464,10,91
Africa,Mauritius,1265303,2020-04-03,15,2,169,7,0.13356484573260316,0.04142011834319527,11,91
Africa,Mauritius,1265303,2020-04-04,17,0,186,7,0.14700036275895972,0.03763440860215054,12,91
Africa,Mauritius,1265303,2020-04-05,10,0,196,7,0.15490360806858122,0.03571428571428571,13,91
Africa,Mauritius,1265303,2020-04-06,31,0,227,7,0.17940366852840783,0.030837004405286344,14,91
Africa,Mauritius,1265303,2020-04-07,17,0,244,7,0.19283918555476437,0.028688524590163935,15,91
Africa,Mauritius,1265303,2020-04-08,24,0,268,7,0.21180697429785592,0.026119402985074626,16,91
Africa,Mauritius,1265303,2020-04-09,5,0,273,7,0.21575859695266666,0.02564102564102564,17,91
Africa,Mauritius,1265303,2020-04-10,41,0,314,7,0.24816190272211477,0.022292993630573247,18,91
Africa,Mauritius,1265303,2020-04-11,4,2,318,9,0.2513232008459634,0.02830188679245283,19,91
Africa,Mauritius,1265303,2020-04-12,1,0,319,9,0.25211352537692555,0.02821316614420063,20,91
Africa,Mauritius,1265303,2020-04-13,5,0,324,9,0.25606514803173624,0.027777777777777776,21,91
Africa,Mauritius,1265303,2020-04-14,0,0,324,9,0.25606514803173624,0.027777777777777776,22,91
Africa,Mauritius,1265303,2020-04-15,0,0,324,9,0.25606514803173624,0.027777777777777776,23,91
Africa,Mauritius,1265303,2020-04-16,0,0,324,9,0.25606514803173624,0.027777777777777776,24,91
Africa,Mauritius,1265303,2020-04-17,0,0,324,9,0.25606514803173624,0.027777777777777776,25,91
Africa,Mauritius,1265303,2020-04-18,0,0,324,9,0.25606514803173624,0.027777777777777776,26,91
Africa,Mauritius,1265303,2020-04-19,1,0,325,9,0.2568554725626984,0.027692307692307693,27,91
Africa,Mauritius,1265303,2020-04-20,3,0,328,9,0.2592264461555848,0.027439024390243903,28,91
Africa,Mauritius,1265303,2020-04-21,0,0,328,9,0.2592264461555848,0.027439024390243903,29,91
Africa,Mauritius,1265303,2020-04-22,0,0,328,9,0.2592264461555848,0.027439024390243903,30,91
Africa,Mauritius,1265303,2020-04-23,1,0,329,9,0.26001677068654705,0.02735562310030395,31,91
Africa,Mauritius,1265303,2020-04-24,2,0,331,9,0.2615974197484713,0.027190332326283987,32,91
Africa,Mauritius,1265303,2020-04-25,0,0,331,9,0.2615974197484713,0.027190332326283987,33,91
Africa,Mauritius,1265303,2020-04-26,0,0,331,9,0.2615974197484713,0.027190332326283987,34,91
Africa,Mauritius,1265303,2020-04-27,1,0,332,9,0.2623877442794335,0.02710843373493976,35,91
Africa,Mauritius,1265303,2020-04-28,0,1,332,10,0.2623877442794335,0.030120481927710843,36,91
Africa,Mauritius,1265303,2020-04-29,0,0,332,10,0.2623877442794335,0.030120481927710843,37,91
Africa,Mauritius,1265303,2020-04-30,0,0,332,10,0.2623877442794335,0.030120481927710843,38,91
Africa,Mauritius,1265303,2020-05-01,0,0,332,10,0.2623877442794335,0.030120481927710843,39,91
Africa,Mauritius,1265303,2020-05-02,0,0,332,10,0.2623877442794335,0.030120481927710843,40,91
Africa,Mauritius,1265303,2020-05-03,0,0,332,10,0.2623877442794335,0.030120481927710843,41,91
Africa,Mauritius,1265303,2020-05-04,0,0,332,10,0.2623877442794335,0.030120481927710843,42,91
Africa,Mauritius,1265303,2020-05-05,0,0,332,10,0.2623877442794335,0.030120481927710843,43,91
Africa,Mauritius,1265303,2020-05-06,0,0,332,10,0.2623877442794335,0.030120481927710843,44,91
Africa,Mauritius,1265303,2020-05-07,0,0,332,10,0.2623877442794335,0.030120481927710843,45,91
Africa,Mauritius,1265303,2020-05-08,0,0,332,10,0.2623877442794335,0.030120481927710843,46,91
Africa,Mauritius,1265303,2020-05-09,0,0,332,10,0.2623877442794335,0.030120481927710843,47,91
Africa,Mauritius,1265303,2020-05-10,0,0,332,10,0.2623877442794335,0.030120481927710843,48,91
Africa,Mauritius,1265303,2020-05-11,0,0,332,10,0.2623877442794335,0.030120481927710843,49,91
Africa,Mauritius,1265303,2020-05-12,0,0,332,10,0.2623877442794335,0.030120481927710843,50,91
Africa,Mauritius,1265303,2020-05-13,0,0,332,10,0.2623877442794335,0.030120481927710843,51,91
Africa,Mauritius,1265303,2020-05-14,0,0,332,10,0.2623877442794335,0.030120481927710843,52,91
Africa,Mauritius,1265303,2020-05-15,0,0,332,10,0.2623877442794335,0.030120481927710843,53,91
Africa,Mauritius,1265303,2020-05-16,0,0,332,10,0.2623877442794335,0.030120481927710843,54,91
Africa,Mauritius,1265303,2020-05-17,0,0,332,10,0.2623877442794335,0.030120481927710843,55,91
Africa,Mauritius,1265303,2020-05-18,0,0,332,10,0.2623877442794335,0.030120481927710843,56,91
Africa,Mauritius,1265303,2020-05-19,0,0,332,10,0.2623877442794335,0.030120481927710843,57,91
Africa,Mauritius,1265303,2020-05-20,0,0,332,10,0.2623877442794335,0.030120481927710843,58,91
Africa,Mauritius,1265303,2020-05-21,0,0,332,10,0.2623877442794335,0.030120481927710843,59,91
Africa,Mauritius,1265303,2020-05-22,0,0,332,10,0.2623877442794335,0.030120481927710843,60,91
Africa,Mauritius,1265303,2020-05-23,0,0,332,10,0.2623877442794335,0.030120481927710843,61,91
Africa,Mauritius,1265303,2020-05-24,0,0,332,10,0.2623877442794335,0.030120481927710843,62,91
Africa,Mauritius,1265303,2020-05-25,2,0,334,10,0.26396839334135774,0.029940119760479042,63,91
Africa,Mauritius,1265303,2020-05-26,0,0,334,10,0.26396839334135774,0.029940119760479042,64,91
Africa,Mauritius,1265303,2020-05-27,0,0,334,10,0.26396839334135774,0.029940119760479042,65,91
America,Mexico,126190788,2020-04-08,346,16,2785,141,0.02206975678763493,0.05062836624775584,0,92
America,Mexico,126190788,2020-04-09,396,33,3181,174,0.025207862241101147,0.05469977994341402,1,92
America,Mexico,126190788,2020-04-10,260,20,3441,194,0.027268234508528468,0.056378959604766056,2,92
America,Mexico,126190788,2020-04-11,403,39,3844,233,0.03046181152304081,0.06061394380853278,3,92
America,Mexico,126190788,2020-04-12,375,40,4219,273,0.033433502293368673,0.06470727660583077,4,92
America,Mexico,126190788,2020-04-13,442,23,4661,296,0.03693613514799511,0.06350568547521991,5,92
America,Mexico,126190788,2020-04-14,353,36,5014,332,0.03973348672646374,0.06621459912245713,6,92
America,Mexico,126190788,2020-04-15,385,74,5399,406,0.042784422584000344,0.07519911094647157,7,92
America,Mexico,126190788,2020-04-16,448,43,5847,449,0.04633460249095203,0.07679151701727381,8,92
America,Mexico,126190788,2020-04-17,450,37,6297,486,0.049900631415345474,0.0771796093377799,9,92
America,Mexico,126190788,2020-04-18,578,60,6875,546,0.054480997456010816,0.07941818181818182,10,92
America,Mexico,126190788,2020-04-19,622,104,7497,650,0.05941004188039463,0.08670134720554888,11,92
America,Mexico,126190788,2020-04-20,764,36,8261,686,0.0654643665431426,0.08304079409272486,12,92
America,Mexico,126190788,2020-04-21,511,26,8772,712,0.06951379049950937,0.08116735066119471,13,92
America,Mexico,126190788,2020-04-22,729,145,9501,857,0.07529075735702673,0.09020103147037153,14,92
America,Mexico,126190788,2020-04-23,1043,113,10544,970,0.08355601995289863,0.09199544764795144,15,92
America,Mexico,126190788,2020-04-24,1089,99,11633,1069,0.09218580994993074,0.09189375053726467,16,92
America,Mexico,126190788,2020-04-25,1239,152,12872,1221,0.10200427625509399,0.09485705407085146,17,92
America,Mexico,126190788,2020-04-26,970,84,13842,1305,0.10969104971434206,0.09427828348504551,18,92
America,Mexico,126190788,2020-04-27,835,46,14677,1351,0.1163080144962721,0.0920487838114056,19,92
America,Mexico,126190788,2020-04-28,852,83,15529,1434,0.12305969592645702,0.09234335758902698,20,92
America,Mexico,126190788,2020-04-29,1223,135,16752,1569,0.1327513700920863,0.09366045845272206,21,92
America,Mexico,126190788,2020-04-30,1047,163,17799,1732,0.14104833072284167,0.09730883757514468,22,92
America,Mexico,126190788,2020-05-01,1425,127,19224,1859,0.15234075565008756,0.09670203911776945,23,92
America,Mexico,126190788,2020-05-02,1515,113,20739,1972,0.1643463863622121,0.09508655190703505,24,92
America,Mexico,126190788,2020-05-03,1349,89,22088,2061,0.17503654862667153,0.09330858384643245,25,92
America,Mexico,126190788,2020-05-04,1383,93,23471,2154,0.1859961441876407,0.0917728260406459,26,92
America,Mexico,126190788,2020-05-05,1434,117,24905,2271,0.19735988969337445,0.09118650873318611,27,92
America,Mexico,126190788,2020-05-06,1120,236,26025,2507,0.20623533946075367,0.09633045148895293,28,92
America,Mexico,126190788,2020-05-07,1609,197,27634,2704,0.2189858739926404,0.09785047405370197,29,92
America,Mexico,126190788,2020-05-08,1982,257,29616,2961,0.23469225027741325,0.09997974068071312,30,92
America,Mexico,126190788,2020-05-09,1906,199,31522,3160,0.2497963638993997,0.10024744622803122,31,92
America,Mexico,126190788,2020-05-10,1938,193,33460,3353,0.2651540618004541,0.1002092050209205,32,92
America,Mexico,126190788,2020-05-11,1562,112,35022,3465,0.27753214442245977,0.09893781051910228,33,92
America,Mexico,126190788,2020-05-12,1305,108,36327,3573,0.28787362830320073,0.09835659426872574,34,92
America,Mexico,126190788,2020-05-13,1997,353,38324,3926,0.3036988722187867,0.10244233378561737,35,92
America,Mexico,126190788,2020-05-14,1862,294,40186,4220,0.3184543074570546,0.10501169561538845,36,92
America,Mexico,126190788,2020-05-15,2409,257,42595,4477,0.33754444896564084,0.10510623312595375,37,92
America,Mexico,126190788,2020-05-16,2437,290,45032,4767,0.35685647671841153,0.10585805649316042,38,92
America,Mexico,126190788,2020-05-17,2112,278,47144,5045,0.373593039136898,0.10701255727133888,39,92
America,Mexico,126190788,2020-05-18,2075,132,49219,5177,0.3900363947327122,0.10518295780084927,40,92
America,Mexico,126190788,2020-05-19,2414,155,51633,5332,0.40916615878490276,0.1032672902988399,41,92
America,Mexico,126190788,2020-05-20,2713,334,54346,5666,0.4306653509446347,0.104257903065543,42,92
America,Mexico,126190788,2020-05-21,2248,424,56594,6090,0.4484796465491601,0.10760858041488497,43,92
America,Mexico,126190788,2020-05-22,2973,420,59567,6510,0.4720392109763194,0.10928870011919352,44,92
America,Mexico,126190788,2020-05-23,2960,479,62527,6989,0.4954957567901073,0.11177571289203064,45,92
America,Mexico,126190788,2020-05-24,3329,190,65856,7179,0.521876446321898,0.10901056851311954,46,92
America,Mexico,126190788,2020-05-25,2764,215,68620,7394,0.5437797884263945,0.10775284173710288,47,92
America,Mexico,126190788,2020-05-26,2485,239,71105,7633,0.5634721925977672,0.10734828774347796,48,92
America,Mexico,126190788,2020-05-27,3455,501,74560,8134,0.5908513702283879,0.10909334763948497,49,92
Europe,Moldova,3545883,2020-03-22,14,0,80,1,0.022561376108574366,0.0125,0,93
Europe,Moldova,3545883,2020-03-23,14,0,94,1,0.026509616927574878,0.010638297872340425,1,93
Europe,Moldova,3545883,2020-03-24,15,0,109,1,0.030739874947932573,0.009174311926605505,2,93
Europe,Moldova,3545883,2020-03-25,16,0,125,1,0.03525215016964745,0.008,3,93
Europe,Moldova,3545883,2020-03-26,24,0,149,1,0.042020563002219756,0.006711409395973154,4,93
Europe,Moldova,3545883,2020-03-27,28,0,177,1,0.04991704464022079,0.005649717514124294,5,93
Europe,Moldova,3545883,2020-03-28,22,1,199,2,0.05612142307007874,0.010050251256281407,6,93
Europe,Moldova,3545883,2020-03-29,32,0,231,2,0.06514597351350848,0.008658008658008658,7,93
Europe,Moldova,3545883,2020-03-30,32,0,263,2,0.07417052395693823,0.0076045627376425855,8,93
Europe,Moldova,3545883,2020-03-31,35,0,298,2,0.08404112600443951,0.006711409395973154,9,93
Europe,Moldova,3545883,2020-04-01,55,2,353,4,0.09955207207908438,0.0113314447592068,10,93
Europe,Moldova,3545883,2020-04-02,70,1,423,5,0.11929327617408696,0.01182033096926714,11,93
Europe,Moldova,3545883,2020-04-03,82,1,505,6,0.1424186866853757,0.011881188118811881,12,93
Europe,Moldova,3545883,2020-04-04,86,2,591,8,0.16667216600209311,0.01353637901861252,13,93
Europe,Moldova,3545883,2020-04-05,161,4,752,12,0.21207693542059902,0.015957446808510637,14,93
Europe,Moldova,3545883,2020-04-06,112,3,864,15,0.24366286197260317,0.017361111111111112,15,93
Europe,Moldova,3545883,2020-04-07,101,4,965,19,0.27214659930967827,0.019689119170984457,16,93
Europe,Moldova,3545883,2020-04-08,91,3,1056,22,0.2978101646331816,0.020833333333333332,17,93
Europe,Moldova,3545883,2020-04-09,118,5,1174,27,0.33108819439332887,0.022998296422487224,18,93
Europe,Moldova,3545883,2020-04-10,115,2,1289,29,0.3635201725494045,0.022498060512024826,19,93
Europe,Moldova,3545883,2020-04-11,149,0,1438,29,0.40554073555162423,0.020166898470097356,20,93
Europe,Moldova,3545883,2020-04-12,122,1,1560,30,0.43994683411720015,0.019230769230769232,21,93
Europe,Moldova,3545883,2020-04-13,102,2,1662,32,0.4687125886556325,0.019253910950661854,22,93
Europe,Moldova,3545883,2020-04-14,50,4,1712,36,0.4828134487234914,0.02102803738317757,23,93
Europe,Moldova,3545883,2020-04-15,222,4,1934,40,0.54542126742478525,0.020682523267838676,24,93
Europe,Moldova,3545883,2020-04-16,115,6,2049,46,0.577853245580861,0.02244997559785261,25,93
Europe,Moldova,3545883,2020-04-17,105,8,2154,54,0.6074650517233648,0.025069637883008356,26,93
Europe,Moldova,3545883,2020-04-18,110,2,2264,56,0.6384869438726546,0.024734982332155476,27,93
Europe,Moldova,3545883,2020-04-19,87,4,2351,60,0.6630224403907292,0.02552105487026797,28,93
Europe,Moldova,3545883,2020-04-20,121,7,2472,67,0.6971465217549478,0.027103559870550162,29,93
Europe,Moldova,3545883,2020-04-21,76,3,2548,70,0.7185798290580936,0.027472527472527472,30,93
Europe,Moldova,3545883,2020-04-22,66,3,2614,73,0.7371929643476673,0.0279265493496557,31,93
Europe,Moldova,3545883,2020-04-23,164,3,2778,76,0.7834437853702448,0.027357811375089993,32,93
Europe,Moldova,3545883,2020-04-24,148,4,2926,80,0.8251823311711074,0.02734107997265892,33,93
Europe,Moldova,3545883,2020-04-25,184,7,3110,87,0.8770734962208284,0.02797427652733119,34,93
Europe,Moldova,3545883,2020-04-26,194,7,3304,94,0.9317848332841213,0.028450363196125907,35,93
Europe,Moldova,3545883,2020-04-27,104,2,3408,96,0.961114622225268,0.028169014084507043,36,93
Europe,Moldova,3545883,2020-04-28,73,6,3481,102,0.9817018779243422,0.02930192473427176,37,93
Europe,Moldova,3545883,2020-04-29,157,5,3638,107,1.0259785785374191,0.029411764705882353,38,93
Europe,Moldova,3545883,2020-04-30,133,4,3771,111,1.0634868663179242,0.0294351630867144,39,93
Europe,Moldova,3545883,2020-05-01,126,8,3897,119,1.0990210336889288,0.030536309982037466,40,93
Europe,Moldova,3545883,2020-05-02,83,3,3980,122,1.1224284614015747,0.030653266331658293,41,93
Europe,Moldova,3545883,2020-05-03,72,2,4052,124,1.1427336998992916,0.03060217176702863,42,93
Europe,Moldova,3545883,2020-05-04,69,1,4121,125,1.162192886792937,0.030332443581654937,43,93
Europe,Moldova,3545883,2020-05-05,127,7,4248,132,1.1980090713652987,0.031073446327683617,44,93
Europe,Moldova,3545883,2020-05-06,115,4,4363,136,1.2304410495213745,0.031171212468484987,45,93
Europe,Moldova,3545883,2020-05-07,113,7,4476,143,1.2623089932747358,0.03194816800714924,46,93
Europe,Moldova,3545883,2020-05-08,129,2,4605,145,1.298689212249812,0.031487513572204126,47,93
Europe,Moldova,3545883,2020-05-09,123,7,4728,152,1.333377328016745,0.032148900169204735,48,93
Europe,Moldova,3545883,2020-05-10,139,9,4867,161,1.372577719005393,0.03307992603246353,49,93
Europe,Moldova,3545883,2020-05-11,60,8,4927,169,1.389498751086824,0.03430079155672823,50,93
Europe,Moldova,3545883,2020-05-12,68,6,4995,175,1.4086759207791122,0.035035035035035036,51,93
Europe,Moldova,3545883,2020-05-13,159,7,5154,182,1.4535166557949035,0.03531237873496314,52,93
Europe,Moldova,3545883,2020-05-14,252,3,5406,185,1.5245849905369127,0.03422123566407695,53,93
Europe,Moldova,3545883,2020-05-15,147,9,5553,194,1.566041519136418,0.034936070592472536,54,93
Europe,Moldova,3545883,2020-05-16,192,3,5745,197,1.6201888217969966,0.03429068755439513,55,93
Europe,Moldova,3545883,2020-05-17,189,10,5934,207,1.6734900728535036,0.03488372093023256,56,93
Europe,Moldova,3545883,2020-05-18,126,4,6060,211,1.7090242402245082,0.03481848184818482,57,93
Europe,Moldova,3545883,2020-05-19,78,4,6138,215,1.7310215819303683,0.0350276963180189,58,93
Europe,Moldova,3545883,2020-05-20,202,6,6340,221,1.7879890566045187,0.03485804416403786,59,93
Europe,Moldova,3545883,2020-05-21,213,7,6553,228,1.8480587204935979,0.034793224477338625,60,93
Europe,Moldova,3545883,2020-05-22,151,5,6704,233,1.890643317898532,0.034755369928400955,61,93
Europe,Moldova,3545883,2020-05-23,143,4,6847,237,1.9309717776926085,0.03461369943040748,62,93
Europe,Moldova,3545883,2020-05-24,147,5,6994,242,1.9724283062921142,0.03460108664569631,63,93
Europe,Moldova,3545883,2020-05-25,99,8,7093,250,2.000348009226475,0.03524601720005639,64,93
Europe,Moldova,3545883,2020-05-26,54,11,7147,261,2.0155769380997626,0.03651881908493074,65,93
Europe,Moldova,3545883,2020-05-27,158,6,7305,267,2.060135655914197,0.03655030800821355,66,93
Asia,Mongolia,3170208,2020-05-16,74,0,135,0,0.0425839566362838,0,0,94
Asia,Mongolia,3170208,2020-05-17,1,0,136,0,0.04289939335210813,0,1,94
Asia,Mongolia,3170208,2020-05-18,4,0,140,0,0.04416114021540543,0,2,94
Asia,Mongolia,3170208,2020-05-19,0,0,140,0,0.04416114021540543,0,3,94
Asia,Mongolia,3170208,2020-05-20,0,0,140,0,0.04416114021540543,0,4,94
Asia,Mongolia,3170208,2020-05-21,0,0,140,0,0.04416114021540543,0,5,94
Asia,Mongolia,3170208,2020-05-22,1,0,141,0,0.04447657693122975,0,6,94
Asia,Mongolia,3170208,2020-05-23,0,0,141,0,0.04447657693122975,0,7,94
Asia,Mongolia,3170208,2020-05-24,0,0,141,0,0.04447657693122975,0,8,94
Asia,Mongolia,3170208,2020-05-25,0,0,141,0,0.04447657693122975,0,9,94
Asia,Mongolia,3170208,2020-05-26,0,0,141,0,0.04447657693122975,0,10,94
Asia,Mongolia,3170208,2020-05-27,7,0,148,0,0.046684633942000016,0,11,94
Europe,Montenegro,622345,2020-03-20,5,0,13,0,0.020888735347757273,0,0,95
Europe,Montenegro,622345,2020-03-21,1,0,14,0,0.0224955611437386,0,1,95
Europe,Montenegro,622345,2020-03-22,0,0,14,0,0.0224955611437386,0,2,95
Europe,Montenegro,622345,2020-03-23,7,0,21,0,0.0337433417156079,0,3,95
Europe,Montenegro,622345,2020-03-24,6,0,27,0,0.043384296491495875,0,4,95
Europe,Montenegro,622345,2020-03-25,20,0,47,0,0.07552081241112245,0,5,95
Europe,Montenegro,622345,2020-03-26,6,0,53,0,0.08516176718701042,0,6,95
Europe,Montenegro,622345,2020-03-27,14,1,67,1,0.10765732833074902,0.014925373134328358,7,95
Europe,Montenegro,622345,2020-03-28,8,0,75,1,0.12051193469859965,0.013333333333333334,8,95
Europe,Montenegro,622345,2020-03-29,9,0,84,1,0.1349733668624316,0.011904761904761904,9,95
Europe,Montenegro,622345,2020-03-30,1,0,85,1,0.13658019265841292,0.011764705882352941,10,95
Europe,Montenegro,622345,2020-03-31,6,0,91,1,0.14622114743430092,0.01098901098901099,11,95
Europe,Montenegro,622345,2020-04-01,18,0,109,1,0.1751440117619648,0.009174311926605505,12,95
Europe,Montenegro,622345,2020-04-02,14,0,123,1,0.19763957290570341,0.008130081300813009,13,95
Europe,Montenegro,622345,2020-04-03,21,1,144,2,0.23138291462131133,0.013888888888888888,14,95
Europe,Montenegro,622345,2020-04-04,30,0,174,2,0.27958768850075116,0.011494252873563218,15,95
Europe,Montenegro,622345,2020-04-05,27,0,201,2,0.32297198499224705,0.009950248756218905,16,95
Europe,Montenegro,622345,2020-04-06,13,0,214,2,0.34386072034000437,0.009345794392523364,17,95
Europe,Montenegro,622345,2020-04-07,19,0,233,2,0.37439041046364957,0.008583690987124463,18,95
Europe,Montenegro,622345,2020-04-08,8,0,241,2,0.3872450168315002,0.008298755186721992,19,95
Europe,Montenegro,622345,2020-04-09,8,0,249,2,0.40009962319935083,0.008032128514056224,20,95
Europe,Montenegro,622345,2020-04-10,3,0,252,2,0.40492010058729483,0.007936507936507936,21,95
Europe,Montenegro,622345,2020-04-11,5,0,257,2,0.41295422956720146,0.007782101167315175,22,95
Europe,Montenegro,622345,2020-04-12,6,0,263,2,0.42259518434308946,0.0076045627376425855,23,95
Europe,Montenegro,622345,2020-04-13,9,1,272,3,0.4370566165069214,0.011029411764705883,24,95
Europe,Montenegro,622345,2020-04-14,2,0,274,3,0.4402702680988841,0.010948905109489052,25,95
Europe,Montenegro,622345,2020-04-15,9,1,283,4,0.45473170026271603,0.014134275618374558,26,95
Europe,Montenegro,622345,2020-04-16,5,0,288,4,0.46276582924262266,0.013888888888888888,27,95
Europe,Montenegro,622345,2020-04-17,15,0,303,4,0.4868682161823426,0.013201320132013201,28,95
Europe,Montenegro,622345,2020-04-18,0,0,303,4,0.4868682161823426,0.013201320132013201,29,95
Europe,Montenegro,622345,2020-04-19,4,1,307,5,0.4932955193662679,0.016286644951140065,30,95
Europe,Montenegro,622345,2020-04-20,1,0,308,5,0.49490234516224924,0.016233766233766232,31,95
Europe,Montenegro,622345,2020-04-21,4,0,312,5,0.50132964834617455,0.016025641025641024,32,95
Europe,Montenegro,622345,2020-04-22,1,0,313,5,0.5029364741421559,0.01597444089456869,33,95
Europe,Montenegro,622345,2020-04-23,2,0,315,5,0.50615012573411855,0.015873015873015872,34,95
Europe,Montenegro,622345,2020-04-24,4,0,319,5,0.5125774289180438,0.01567398119122257,35,95
Europe,Montenegro,622345,2020-04-25,0,1,319,6,0.5125774289180438,0.018808777429467086,36,95
Europe,Montenegro,622345,2020-04-26,1,0,320,6,0.5141842547140252,0.01875,37,95
Europe,Montenegro,622345,2020-04-27,1,1,321,7,0.5157910805100064,0.021806853582554516,38,95
Europe,Montenegro,622345,2020-04-28,0,0,321,7,0.5157910805100064,0.021806853582554516,39,95
Europe,Montenegro,622345,2020-04-29,0,0,321,7,0.5157910805100064,0.021806853582554516,40,95
Europe,Montenegro,622345,2020-04-30,1,0,322,7,0.5173979063059878,0.021739130434782608,41,95
Europe,Montenegro,622345,2020-05-01,0,0,322,7,0.5173979063059878,0.021739130434782608,42,95
Europe,Montenegro,622345,2020-05-02,0,0,322,7,0.5173979063059878,0.021739130434782608,43,95
Europe,Montenegro,622345,2020-05-03,0,0,322,7,0.5173979063059878,0.021739130434782608,44,95
Europe,Montenegro,622345,2020-05-04,0,1,322,8,0.5173979063059878,0.024844720496894408,45,95
Europe,Montenegro,622345,2020-05-05,1,0,323,8,0.5190047321019692,0.02476780185758514,46,95
Europe,Montenegro,622345,2020-05-06,1,0,324,8,0.5206115578979505,0.024691358024691357,47,95
Europe,Montenegro,622345,2020-05-07,0,0,324,8,0.5206115578979505,0.024691358024691357,48,95
Europe,Montenegro,622345,2020-05-08,0,0,324,8,0.5206115578979505,0.024691358024691357,49,95
Europe,Montenegro,622345,2020-05-09,0,0,324,8,0.5206115578979505,0.024691358024691357,50,95
Europe,Montenegro,622345,2020-05-10,0,0,324,8,0.5206115578979505,0.024691358024691357,51,95
Europe,Montenegro,622345,2020-05-11,0,1,324,9,0.5206115578979505,0.027777777777777776,52,95
Europe,Montenegro,622345,2020-05-12,0,0,324,9,0.5206115578979505,0.027777777777777776,53,95
Europe,Montenegro,622345,2020-05-13,0,0,324,9,0.5206115578979505,0.027777777777777776,54,95
Europe,Montenegro,622345,2020-05-14,0,0,324,9,0.5206115578979505,0.027777777777777776,55,95
Europe,Montenegro,622345,2020-05-15,0,0,324,9,0.5206115578979505,0.027777777777777776,56,95
Europe,Montenegro,622345,2020-05-16,0,0,324,9,0.5206115578979505,0.027777777777777776,57,95
Europe,Montenegro,622345,2020-05-17,0,0,324,9,0.5206115578979505,0.027777777777777776,58,95
Europe,Montenegro,622345,2020-05-18,0,0,324,9,0.5206115578979505,0.027777777777777776,59,95
Europe,Montenegro,622345,2020-05-19,0,0,324,9,0.5206115578979505,0.027777777777777776,60,95
Europe,Montenegro,622345,2020-05-20,0,0,324,9,0.5206115578979505,0.027777777777777776,61,95
Europe,Montenegro,622345,2020-05-21,0,0,324,9,0.5206115578979505,0.027777777777777776,62,95
Europe,Montenegro,622345,2020-05-22,0,0,324,9,0.5206115578979505,0.027777777777777776,63,95
Europe,Montenegro,622345,2020-05-23,0,0,324,9,0.5206115578979505,0.027777777777777776,64,95
Europe,Montenegro,622345,2020-05-24,0,0,324,9,0.5206115578979505,0.027777777777777776,65,95
Europe,Montenegro,622345,2020-05-25,0,0,324,9,0.5206115578979505,0.027777777777777776,66,95
Europe,Montenegro,622345,2020-05-26,0,0,324,9,0.5206115578979505,0.027777777777777776,67,95
Europe,Montenegro,622345,2020-05-27,0,0,324,9,0.5206115578979505,0.027777777777777776,68,95
Africa,Morocco,36029138,2020-04-05,211,15,919,59,0.025507132588073574,0.06420021762785637,0,96
Africa,Morocco,36029138,2020-04-06,102,11,1021,70,0.02833817450753332,0.06856023506366307,1,96
Africa,Morocco,36029138,2020-04-07,99,10,1120,80,0.031085950488185424,0.07142857142857142,2,96
Africa,Morocco,36029138,2020-04-08,64,10,1184,90,0.032862290516081735,0.07601351351351351,3,96
Africa,Morocco,36029138,2020-04-09,91,3,1275,93,0.0353880239932468,0.07294117647058823,4,96
Africa,Morocco,36029138,2020-04-10,99,4,1374,97,0.038135799973898904,0.07059679767103348,5,96
Africa,Morocco,36029138,2020-04-11,74,10,1448,107,0.04018969313115401,0.0738950276243094,6,96
Africa,Morocco,36029138,2020-04-12,97,4,1545,111,0.04288195848593436,0.07184466019417475,7,96
Africa,Morocco,36029138,2020-04-13,116,7,1661,118,0.046101574786496416,0.07104154124021674,8,96
Africa,Morocco,36029138,2020-04-14,102,8,1763,126,0.04893261670595617,0.07146908678389109,9,96
Africa,Morocco,36029138,2020-04-15,125,0,1888,126,0.05240203082294114,0.06673728813559322,10,96
Africa,Morocco,36029138,2020-04-16,136,1,2024,127,0.056176753382220806,0.06274703557312253,11,96
Africa,Morocco,36029138,2020-04-17,259,3,2283,130,0.06336537943261368,0.05694261936049058,12,96
Africa,Morocco,36029138,2020-04-18,281,5,2564,135,0.07116462236759592,0.052652106084243366,13,96
Africa,Morocco,36029138,2020-04-19,121,2,2685,137,0.07452301523283737,0.05102420856610801,14,96
Africa,Morocco,36029138,2020-04-20,170,4,2855,141,0.07924141843193695,0.04938704028021016,15,96
Africa,Morocco,36029138,2020-04-21,191,2,3046,143,0.08454268320269,0.04694681549573211,16,96
Africa,Morocco,36029138,2020-04-22,163,2,3209,145,0.08906679921123842,0.04518541601745092,17,96
Africa,Morocco,36029138,2020-04-23,168,4,3377,149,0.09372969178446623,0.0441220017767249,18,96
Africa,Morocco,36029138,2020-04-24,191,6,3568,155,0.09903095655521928,0.04344170403587444,19,96
Africa,Morocco,36029138,2020-04-25,190,3,3758,158,0.10430446601303645,0.04204364023416711,20,96
Africa,Morocco,36029138,2020-04-26,139,1,3897,159,0.10816245451112375,0.04080061585835258,21,96
Africa,Morocco,36029138,2020-04-27,168,2,4065,161,0.11282534708435156,0.03960639606396064,22,96
Africa,Morocco,36029138,2020-04-28,55,1,4120,162,0.11435188929582496,0.03932038834951456,23,96
Africa,Morocco,36029138,2020-04-29,132,3,4252,165,0.11801559060336109,0.038805268109125116,24,96
Africa,Morocco,36029138,2020-04-30,69,3,4321,168,0.1199307071959368,0.0388798889146031,25,96
Africa,Morocco,36029138,2020-05-01,102,2,4423,170,0.12276174911539654,0.03843545105132263,26,96
Africa,Morocco,36029138,2020-05-02,146,1,4569,171,0.12681402480403497,0.03742613263296126,27,96
Africa,Morocco,36029138,2020-05-03,160,2,4729,173,0.13125487487377577,0.036582787058574755,28,96
Africa,Morocco,36029138,2020-05-04,174,1,4903,174,0.13608429932461888,0.035488476442994084,29,96
Africa,Morocco,36029138,2020-05-05,140,5,5043,179,0.13997004313564204,0.03549474519135435,30,96
Africa,Morocco,36029138,2020-05-06,176,2,5219,181,0.1448549782123569,0.03468097336654531,31,96
Africa,Morocco,36029138,2020-05-07,189,2,5408,183,0.15010073235723817,0.033838757396449703,32,96
Africa,Morocco,36029138,2020-05-08,140,0,5548,183,0.15398647616826136,0.03298485940879596,33,96
Africa,Morocco,36029138,2020-05-09,163,3,5711,186,0.1585105921768098,0.03256872701803537,34,96
Africa,Morocco,36029138,2020-05-10,199,0,5910,186,0.16403389945104987,0.03147208121827411,35,96
Africa,Morocco,36029138,2020-05-11,153,2,6063,188,0.16828046233023947,0.031007751937984496,36,96
Africa,Morocco,36029138,2020-05-12,218,0,6281,188,0.1743311205502613,0.02993153956376373,37,96
Africa,Morocco,36029138,2020-05-13,137,0,6418,188,0.17813359842247684,0.029292614521657837,38,96
Africa,Morocco,36029138,2020-05-14,94,0,6512,188,0.18074259783844954,0.02886977886977887,39,96
Africa,Morocco,36029138,2020-05-15,95,2,6607,190,0.18337935256735813,0.028757378537914335,40,96
Africa,Morocco,36029138,2020-05-16,45,0,6652,190,0.1846283416494727,0.028562838244137103,41,96
Africa,Morocco,36029138,2020-05-17,89,2,6741,192,0.18709856450076603,0.02848242100578549,42,96
Africa,Morocco,36029138,2020-05-18,129,0,6870,192,0.19067899986949452,0.02794759825327511,43,96
Africa,Morocco,36029138,2020-05-19,82,0,6952,192,0.19295493553023668,0.02761795166858458,44,96
Africa,Morocco,36029138,2020-05-20,71,1,7023,193,0.19492556274868414,0.027481133418766908,45,96
Africa,Morocco,36029138,2020-05-21,110,1,7133,194,0.1979786471716309,0.027197532594981075,46,96
Africa,Morocco,36029138,2020-05-22,78,2,7211,196,0.20014356158062957,0.027180696158646513,47,96
Africa,Morocco,36029138,2020-05-23,121,1,7332,197,0.203501954445871,0.026868521549372613,48,96
Africa,Morocco,36029138,2020-05-24,74,1,7406,198,0.20555584760312612,0.026735079665136375,49,96
Africa,Morocco,36029138,2020-05-25,27,1,7433,199,0.20630524105239487,0.026772501009013856,50,96
Africa,Morocco,36029138,2020-05-26,99,1,7532,200,0.20905301703304696,0.026553372278279343,51,96
Africa,Morocco,36029138,2020-05-27,45,2,7577,202,0.21030200611516156,0.02665962782103735,52,96
Europe,Netherlands,17231017,2020-03-11,61,1,382,4,0.022169324074139095,0.010471204188481676,0,97
Europe,Netherlands,17231017,2020-03-12,121,1,503,5,0.029191544526942316,0.009940357852882704,1,97
Europe,Netherlands,17231017,2020-03-13,111,0,614,5,0.0356334161819932,0.008143322475570033,2,97
Europe,Netherlands,17231017,2020-03-14,190,0,804,5,0.04666004333928752,0.006218905472636816,3,97
Europe,Netherlands,17231017,2020-03-15,155,7,959,12,0.05565544970444867,0.01251303441084463,4,97
Europe,Netherlands,17231017,2020-03-16,176,8,1135,20,0.06586958854488972,0.01762114537444934,5,97
Europe,Netherlands,17231017,2020-03-17,278,4,1413,24,0.08200328512240457,0.016985138004246284,6,97
Europe,Netherlands,17231017,2020-03-18,292,19,1705,43,0.09894947001677266,0.025219941348973606,7,97
Europe,Netherlands,17231017,2020-03-19,346,15,2051,58,0.11902953841900335,0.028278888347147733,8,97
Europe,Netherlands,17231017,2020-03-20,409,18,2460,76,0.14276580424707375,0.030894308943089432,9,97
Europe,Netherlands,17231017,2020-03-21,534,30,2994,106,0.1737564300470483,0.035404141616566465,10,97
Europe,Netherlands,17231017,2020-03-22,637,30,3631,136,0.21072464846387187,0.03745524648857064,11,97
Europe,Netherlands,17231017,2020-03-23,573,43,4204,179,0.2439786345750805,0.04257849666983825,12,97
Europe,Netherlands,17231017,2020-03-24,545,34,4749,213,0.27560764405258265,0.04485154769425142,13,97
Europe,Netherlands,17231017,2020-03-25,811,63,5560,276,0.3226739315502967,0.04964028776978417,14,97
Europe,Netherlands,17231017,2020-03-26,852,80,6412,356,0.37211964911879547,0.05552089831565814,15,97
Europe,Netherlands,17231017,2020-03-27,1019,78,7431,434,0.4312571916097582,0.058403983313147625,16,97
Europe,Netherlands,17231017,2020-03-28,1172,112,8603,546,0.4992740707063315,0.06346623270951994,17,97
Europe,Netherlands,17231017,2020-03-29,1159,93,9762,639,0.5665364963658268,0.0654578979717271,18,97
Europe,Netherlands,17231017,2020-03-30,1104,132,10866,771,0.6306070036376843,0.07095527332965212,19,97
Europe,Netherlands,17231017,2020-03-31,884,93,11750,864,0.6819098373589905,0.07353191489361702,20,97
Europe,Netherlands,17231017,2020-04-01,845,175,12595,1039,0.7309493107690626,0.08249305279872965,21,97
Europe,Netherlands,17231017,2020-04-02,1019,134,13614,1173,0.7900868532600251,0.08616130453944469,22,97
Europe,Netherlands,17231017,2020-04-03,1083,166,14697,1339,0.8529386280566028,0.09110702864530176,23,97
Europe,Netherlands,17231017,2020-04-04,1026,148,15723,1487,0.9124824147059921,0.09457482668701901,24,97
Europe,Netherlands,17231017,2020-04-05,904,164,16627,1651,0.964945946022803,0.09929632525410477,25,97
Europe,Netherlands,17231017,2020-04-06,1224,115,17851,1766,1.0359806388676884,0.09893003193098426,26,97
Europe,Netherlands,17231017,2020-04-07,952,101,18803,1867,1.0912298444137103,0.09929266606392596,27,97
Europe,Netherlands,17231017,2020-04-08,777,234,19580,2101,1.1363229459990667,0.10730337078651686,28,97
Europe,Netherlands,17231017,2020-04-09,969,147,20549,2248,1.1925587445012678,0.1093970509513845,29,97
Europe,Netherlands,17231017,2020-04-10,1213,148,21762,2396,1.2629550536686256,0.11010017461630364,30,97
Europe,Netherlands,17231017,2020-04-11,1335,115,23097,2511,1.3404316181685618,0.10871541758669957,31,97
Europe,Netherlands,17231017,2020-04-12,1316,132,24413,2643,1.416805519952769,0.10826199156187277,32,97
Europe,Netherlands,17231017,2020-04-13,1174,94,25587,2737,1.4849384688088927,0.10696838238167819,33,97
Europe,Netherlands,17231017,2020-04-14,964,86,26551,2823,1.5408840929122176,0.10632367895747806,34,97
Europe,Netherlands,17231017,2020-04-15,868,122,27419,2945,1.59125836855712,0.10740727232940661,35,97
Europe,Netherlands,17231017,2020-04-16,734,189,28153,3134,1.6338559703121411,0.11132028558235357,36,97
Europe,Netherlands,17231017,2020-04-17,1061,181,29214,3315,1.6954309777536636,0.11347299240090368,37,97
Europe,Netherlands,17231017,2020-04-18,1235,144,30449,3459,1.7671040542760768,0.11359978981247332,38,97
Europe,Netherlands,17231017,2020-04-19,1140,142,31589,3601,1.8332638172198426,0.11399537813795942,39,97
Europe,Netherlands,17231017,2020-04-20,1066,83,32655,3684,1.8951289990602413,0.11281580156178227,40,97
Europe,Netherlands,17231017,2020-04-21,750,67,33405,3751,1.938655158891666,0.11228857955395899,41,97
Europe,Netherlands,17231017,2020-04-22,729,165,34134,3916,1.9809625862478113,0.11472432179059003,42,97
Europe,Netherlands,17231017,2020-04-23,708,138,34842,4054,2.022051281128676,0.11635382584237415,43,97
Europe,Netherlands,17231017,2020-04-24,887,123,35729,4177,2.073528219489308,0.11690783397240337,44,97
Europe,Netherlands,17231017,2020-04-25,806,112,36535,4289,2.1203043325881463,0.11739427945805392,45,97
Europe,Netherlands,17231017,2020-04-26,655,120,37190,4409,2.1583171788409237,0.11855337456305458,46,97
Europe,Netherlands,17231017,2020-04-27,655,66,37845,4475,2.1963300250937015,0.1182454749636676,47,97
Europe,Netherlands,17231017,2020-04-28,400,43,38245,4518,2.2195439770037946,0.118133089292718,48,97
Europe,Netherlands,17231017,2020-04-29,171,48,38416,4566,2.22946794144536,0.118856726364015,49,97
Europe,Netherlands,17231017,2020-04-30,386,145,38802,4711,2.2518694050386,0.12141126746044019,50,97
Europe,Netherlands,17231017,2020-05-01,514,84,39316,4795,2.2816993332430697,0.12196052497710856,51,97
Europe,Netherlands,17231017,2020-05-02,475,98,39791,4893,2.3092659011363055,0.12296750521474706,52,97
Europe,Netherlands,17231017,2020-05-03,445,94,40236,4987,2.335091422636284,0.12394373198131027,53,97
Europe,Netherlands,17231017,2020-05-04,335,69,40571,5056,2.3545331073609876,0.1246210347292401,54,97
Europe,Netherlands,17231017,2020-05-05,199,26,40770,5082,2.3660820484362586,0.1246504782928624,55,97
Europe,Netherlands,17231017,2020-05-06,317,86,41087,5168,2.384479105325008,0.12578187747949474,56,97
Europe,Netherlands,17231017,2020-05-07,232,36,41319,5204,2.3979431974328618,0.1259469009414555,57,97
Europe,Netherlands,17231017,2020-05-08,455,84,41774,5288,2.424349067730593,0.1265859146837746,58,97
Europe,Netherlands,17231017,2020-05-09,319,71,42093,5359,2.4428621943788924,0.12731333000736464,59,97
Europe,Netherlands,17231017,2020-05-10,289,63,42382,5422,2.459634274633935,0.12793166910480863,60,97
Europe,Netherlands,17231017,2020-05-11,245,18,42627,5440,2.473852820178867,0.1276186454594506,61,97
Europe,Netherlands,17231017,2020-05-12,161,16,42788,5456,2.4831964358226797,0.12751238665046274,62,97
Europe,Netherlands,17231017,2020-05-13,196,54,42984,5510,2.494571272258625,0.12818723245858923,63,97
Europe,Netherlands,17231017,2020-05-14,227,52,43211,5562,2.5077451899676033,0.12871722478072714,64,97
Europe,Netherlands,17231017,2020-05-15,270,28,43481,5590,2.523414607506916,0.12856190060026218,65,97
Europe,Netherlands,17231017,2020-05-16,200,53,43681,5643,2.5350215834619627,0.1291866028708134,66,97
Europe,Netherlands,17231017,2020-05-17,189,27,43870,5670,2.545990175739482,0.12924549806245725,67,97
Europe,Netherlands,17231017,2020-05-18,125,10,43995,5680,2.5532445357113858,0.12910558017956586,68,97
Europe,Netherlands,17231017,2020-05-19,146,14,44141,5694,2.5617176281585703,0.12899571826646428,69,97
Europe,Netherlands,17231017,2020-05-20,108,21,44249,5715,2.5679853951742952,0.12915546114036475,70,97
Europe,Netherlands,17231017,2020-05-21,198,33,44447,5748,2.5794763013697914,0.12932256395257272,71,97
Europe,Netherlands,17231017,2020-05-22,253,27,44700,5775,2.5941591259529257,0.12919463087248323,72,97
Europe,Netherlands,17231017,2020-05-23,188,13,44888,5788,2.6050696833506692,0.1289431473890572,73,97
Europe,Netherlands,17231017,2020-05-24,176,23,45064,5811,2.61528382219111,0.12894993786614592,74,97
Europe,Netherlands,17231017,2020-05-25,172,11,45236,5822,2.6252658215124502,0.12870280307719514,75,97
Europe,Netherlands,17231017,2020-05-26,209,8,45445,5830,2.637395111385474,0.12828694025745407,76,97
Europe,Netherlands,17231017,2020-05-27,133,26,45578,5856,2.6451137503955806,0.1284830400631884,77,97
Oceania,New Caledonia,284060,2020-03-24,2,0,7,0,0.02464268112370626,0,0,98
Oceania,New Caledonia,284060,2020-03-25,2,0,9,0,0.0316834471590509,0,1,98
Oceania,New Caledonia,284060,2020-03-26,5,0,14,0,0.04928536224741252,0,2,98
Oceania,New Caledonia,284060,2020-03-27,1,0,15,0,0.052805745265084844,0,3,98
Oceania,New Caledonia,284060,2020-03-28,0,0,15,0,0.052805745265084844,0,4,98
Oceania,New Caledonia,284060,2020-03-29,0,0,15,0,0.052805745265084844,0,5,98
Oceania,New Caledonia,284060,2020-03-30,0,0,15,0,0.052805745265084844,0,6,98
Oceania,New Caledonia,284060,2020-03-31,1,0,16,0,0.05632612828275716,0,7,98
Oceania,New Caledonia,284060,2020-04-01,0,0,16,0,0.05632612828275716,0,8,98
Oceania,New Caledonia,284060,2020-04-02,0,0,16,0,0.05632612828275716,0,9,98
Oceania,New Caledonia,284060,2020-04-03,0,0,16,0,0.05632612828275716,0,10,98
Oceania,New Caledonia,284060,2020-04-04,2,0,18,0,0.0633668943181018,0,11,98
Oceania,New Caledonia,284060,2020-04-05,0,0,18,0,0.0633668943181018,0,12,98
Oceania,New Caledonia,284060,2020-04-06,0,0,18,0,0.0633668943181018,0,13,98
Oceania,New Caledonia,284060,2020-04-07,0,0,18,0,0.0633668943181018,0,14,98
Oceania,New Caledonia,284060,2020-04-08,0,0,18,0,0.0633668943181018,0,15,98
Oceania,New Caledonia,284060,2020-04-09,0,0,18,0,0.0633668943181018,0,16,98
Oceania,New Caledonia,284060,2020-04-10,0,0,18,0,0.0633668943181018,0,17,98
Oceania,New Caledonia,284060,2020-04-11,0,0,18,0,0.0633668943181018,0,18,98
Oceania,New Caledonia,284060,2020-04-12,0,0,18,0,0.0633668943181018,0,19,98
Oceania,New Caledonia,284060,2020-04-13,0,0,18,0,0.0633668943181018,0,20,98
Oceania,New Caledonia,284060,2020-04-14,0,0,18,0,0.0633668943181018,0,21,98
Oceania,New Caledonia,284060,2020-04-15,0,0,18,0,0.0633668943181018,0,22,98
Oceania,New Caledonia,284060,2020-04-16,0,0,18,0,0.0633668943181018,0,23,98
Oceania,New Caledonia,284060,2020-04-17,0,0,18,0,0.0633668943181018,0,24,98
Oceania,New Caledonia,284060,2020-04-18,0,0,18,0,0.0633668943181018,0,25,98
Oceania,New Caledonia,284060,2020-04-19,0,0,18,0,0.0633668943181018,0,26,98
Oceania,New Caledonia,284060,2020-04-20,0,0,18,0,0.0633668943181018,0,27,98
Oceania,New Caledonia,284060,2020-04-21,0,0,18,0,0.0633668943181018,0,28,98
Oceania,New Caledonia,284060,2020-04-22,0,0,18,0,0.0633668943181018,0,29,98
Oceania,New Caledonia,284060,2020-04-23,0,0,18,0,0.0633668943181018,0,30,98
Oceania,New Caledonia,284060,2020-04-24,0,0,18,0,0.0633668943181018,0,31,98
Oceania,New Caledonia,284060,2020-04-25,0,0,18,0,0.0633668943181018,0,32,98
Oceania,New Caledonia,284060,2020-04-26,0,0,18,0,0.0633668943181018,0,33,98
Oceania,New Caledonia,284060,2020-04-27,0,0,18,0,0.0633668943181018,0,34,98
Oceania,New Caledonia,284060,2020-04-28,0,0,18,0,0.0633668943181018,0,35,98
Oceania,New Caledonia,284060,2020-04-29,0,0,18,0,0.0633668943181018,0,36,98
Oceania,New Caledonia,284060,2020-04-30,0,0,18,0,0.0633668943181018,0,37,98
Oceania,New Caledonia,284060,2020-05-01,0,0,18,0,0.0633668943181018,0,38,98
Oceania,New Caledonia,284060,2020-05-02,0,0,18,0,0.0633668943181018,0,39,98
Oceania,New Caledonia,284060,2020-05-03,0,0,18,0,0.0633668943181018,0,40,98
Oceania,New Caledonia,284060,2020-05-04,0,0,18,0,0.0633668943181018,0,41,98
Oceania,New Caledonia,284060,2020-05-05,0,0,18,0,0.0633668943181018,0,42,98
Oceania,New Caledonia,284060,2020-05-06,0,0,18,0,0.0633668943181018,0,43,98
Oceania,New Caledonia,284060,2020-05-07,0,0,18,0,0.0633668943181018,0,44,98
Oceania,New Caledonia,284060,2020-05-08,0,0,18,0,0.0633668943181018,0,45,98
Oceania,New Caledonia,284060,2020-05-09,0,0,18,0,0.0633668943181018,0,46,98
Oceania,New Caledonia,284060,2020-05-10,0,0,18,0,0.0633668943181018,0,47,98
Oceania,New Caledonia,284060,2020-05-11,0,0,18,0,0.0633668943181018,0,48,98
Oceania,New Caledonia,284060,2020-05-12,0,0,18,0,0.0633668943181018,0,49,98
Oceania,New Caledonia,284060,2020-05-13,0,0,18,0,0.0633668943181018,0,50,98
Oceania,New Caledonia,284060,2020-05-14,0,0,18,0,0.0633668943181018,0,51,98
Oceania,New Caledonia,284060,2020-05-15,0,0,18,0,0.0633668943181018,0,52,98
Oceania,New Caledonia,284060,2020-05-16,0,0,18,0,0.0633668943181018,0,53,98
Oceania,New Caledonia,284060,2020-05-17,0,0,18,0,0.0633668943181018,0,54,98
Oceania,New Caledonia,284060,2020-05-18,0,0,18,0,0.0633668943181018,0,55,98
Oceania,New Caledonia,284060,2020-05-19,0,0,18,0,0.0633668943181018,0,56,98
Oceania,New Caledonia,284060,2020-05-20,0,0,18,0,0.0633668943181018,0,57,98
Oceania,New Caledonia,284060,2020-05-21,0,0,18,0,0.0633668943181018,0,58,98
Oceania,New Caledonia,284060,2020-05-22,0,0,18,0,0.0633668943181018,0,59,98
Oceania,New Caledonia,284060,2020-05-23,0,0,18,0,0.0633668943181018,0,60,98
Oceania,New Caledonia,284060,2020-05-24,0,0,18,0,0.0633668943181018,0,61,98
Oceania,New Caledonia,284060,2020-05-25,0,0,18,0,0.0633668943181018,0,62,98
Oceania,New Caledonia,284060,2020-05-26,0,0,18,0,0.0633668943181018,0,63,98
Oceania,New Caledonia,284060,2020-05-27,0,0,18,0,0.0633668943181018,0,64,98
Oceania,New Zealand,4885500,2020-03-23,36,0,102,0,0.020878108688977586,0,0,99
Oceania,New Zealand,4885500,2020-03-24,40,0,142,0,0.02906560229249821,0,1,99
Oceania,New Zealand,4885500,2020-03-25,47,0,189,0,0.038685907276634936,0,2,99
Oceania,New Zealand,4885500,2020-03-26,73,0,262,0,0.053628083103060074,0,3,99
Oceania,New Zealand,4885500,2020-03-27,76,0,338,0,0.06918432094974926,0,4,99
Oceania,New Zealand,4885500,2020-03-28,78,0,416,0,0.08514993347661447,0,5,99
Oceania,New Zealand,4885500,2020-03-29,60,1,476,1,0.09743117388189541,0.0021008403361344537,6,99
Oceania,New Zealand,4885500,2020-03-30,76,0,552,1,0.11298741172858458,0.0018115942028985507,7,99
Oceania,New Zealand,4885500,2020-03-31,95,0,647,1,0.13243270903694607,0.0015455950540958269,8,99
Oceania,New Zealand,4885500,2020-04-01,0,0,647,1,0.13243270903694607,0.0015455950540958269,9,99
Oceania,New Zealand,4885500,2020-04-02,76,0,723,1,0.14798894688363523,0.0013831258644536654,10,99
Oceania,New Zealand,4885500,2020-04-03,49,0,772,1,0.15801862654794802,0.0012953367875647669,11,99
Oceania,New Zealand,4885500,2020-04-04,52,0,824,1,0.16866236823252484,0.0012135922330097086,12,99
Oceania,New Zealand,4885500,2020-04-05,48,0,872,1,0.17848736055674957,0.0011467889908256881,13,99
Oceania,New Zealand,4885500,2020-04-06,39,0,911,1,0.18647016682018216,0.0010976948408342481,14,99
Oceania,New Zealand,4885500,2020-04-07,32,0,943,1,0.19302016170299865,0.0010604453870625664,15,99
Oceania,New Zealand,4885500,2020-04-08,26,0,969,1,0.1983420325452871,0.0010319917440660474,16,99
Oceania,New Zealand,4885500,2020-04-09,23,0,992,1,0.2030498413673114,0.0010080645161290322,17,99
Oceania,New Zealand,4885500,2020-04-10,23,1,1015,2,0.20775765018933579,0.0019704433497536944,18,99
Oceania,New Zealand,4885500,2020-04-11,20,2,1035,4,0.2118513969910961,0.003864734299516908,19,99
Oceania,New Zealand,4885500,2020-04-12,14,0,1049,4,0.21471701975232832,0.0038131553860819827,20,99
Oceania,New Zealand,4885500,2020-04-13,15,1,1064,5,0.21778732985364854,0.004699248120300752,21,99
Oceania,New Zealand,4885500,2020-04-14,8,4,1072,9,0.21942482857435266,0.008395522388059701,22,99
Oceania,New Zealand,4885500,2020-04-15,6,0,1078,9,0.22065295261488077,0.008348794063079777,23,99
Oceania,New Zealand,4885500,2020-04-16,6,0,1084,9,0.22188107665540885,0.008302583025830259,24,99
Oceania,New Zealand,4885500,2020-04-17,2,2,1086,11,0.2222904513355849,0.010128913443830571,25,99
Oceania,New Zealand,4885500,2020-04-18,8,0,1094,11,0.22392795005628902,0.010054844606946984,26,99
Oceania,New Zealand,4885500,2020-04-19,4,1,1098,12,0.2247466994166411,0.01092896174863388,27,99
Oceania,New Zealand,4885500,2020-04-20,7,0,1105,12,0.22617951079725718,0.01085972850678733,28,99
Oceania,New Zealand,4885500,2020-04-21,2,1,1107,13,0.22658888547743322,0.011743450767841012,29,99
Oceania,New Zealand,4885500,2020-04-22,5,1,1112,14,0.2276123221778733,0.012589928057553957,30,99
Oceania,New Zealand,4885500,2020-04-23,0,2,1112,16,0.2276123221778733,0.014388489208633094,31,99
Oceania,New Zealand,4885500,2020-04-24,2,1,1114,17,0.22802169685804935,0.01526032315978456,32,99
Oceania,New Zealand,4885500,2020-04-25,3,1,1117,18,0.2286357588783134,0.01611459265890779,33,99
Oceania,New Zealand,4885500,2020-04-26,4,0,1121,18,0.22945450823866542,0.016057091882247992,34,99
Oceania,New Zealand,4885500,2020-04-27,1,1,1122,19,0.22965919557875344,0.01693404634581105,35,99
Oceania,New Zealand,4885500,2020-04-28,2,0,1124,19,0.2300685702589295,0.016903914590747332,36,99
Oceania,New Zealand,4885500,2020-04-29,2,0,1126,19,0.2304779449391055,0.016873889875666074,37,99
Oceania,New Zealand,4885500,2020-04-30,3,0,1129,19,0.23109200695936957,0.01682905225863596,38,99
Oceania,New Zealand,4885500,2020-05-01,3,0,1132,19,0.2317060689796336,0.01678445229681979,39,99
Oceania,New Zealand,4885500,2020-05-02,2,1,1134,20,0.23211544365980966,0.01763668430335097,40,99
Oceania,New Zealand,4885500,2020-05-03,2,0,1136,20,0.23252481833998567,0.017605633802816902,41,99
Oceania,New Zealand,4885500,2020-05-04,1,0,1137,20,0.23272950568007367,0.01759014951627089,42,99
Oceania,New Zealand,4885500,2020-05-05,0,0,1137,20,0.23272950568007367,0.01759014951627089,43,99
Oceania,New Zealand,4885500,2020-05-06,1,1,1138,21,0.2329341930201617,0.01845342706502636,44,99
Oceania,New Zealand,4885500,2020-05-07,1,0,1139,21,0.2331388803602497,0.018437225636523266,45,99
Oceania,New Zealand,4885500,2020-05-08,2,0,1141,21,0.23354825504042576,0.018404907975460124,46,99
Oceania,New Zealand,4885500,2020-05-09,1,0,1142,21,0.23375294238051375,0.01838879159369527,47,99
Oceania,New Zealand,4885500,2020-05-10,2,0,1144,21,0.2341623170606898,0.018356643356643356,48,99
Oceania,New Zealand,4885500,2020-05-11,3,0,1147,21,0.23477637908095383,0.018308631211857017,49,99
Oceania,New Zealand,4885500,2020-05-12,0,0,1147,21,0.23477637908095383,0.018308631211857017,50,99
Oceania,New Zealand,4885500,2020-05-13,0,0,1147,21,0.23477637908095383,0.018308631211857017,51,99
Oceania,New Zealand,4885500,2020-05-14,0,0,1147,21,0.23477637908095383,0.018308631211857017,52,99
Oceania,New Zealand,4885500,2020-05-15,1,0,1148,21,0.23498106642104186,0.018292682926829267,53,99
Oceania,New Zealand,4885500,2020-05-16,0,0,1148,21,0.23498106642104186,0.018292682926829267,54,99
Oceania,New Zealand,4885500,2020-05-17,1,0,1149,21,0.23518575376112988,0.018276762402088774,55,99
Oceania,New Zealand,4885500,2020-05-18,0,0,1149,21,0.23518575376112988,0.018276762402088774,56,99
Oceania,New Zealand,4885500,2020-05-19,4,0,1153,21,0.23600450312148194,0.01821335646140503,57,99
Oceania,New Zealand,4885500,2020-05-20,0,0,1153,21,0.23600450312148194,0.01821335646140503,58,99
Oceania,New Zealand,4885500,2020-05-21,0,0,1153,21,0.23600450312148194,0.01821335646140503,59,99
Oceania,New Zealand,4885500,2020-05-22,1,0,1154,21,0.23620919046156996,0.018197573656845753,60,99
Oceania,New Zealand,4885500,2020-05-23,0,0,1154,21,0.23620919046156996,0.018197573656845753,61,99
Oceania,New Zealand,4885500,2020-05-24,0,0,1154,21,0.23620919046156996,0.018197573656845753,62,99
Oceania,New Zealand,4885500,2020-05-25,0,0,1154,21,0.23620919046156996,0.018197573656845753,63,99
Oceania,New Zealand,4885500,2020-05-26,0,0,1154,21,0.23620919046156996,0.018197573656845753,64,99
Oceania,New Zealand,4885500,2020-05-27,0,0,1154,21,0.23620919046156996,0.018197573656845753,65,99
Africa,Niger,22442948,2020-04-12,53,0,491,11,0.021877696281255028,0.02240325865580448,0,100
Africa,Niger,22442948,2020-04-13,38,1,529,12,0.02357087847817497,0.022684310018903593,1,100
Africa,Niger,22442948,2020-04-14,19,1,548,13,0.024417469576634942,0.023722627737226276,2,100
Africa,Niger,22442948,2020-04-15,22,1,570,14,0.02539773295379912,0.02456140350877193,3,100
Africa,Niger,22442948,2020-04-16,14,0,584,14,0.026021536921085414,0.023972602739726026,4,100
Africa,Niger,22442948,2020-04-17,25,1,609,15,0.027135472576953795,0.024630541871921183,5,100
Africa,Niger,22442948,2020-04-18,18,3,627,18,0.02793750624917903,0.028708133971291867,6,100
Africa,Niger,22442948,2020-04-19,12,1,639,19,0.028472195363995853,0.0297339593114241,7,100
Africa,Niger,22442948,2020-04-20,9,1,648,20,0.02887321220010847,0.030864197530864196,8,100
Africa,Niger,22442948,2020-04-21,7,0,655,20,0.02918511418375162,0.030534351145038167,9,100
Africa,Niger,22442948,2020-04-22,0,0,655,20,0.02918511418375162,0.030534351145038167,10,100
Africa,Niger,22442948,2020-04-23,7,2,662,22,0.029497016167394762,0.03323262839879154,11,100
Africa,Niger,22442948,2020-04-24,9,2,671,24,0.029898033003507383,0.03576751117734724,12,100
Africa,Niger,22442948,2020-04-25,10,0,681,24,0.030343607265854736,0.03524229074889868,13,100
Africa,Niger,22442948,2020-04-26,3,3,684,27,0.030477279544558943,0.039473684210526314,14,100
Africa,Niger,22442948,2020-04-27,12,2,696,29,0.031011968659375767,0.041666666666666664,15,100
Africa,Niger,22442948,2020-04-28,5,0,701,29,0.03123475579054944,0.04136947218259629,16,100
Africa,Niger,22442948,2020-04-29,8,2,709,31,0.031591215200427326,0.04372355430183357,17,100
Africa,Niger,22442948,2020-04-30,4,1,713,32,0.03176944490536626,0.04488078541374474,18,100
Africa,Niger,22442948,2020-05-01,6,0,719,32,0.032036789462774676,0.04450625869262865,19,100
Africa,Niger,22442948,2020-05-02,9,1,728,33,0.03243780629888729,0.04532967032967033,20,100
Africa,Niger,22442948,2020-05-03,8,2,736,35,0.032794265708765175,0.04755434782608696,21,100
Africa,Niger,22442948,2020-05-04,14,1,750,36,0.03341806967605147,0.048,22,100
Africa,Niger,22442948,2020-05-05,5,1,755,37,0.033640856807225145,0.04900662251655629,23,100
Africa,Niger,22442948,2020-05-06,8,1,763,38,0.03399731621710303,0.04980340760157274,24,100
Africa,Niger,22442948,2020-05-07,7,0,770,38,0.03430921820074617,0.04935064935064935,25,100
Africa,Niger,22442948,2020-05-08,11,4,781,42,0.034799349889328264,0.05377720870678617,26,100
Africa,Niger,22442948,2020-05-09,14,2,795,44,0.035423153856614556,0.055345911949685536,27,100
Africa,Niger,22442948,2020-05-10,20,1,815,45,0.03631430238130927,0.05521472392638037,28,100
Africa,Niger,22442948,2020-05-11,6,1,821,46,0.036581646938717675,0.05602923264311815,29,100
Africa,Niger,22442948,2020-05-12,11,0,832,46,0.03707177862729977,0.055288461538461536,30,100
Africa,Niger,22442948,2020-05-13,22,1,854,47,0.03805204200446394,0.05503512880562061,31,100
Africa,Niger,22442948,2020-05-14,6,2,860,49,0.03831938656187235,0.056976744186046514,32,100
Africa,Niger,22442948,2020-05-15,16,1,876,50,0.039032305381628114,0.05707762557077625,33,100
Africa,Niger,22442948,2020-05-16,9,1,885,51,0.039433322217740735,0.0576271186440678,34,100
Africa,Niger,22442948,2020-05-17,4,0,889,51,0.03961155192267968,0.05736782902137233,35,100
Africa,Niger,22442948,2020-05-18,15,3,904,54,0.04027991331620071,0.059734513274336286,36,100
Africa,Niger,22442948,2020-05-19,5,1,909,55,0.04050270044737438,0.06050605060506051,37,100
Africa,Niger,22442948,2020-05-20,5,0,914,55,0.04072548757854806,0.060175054704595186,38,100
Africa,Niger,22442948,2020-05-21,6,3,920,58,0.04099283213595647,0.06304347826086956,39,100
Africa,Niger,22442948,2020-05-22,4,2,924,60,0.04117106184089541,0.06493506493506493,40,100
Africa,Niger,22442948,2020-05-23,13,0,937,60,0.041750308381946974,0.064034151547492,41,100
Africa,Niger,22442948,2020-05-24,6,1,943,61,0.04201765293935538,0.06468716861081654,42,100
Africa,Niger,22442948,2020-05-25,2,0,945,61,0.04210676779182485,0.06455026455026455,43,100
Africa,Niger,22442948,2020-05-26,6,1,951,62,0.042374112349233266,0.06519453207150368,44,100
Africa,Niger,22442948,2020-05-27,1,1,952,63,0.042418669775467994,0.0661764705882353,45,100
Africa,Nigeria,195874740,2020-05-10,239,11,4151,128,0.021192114919973856,0.030835943146229824,0,101
Africa,Nigeria,195874740,2020-05-11,248,15,4399,143,0.02245823019343893,0.032507388042736986,1,101
Africa,Nigeria,195874740,2020-05-12,242,7,4641,150,0.02369371364577178,0.03232062055591468,2,101
Africa,Nigeria,195874740,2020-05-13,146,8,4787,158,0.024439087959989125,0.03300605807395028,3,101
Africa,Nigeria,195874740,2020-05-14,184,6,4971,164,0.025378463808043854,0.03299134982900825,4,101
Africa,Nigeria,195874740,2020-05-15,191,3,5162,167,0.02635357678075284,0.03235180162727625,5,101
Africa,Nigeria,195874740,2020-05-16,283,4,5445,171,0.027798377677489196,0.03140495867768595,6,101
Africa,Nigeria,195874740,2020-05-17,176,5,5621,176,0.028696911097367633,0.03131115459882583,7,101
Africa,Nigeria,195874740,2020-05-18,338,6,5959,182,0.030422503687816,0.030542037254572916,8,101
Africa,Nigeria,195874740,2020-05-19,216,9,6175,191,0.0315252492485759,0.030931174089068827,9,101
Africa,Nigeria,195874740,2020-05-20,226,1,6401,192,0.032679047844556164,0.029995313232307454,10,101
Africa,Nigeria,195874740,2020-05-21,276,8,6677,200,0.034088111616638266,0.029953571963456643,11,101
Africa,Nigeria,195874740,2020-05-22,339,11,7016,211,0.035818809510608667,0.03007411630558723,12,101
Africa,Nigeria,195874740,2020-05-23,245,10,7261,221,0.03706960887350763,0.030436578983611073,13,101
Africa,Nigeria,195874740,2020-05-24,265,0,7526,221,0.03842251430684732,0.029364868456019134,14,101
Africa,Nigeria,195874740,2020-05-25,313,5,7839,226,0.040020474309244776,0.028830207934685548,15,101
Africa,Nigeria,195874740,2020-05-26,229,7,8068,233,0.04118958881579115,0.028879524045612295,16,101
Africa,Nigeria,195874740,2020-05-27,276,16,8344,249,0.042598652587873244,0.029841802492809204,17,101
Europe,North Macedonia,2082958,2020-03-19,11,0,42,0,0.020163632680063638,0,0,102
Europe,North Macedonia,2082958,2020-03-20,6,0,48,0,0.023044151634358447,0,1,102
Europe,North Macedonia,2082958,2020-03-21,22,0,70,0,0.033606054466772735,0,2,102
Europe,North Macedonia,2082958,2020-03-22,15,0,85,0,0.04080735185250975,0,3,102
Europe,North Macedonia,2082958,2020-03-23,29,1,114,1,0.05472986013160131,0.008771929824561403,4,102
Europe,North Macedonia,2082958,2020-03-24,22,1,136,2,0.06529176296401559,0.014705882352941176,5,102
Europe,North Macedonia,2082958,2020-03-25,12,0,148,2,0.07105280087260521,0.013513513513513514,6,102
Europe,North Macedonia,2082958,2020-03-26,29,0,177,2,0.08497530915169678,0.011299435028248588,7,102
Europe,North Macedonia,2082958,2020-03-27,24,1,201,3,0.096497384968876,0.014925373134328358,8,102
Europe,North Macedonia,2082958,2020-03-28,18,0,219,3,0.10513894183176041,0.0136986301369863,9,102
Europe,North Macedonia,2082958,2020-03-29,22,1,241,4,0.1157008446641747,0.016597510373443983,10,102
Europe,North Macedonia,2082958,2020-03-30,18,2,259,6,0.1243424015270591,0.023166023166023165,11,102
Europe,North Macedonia,2082958,2020-03-31,26,1,285,7,0.1368246503290033,0.02456140350877193,12,102
Europe,North Macedonia,2082958,2020-04-01,44,2,329,9,0.15794845599383184,0.02735562310030395,13,102
Europe,North Macedonia,2082958,2020-04-02,25,1,354,10,0.16995061830339356,0.02824858757062147,14,102
Europe,North Macedonia,2082958,2020-04-03,0,1,354,11,0.16995061830339356,0.031073446327683617,15,102
Europe,North Macedonia,2082958,2020-04-04,76,1,430,12,0.2064371917244611,0.027906976744186046,16,102
Europe,North Macedonia,2082958,2020-04-05,53,5,483,17,0.23188177582073188,0.035196687370600416,17,102
Europe,North Macedonia,2082958,2020-04-06,0,0,483,17,0.23188177582073188,0.035196687370600416,18,102
Europe,North Macedonia,2082958,2020-04-07,87,4,570,21,0.2736493006580066,0.03684210526315789,19,102
Europe,North Macedonia,2082958,2020-04-08,29,5,599,26,0.2875718089370981,0.04340567612687813,20,102
Europe,North Macedonia,2082958,2020-04-09,18,4,617,30,0.29621336579998253,0.04862236628849271,21,102
Europe,North Macedonia,2082958,2020-04-10,46,2,663,32,0.3182973444495761,0.048265460030165915,22,102
Europe,North Macedonia,2082958,2020-04-11,48,0,711,32,0.3413414960839345,0.0450070323488045,23,102
Europe,North Macedonia,2082958,2020-04-12,49,2,760,34,0.3648657342106754,0.04473684210526316,24,102
Europe,North Macedonia,2082958,2020-04-13,68,0,828,34,0.39751161569268323,0.04106280193236715,25,102
Europe,North Macedonia,2082958,2020-04-14,26,4,854,38,0.4099938644946273,0.04449648711943794,26,102
Europe,North Macedonia,2082958,2020-04-15,54,6,908,44,0.4359185350832806,0.048458149779735685,27,102
Europe,North Macedonia,2082958,2020-04-16,66,1,974,45,0.4676042435805235,0.04620123203285421,28,102
Europe,North Macedonia,2082958,2020-04-17,107,1,1081,46,0.5189734982654475,0.0425531914893617,29,102
Europe,North Macedonia,2082958,2020-04-18,36,3,1117,49,0.5362566119912163,0.043867502238137866,30,102
Europe,North Macedonia,2082958,2020-04-19,53,0,1170,49,0.5617011960874871,0.04188034188034188,31,102
Europe,North Macedonia,2082958,2020-04-20,37,2,1207,51,0.5794643963056384,0.04225352112676056,32,102
Europe,North Macedonia,2082958,2020-04-21,18,3,1225,54,0.5881059531685229,0.044081632653061226,33,102
Europe,North Macedonia,2082958,2020-04-22,6,1,1231,55,0.5909864721228176,0.04467912266450041,34,102
Europe,North Macedonia,2082958,2020-04-23,28,1,1259,56,0.6044288939095268,0.04447974583002383,35,102
Europe,North Macedonia,2082958,2020-04-24,41,0,1300,56,0.6241124400972079,0.043076923076923075,36,102
Europe,North Macedonia,2082958,2020-04-25,26,1,1326,57,0.6365946888991522,0.042986425339366516,37,102
Europe,North Macedonia,2082958,2020-04-26,41,2,1367,59,0.6562782350868333,0.04316020482809071,38,102
Europe,North Macedonia,2082958,2020-04-27,19,2,1386,61,0.6653998784421001,0.04401154401154401,39,102
Europe,North Macedonia,2082958,2020-04-28,13,4,1399,65,0.6716410028430722,0.04646175839885633,40,102
Europe,North Macedonia,2082958,2020-04-29,22,6,1421,71,0.6822029056754865,0.04996481351161154,41,102
Europe,North Macedonia,2082958,2020-04-30,21,2,1442,73,0.6922847220155183,0.05062413314840499,42,102
Europe,North Macedonia,2082958,2020-05-01,23,4,1465,77,0.7033267113403151,0.05255972696245734,43,102
Europe,North Macedonia,2082958,2020-05-02,29,4,1494,81,0.7172492196194067,0.05421686746987952,44,102
Europe,North Macedonia,2082958,2020-05-03,12,1,1506,82,0.7230102575279963,0.05444887118193891,45,102
Europe,North Macedonia,2082958,2020-05-04,5,2,1511,84,0.7254106899899085,0.05559232296492389,46,102
Europe,North Macedonia,2082958,2020-05-05,7,1,1518,85,0.7287712954365858,0.055994729907773384,47,102
Europe,North Macedonia,2082958,2020-05-06,8,1,1526,86,0.7326119873756456,0.0563564875491481,48,102
Europe,North Macedonia,2082958,2020-05-07,13,2,1539,88,0.7388531117766177,0.057179987004548405,49,102
Europe,North Macedonia,2082958,2020-05-08,33,1,1572,89,0.754695966025239,0.056615776081424936,50,102
Europe,North Macedonia,2082958,2020-05-09,14,1,1586,90,0.7614171769185936,0.05674653215636822,51,102
Europe,North Macedonia,2082958,2020-05-10,36,1,1622,91,0.7787002906443625,0.056103575832305796,52,102
Europe,North Macedonia,2082958,2020-05-11,20,0,1642,91,0.7883020204920118,0.055420219244823384,53,102
Europe,North Macedonia,2082958,2020-05-12,22,0,1664,91,0.7988639233244261,0.0546875,54,102
Europe,North Macedonia,2082958,2020-05-13,10,1,1674,92,0.8036647882482508,0.054958183990442055,55,102
Europe,North Macedonia,2082958,2020-05-14,20,3,1694,95,0.8132665180959001,0.05608028335301062,56,102
Europe,North Macedonia,2082958,2020-05-15,29,0,1723,95,0.8271890263749917,0.05513639001741149,57,102
Europe,North Macedonia,2082958,2020-05-16,17,2,1740,97,0.8353504967454937,0.05574712643678161,58,102
Europe,North Macedonia,2082958,2020-05-17,22,1,1762,98,0.845912399577908,0.05561861520998865,59,102
Europe,North Macedonia,2082958,2020-05-18,30,3,1792,101,0.860314994349382,0.056361607142857144,60,102
Europe,North Macedonia,2082958,2020-05-19,25,3,1817,104,0.8723171566589437,0.05723720418271877,61,102
Europe,North Macedonia,2082958,2020-05-20,22,2,1839,106,0.8828790594913579,0.057640021750951606,62,102
Europe,North Macedonia,2082958,2020-05-21,19,4,1858,110,0.8920007028466249,0.059203444564047365,63,102
Europe,North Macedonia,2082958,2020-05-22,40,1,1898,111,0.9112041625419236,0.058482613277133826,64,102
Europe,North Macedonia,2082958,2020-05-23,23,1,1921,112,0.9222461518667203,0.05830296720458095,65,102
Europe,North Macedonia,2082958,2020-05-24,20,1,1941,113,0.9318478817143697,0.05821741370427615,66,102
Europe,North Macedonia,2082958,2020-05-25,37,0,1978,113,0.949611081932521,0.05712841253791709,67,102
Europe,North Macedonia,2082958,2020-05-26,21,0,1999,113,0.9596928982725528,0.05652826413206603,68,102
Europe,North Macedonia,2082958,2020-05-27,16,3,2015,116,0.9673742821506723,0.05756823821339951,69,102
Europe,Norway,5314336,2020-03-07,27,0,113,0,0.021263239659667737,0,0,103
Europe,Norway,5314336,2020-03-08,34,0,147,0,0.02766102858381555,0,1,103
Europe,Norway,5314336,2020-03-09,22,0,169,0,0.03180077435826414,0,2,103
Europe,Norway,5314336,2020-03-10,23,0,192,0,0.03612869039518766,0,3,103
Europe,Norway,5314336,2020-03-11,85,0,277,0,0.0521231627055572,0,4,103
Europe,Norway,5314336,2020-03-12,212,0,489,0,0.09201525835024356,0,5,103
Europe,Norway,5314336,2020-03-13,132,1,621,1,0.11685373299693508,0.001610305958132045,6,103
Europe,Norway,5314336,2020-03-14,0,0,621,1,0.11685373299693508,0.001610305958132045,7,103
Europe,Norway,5314336,2020-03-15,286,0,907,1,0.1706704280647667,0.0011025358324145535,8,103
Europe,Norway,5314336,2020-03-16,170,0,1077,1,0.20265937268550577,9.285051067780873e-4,9,103
Europe,Norway,5314336,2020-03-17,92,2,1169,3,0.21997103683319985,0.0025662959794696323,10,103
Europe,Norway,5314336,2020-03-18,139,0,1308,3,0.24612670331721592,0.0022935779816513763,11,103
Europe,Norway,5314336,2020-03-19,115,0,1423,3,0.2677662835018335,0.0021082220660576245,12,103
Europe,Norway,5314336,2020-03-20,129,3,1552,6,0.29204024736110024,0.003865979381443299,13,103
Europe,Norway,5314336,2020-03-21,190,1,1742,7,0.327792597231338,0.004018369690011481,14,103
Europe,Norway,5314336,2020-03-22,184,0,1926,7,0.3624159255267262,0.0036344755970924196,15,103
Europe,Norway,5314336,2020-03-23,206,0,2132,7,0.40117899959656295,0.003283302063789869,16,103
Europe,Norway,5314336,2020-03-24,239,1,2371,8,0.44615169232807256,0.003374103753690426,17,103
Europe,Norway,5314336,2020-03-25,195,2,2566,10,0.48284489351068505,0.003897116134060795,18,103
Europe,Norway,5314336,2020-03-26,350,2,2916,12,0.5487044853769126,0.00411522633744856,19,103
Europe,Norway,5314336,2020-03-27,240,2,3156,14,0.5938653483708972,0.004435994930291508,20,103
Europe,Norway,5314336,2020-03-28,425,2,3581,16,0.6738377099227447,0.004468025691147724,21,103
Europe,Norway,5314336,2020-03-29,264,4,3845,20,0.7235146592161278,0.005201560468140442,22,103
Europe,Norway,5314336,2020-03-30,257,2,4102,22,0.7718744166721863,0.005363237445148708,23,103
Europe,Norway,5314336,2020-03-31,124,4,4226,26,0.7952075292190783,0.006152389966871746,24,103
Europe,Norway,5314336,2020-04-01,221,2,4447,28,0.8367931572260391,0.006296379581740499,25,103
Europe,Norway,5314336,2020-04-02,218,4,4665,32,0.8778142744455751,0.006859592711682743,26,103
Europe,Norway,5314336,2020-04-03,270,10,4935,42,0.9286202453138078,0.00851063829787234,27,103
Europe,Norway,5314336,2020-04-04,273,2,5208,44,0.9799907269694653,0.008448540706605223,28,103
Europe,Norway,5314336,2020-04-05,302,6,5510,50,1.0368181462368957,0.009074410163339383,29,103
Europe,Norway,5314336,2020-04-06,130,8,5640,58,1.0612802803586374,0.01028368794326241,30,103
Europe,Norway,5314336,2020-04-07,115,1,5755,59,1.082919860543255,0.010251954821894005,31,103
Europe,Norway,5314336,2020-04-08,108,10,5863,69,1.103242248890548,0.011768719085792257,32,103
Europe,Norway,5314336,2020-04-09,147,11,6010,80,1.1309032774743637,0.013311148086522463,33,103
Europe,Norway,5314336,2020-04-10,150,8,6160,88,1.1591288168456042,0.014285714285714285,34,103
Europe,Norway,5314336,2020-04-11,84,4,6244,92,1.1749351188934987,0.014734144778987828,35,103
Europe,Norway,5314336,2020-04-12,76,6,6320,98,1.1892360588415938,0.01550632911392405,36,103
Europe,Norway,5314336,2020-04-13,95,5,6415,103,1.2071122337767126,0.016056118472330475,37,103
Europe,Norway,5314336,2020-04-14,73,11,6488,114,1.220848662937383,0.01757090012330456,38,103
Europe,Norway,5314336,2020-04-15,78,13,6566,127,1.235525943410428,0.019342065184282668,39,103
Europe,Norway,5314336,2020-04-16,111,3,6677,130,1.2564128425451457,0.01946982177624682,40,103
Europe,Norway,5314336,2020-04-17,114,6,6791,136,1.2778642524672885,0.020026505669268148,41,103
Europe,Norway,5314336,2020-04-18,0,0,6791,136,1.2778642524672885,0.020026505669268148,42,103
Europe,Norway,5314336,2020-04-19,193,12,6984,148,1.314181113124951,0.021191294387170677,43,103
Europe,Norway,5314336,2020-04-20,84,6,7068,154,1.3299874151728457,0.02178834182229768,44,103
Europe,Norway,5314336,2020-04-21,45,0,7113,154,1.3384550769842176,0.021650499086180233,45,103
Europe,Norway,5314336,2020-04-22,53,9,7166,163,1.3484281008953893,0.022746301981579682,46,103
Europe,Norway,5314336,2020-04-23,84,6,7250,169,1.364234402943284,0.023310344827586208,47,103
Europe,Norway,5314336,2020-04-24,95,11,7345,180,1.3821105778784029,0.02450646698434309,48,103
Europe,Norway,5314336,2020-04-25,63,11,7408,191,1.3939653044143239,0.025782937365010798,49,103
Europe,Norway,5314336,2020-04-26,59,2,7467,193,1.4050673499003452,0.025847060399089326,50,103
Europe,Norway,5314336,2020-04-27,38,0,7505,193,1.4122178198743927,0.025716189207195202,51,103
Europe,Norway,5314336,2020-04-28,28,0,7533,193,1.4174865872236908,0.02562060268153458,52,103
Europe,Norway,5314336,2020-04-29,72,2,7605,195,1.4310348461218863,0.02564102564102564,53,103
Europe,Norway,5314336,2020-04-30,62,7,7667,202,1.4427014023953322,0.026346680579105258,54,103
Europe,Norway,5314336,2020-05-01,43,2,7710,204,1.4507927236817546,0.026459143968871595,55,103
Europe,Norway,5314336,2020-05-02,49,0,7759,204,1.4600130665430264,0.026292047944322723,56,103
Europe,Norway,5314336,2020-05-03,0,0,7759,204,1.4600130665430264,0.026292047944322723,57,103
Europe,Norway,5314336,2020-05-04,50,4,7809,208,1.469421579666773,0.026635932897938277,58,103
Europe,Norway,5314336,2020-05-05,38,0,7847,208,1.4765720496408206,0.02650694532942526,59,103
Europe,Norway,5314336,2020-05-06,56,1,7903,209,1.487109584339417,0.026445653549285082,60,103
Europe,Norway,5314336,2020-05-07,50,0,7953,209,1.4965180974631638,0.02627939142461964,61,103
Europe,Norway,5314336,2020-05-08,42,0,7995,209,1.5044212484871111,0.026141338336460287,62,103
Europe,Norway,5314336,2020-05-09,39,4,8034,213,1.5117598887236336,0.026512322628827484,63,103
Europe,Norway,5314336,2020-05-10,35,0,8069,213,1.5183458479102563,0.02639732308836287,64,103
Europe,Norway,5314336,2020-05-11,30,4,8099,217,1.5239909557845044,0.02679343128781331,65,103
Europe,Norway,5314336,2020-05-12,7,7,8106,224,1.525308147621829,0.027633851468048358,66,103
Europe,Norway,5314336,2020-05-13,29,4,8135,228,1.530765085233602,0.028027043638598648,67,103
Europe,Norway,5314336,2020-05-14,23,1,8158,229,1.5350930012705255,0.02807060554057367,68,103
Europe,Norway,5314336,2020-05-15,17,3,8175,232,1.5382918957325995,0.028379204892966362,69,103
Europe,Norway,5314336,2020-05-16,22,0,8197,232,1.542431641507048,0.02830303769671831,70,103
Europe,Norway,5314336,2020-05-17,0,0,8197,232,1.542431641507048,0.02830303769671831,71,103
Europe,Norway,5314336,2020-05-18,0,0,8197,232,1.542431641507048,0.02830303769671831,72,103
Europe,Norway,5314336,2020-05-19,52,1,8249,233,1.5522164951557447,0.028245847981573525,73,103
Europe,Norway,5314336,2020-05-20,8,0,8257,233,1.5537218572555442,0.02821848128860361,74,103
Europe,Norway,5314336,2020-05-21,11,1,8268,234,1.5557917301427684,0.02830188679245283,75,103
Europe,Norway,5314336,2020-05-22,0,0,8268,234,1.5557917301427684,0.02830188679245283,76,103
Europe,Norway,5314336,2020-05-23,41,1,8309,235,1.5635067109042409,0.02828258514863401,77,103
Europe,Norway,5314336,2020-05-24,0,0,8309,235,1.5635067109042409,0.02828258514863401,78,103
Europe,Norway,5314336,2020-05-25,0,0,8309,235,1.5635067109042409,0.02828258514863401,79,103
Europe,Norway,5314336,2020-05-26,43,0,8352,235,1.571598032190663,0.02813697318007663,80,103
Europe,Norway,5314336,2020-05-27,12,0,8364,235,1.5738560753403623,0.028096604495456718,81,103
Asia,Oman,4829483,2020-03-26,15,0,99,0,0.02049908861880247,0,0,104
Asia,Oman,4829483,2020-03-27,10,0,109,0,0.02256970363080272,0,1,104
Asia,Oman,4829483,2020-03-28,22,0,131,0,0.027125056657203266,0,2,104
Asia,Oman,4829483,2020-03-29,21,0,152,0,0.03147334818240379,0,3,104
Asia,Oman,4829483,2020-03-30,15,0,167,0,0.03457927070040417,0,4,104
Asia,Oman,4829483,2020-03-31,12,0,179,0,0.03706400871480446,0,5,104
Asia,Oman,4829483,2020-04-01,13,1,192,1,0.03975580823040478,0.005208333333333333,6,104
Asia,Oman,4829483,2020-04-02,18,0,210,1,0.04348291525200523,0.004761904761904762,7,104
Asia,Oman,4829483,2020-04-03,21,0,231,1,0.04783120677720576,0.004329004329004329,8,104
Asia,Oman,4829483,2020-04-04,0,0,231,1,0.04783120677720576,0.004329004329004329,9,104
Asia,Oman,4829483,2020-04-05,46,1,277,2,0.05735603583240691,0.007220216606498195,10,104
Asia,Oman,4829483,2020-04-06,21,0,298,2,0.061704327357607426,0.006711409395973154,11,104
Asia,Oman,4829483,2020-04-07,73,0,371,2,0.07681981694520924,0.005390835579514825,12,104
Asia,Oman,4829483,2020-04-08,48,0,419,2,0.08675876900281045,0.00477326968973747,13,104
Asia,Oman,4829483,2020-04-09,0,0,419,2,0.08675876900281045,0.00477326968973747,14,104
Asia,Oman,4829483,2020-04-10,38,1,457,3,0.0946271060484114,0.006564551422319475,15,104
Asia,Oman,4829483,2020-04-11,27,0,484,3,0.10021776658081208,0.006198347107438017,16,104
Asia,Oman,4829483,2020-04-12,62,0,546,3,0.11305557965521361,0.005494505494505495,17,104
Asia,Oman,4829483,2020-04-13,53,1,599,4,0.12402983921881494,0.00667779632721202,18,104
Asia,Oman,4829483,2020-04-14,214,0,813,4,0.16834100047562026,0.004920049200492005,19,104
Asia,Oman,4829483,2020-04-15,97,0,910,4,0.1884259660920227,0.004395604395604396,20,104
Asia,Oman,4829483,2020-04-16,0,0,910,4,0.1884259660920227,0.004395604395604396,21,104
Asia,Oman,4829483,2020-04-17,109,0,1019,4,0.2109956697228254,0.003925417075564278,22,104
Asia,Oman,4829483,2020-04-18,50,2,1069,6,0.22134874478282665,0.005612722170252572,23,104
Asia,Oman,4829483,2020-04-19,111,0,1180,6,0.2443325714160294,0.005084745762711864,24,104
Asia,Oman,4829483,2020-04-20,86,1,1266,7,0.26213986051923155,0.005529225908372828,25,104
Asia,Oman,4829483,2020-04-21,242,1,1508,8,0.3122487438096376,0.005305039787798408,26,104
Asia,Oman,4829483,2020-04-22,0,0,1508,8,0.3122487438096376,0.005305039787798408,27,104
Asia,Oman,4829483,2020-04-23,106,0,1614,8,0.3341972629368402,0.004956629491945477,28,104
Asia,Oman,4829483,2020-04-24,102,1,1716,9,0.3553175360592428,0.005244755244755245,29,104
Asia,Oman,4829483,2020-04-25,74,1,1790,10,0.37064008714804464,0.00558659217877095,30,104
Asia,Oman,4829483,2020-04-26,115,0,1905,10,0.39445215978604753,0.005249343832020997,31,104
Asia,Oman,4829483,2020-04-27,93,0,1998,10,0.4137088793976498,0.005005005005005005,32,104
Asia,Oman,4829483,2020-04-28,51,0,2049,10,0.4242690159588511,0.004880429477794046,33,104
Asia,Oman,4829483,2020-04-29,82,0,2131,10,0.4412480590572531,0.004692632566870014,34,104
Asia,Oman,4829483,2020-04-30,143,0,2274,10,0.4708578537288567,0.0043975373790677225,35,104
Asia,Oman,4829483,2020-05-01,74,1,2348,11,0.4861804048176585,0.004684838160136286,36,104
Asia,Oman,4829483,2020-05-02,99,0,2447,11,0.506679493436461,0.004495300367797303,37,104
Asia,Oman,4829483,2020-05-03,36,1,2483,12,0.5141337074796619,0.004832863471606927,38,104
Asia,Oman,4829483,2020-05-04,85,0,2568,12,0.5317339350816641,0.004672897196261682,39,104
Asia,Oman,4829483,2020-05-05,69,0,2637,12,0.5460211786644658,0.004550625711035267,40,104
Asia,Oman,4829483,2020-05-06,98,0,2735,12,0.5663132057820682,0.0043875685557586835,41,104
Asia,Oman,4829483,2020-05-07,168,1,2903,13,0.6010995379836723,0.0044781260764726145,42,104
Asia,Oman,4829483,2020-05-08,55,1,2958,14,0.6124879205496737,0.004732927653820149,43,104
Asia,Oman,4829483,2020-05-09,154,1,3112,15,0.6443753917344777,0.004820051413881748,44,104
Asia,Oman,4829483,2020-05-10,112,2,3224,17,0.6675662798688804,0.005272952853598015,45,104
Asia,Oman,4829483,2020-05-11,175,0,3399,17,0.7038020425788848,0.005001471020888497,46,104
Asia,Oman,4829483,2020-05-12,175,0,3574,17,0.7400378052888891,0.004756575265808618,47,104
Asia,Oman,4829483,2020-05-13,147,0,3721,17,0.7704758459652928,0.004568664337543671,48,104
Asia,Oman,4829483,2020-05-14,298,0,4019,17,0.8321801733229002,0.0042299079372978355,49,104
Asia,Oman,4829483,2020-05-15,322,2,4341,19,0.8988539767093082,0.004376871688551025,50,104
Asia,Oman,4829483,2020-05-16,284,0,4625,19,0.9576594430501153,0.0041081081081081085,51,104
Asia,Oman,4829483,2020-05-17,404,2,5029,21,1.0413122895349254,0.0041757804732551205,52,104
Asia,Oman,4829483,2020-05-18,157,1,5186,22,1.0738209452233294,0.004242190512919399,53,104
Asia,Oman,4829483,2020-05-19,193,4,5379,26,1.1137838149549342,0.004833612195575386,54,104
Asia,Oman,4829483,2020-05-20,292,1,5671,27,1.1742457733053413,0.004761065067889261,55,104
Asia,Oman,4829483,2020-05-21,372,3,6043,30,1.2512726517517505,0.004964421644878371,56,104
Asia,Oman,4829483,2020-05-22,327,1,6370,31,1.318981762644159,0.004866562009419153,57,104
Asia,Oman,4829483,2020-05-23,424,1,6794,32,1.4067758391529694,0.0047100382690609364,58,104
Asia,Oman,4829483,2020-05-24,463,4,7257,36,1.502645314208581,0.004960727573377429,59,104
Asia,Oman,4829483,2020-05-25,513,1,7770,37,1.6088678643241938,0.004761904761904762,60,104
Asia,Oman,4829483,2020-05-26,0,0,7770,37,1.6088678643241938,0.004761904761904762,61,104
Asia,Oman,4829483,2020-05-27,348,0,8118,37,1.6809252667418024,0.004557772850455778,62,104
Asia,Pakistan,212215030,2020-04-09,250,5,4322,63,0.02036613523556743,0.014576584914391486,0,105
Asia,Pakistan,212215030,2020-04-10,279,3,4601,66,0.021680839476826877,0.014344707672245164,1,105
Asia,Pakistan,212215030,2020-04-11,187,5,4788,71,0.022562021172581413,0.014828738512949038,2,105
Asia,Pakistan,212215030,2020-04-12,250,15,5038,86,0.023740071567975182,0.017070265978562923,3,105
Asia,Pakistan,212215030,2020-04-13,336,7,5374,93,0.0253233712993844,0.017305545217714925,4,105
Asia,Pakistan,212215030,2020-04-14,342,3,5716,96,0.026934944240283077,0.016794961511546535,5,105
Asia,Pakistan,212215030,2020-04-15,272,11,5988,107,0.028216663070471493,0.017869071476285907,6,105
Asia,Pakistan,212215030,2020-04-16,517,17,6505,124,0.030652871288145804,0.01906225980015373,7,105
Asia,Pakistan,212215030,2020-04-17,520,11,7025,135,0.03310321611056484,0.019217081850533807,8,105
Asia,Pakistan,212215030,2020-04-18,456,8,7481,143,0.03525198003176307,0.019115091565298756,9,105
Asia,Pakistan,212215030,2020-04-19,512,16,7993,159,0.0376646272415295,0.019892405855123235,10,105
Asia,Pakistan,212215030,2020-04-20,425,17,8418,176,0.039667312913698904,0.02090757899738655,11,105
Asia,Pakistan,212215030,2020-04-21,798,16,9216,192,0.04342764977579581,0.020833333333333332,12,105
Asia,Pakistan,212215030,2020-04-22,533,17,9749,209,0.04593925321877532,0.02143809621499641,13,105
Asia,Pakistan,212215030,2020-04-23,0,0,9749,209,0.04593925321877532,0.02143809621499641,14,105
Asia,Pakistan,212215030,2020-04-24,1406,28,11155,237,0.05256460864246986,0.02124607799193187,15,105
Asia,Pakistan,212215030,2020-04-25,785,16,11940,253,0.056263686884006285,0.0211892797319933,16,105
Asia,Pakistan,212215030,2020-04-26,783,16,12723,269,0.05995334072237956,0.02114281222982001,17,105
Asia,Pakistan,212215030,2020-04-27,605,12,13328,281,0.06280422267923248,0.02108343337334934,18,105
Asia,Pakistan,212215030,2020-04-28,751,20,14079,301,0.06634308606699535,0.021379359329497832,19,105
Asia,Pakistan,212215030,2020-04-29,806,26,14885,327,0.07014112054174486,0.021968424588511924,20,105
Asia,Pakistan,212215030,2020-04-30,874,19,15759,346,0.07425958472404147,0.021955707849482836,21,105
Asia,Pakistan,212215030,2020-05-01,1058,39,16817,385,0.07924509399734787,0.0228935006243682,22,105
Asia,Pakistan,212215030,2020-05-02,1297,32,18114,417,0.08535681944865074,0.02302086783703213,23,105
Asia,Pakistan,212215030,2020-05-03,989,23,19103,440,0.09001718681282847,0.023033031461027063,24,105
Asia,Pakistan,212215030,2020-05-04,1083,22,20186,462,0.09512050112567427,0.022887149509561083,25,105
Asia,Pakistan,212215030,2020-05-05,1315,24,21501,486,0.10131704620544549,0.022603599832565928,26,105
Asia,Pakistan,212215030,2020-05-06,1049,40,22550,526,0.10626014566451773,0.023325942350332595,27,105
Asia,Pakistan,212215030,2020-05-07,1523,38,24073,564,0.11343682867325655,0.023428737589830932,28,105
Asia,Pakistan,212215030,2020-05-08,1764,30,25837,594,0.12174915226315497,0.022990285249835506,29,105
Asia,Pakistan,212215030,2020-05-09,1637,24,27474,618,0.12946302625219336,0.022493994321904347,30,105
Asia,Pakistan,212215030,2020-05-10,1991,21,29465,639,0.1388450196011093,0.021686746987951807,31,105
Asia,Pakistan,212215030,2020-05-11,1476,28,30941,667,0.1458002291355141,0.02155715717009793,32,105
Asia,Pakistan,212215030,2020-05-12,1140,39,32081,706,0.1511721389385097,0.022006795299398398,33,105
Asia,Pakistan,212215030,2020-05-13,2255,31,34336,737,0.16179815350496146,0.021464352283317802,34,105
Asia,Pakistan,212215030,2020-05-14,1452,33,35788,770,0.16864027020140845,0.021515591818486644,35,105
Asia,Pakistan,212215030,2020-05-15,1430,33,37218,803,0.1753787184630608,0.021575581707775807,36,105
Asia,Pakistan,212215030,2020-05-16,1581,31,38799,834,0.18282870916353097,0.02149539936596304,37,105
Asia,Pakistan,212215030,2020-05-17,1352,39,40151,873,0.18919960570182046,0.021742920475206096,38,105
Asia,Pakistan,212215030,2020-05-18,1974,30,42125,903,0.19850149162384964,0.02143620178041543,39,105
Asia,Pakistan,212215030,2020-05-19,1841,36,43966,939,0.20717665473552932,0.02135741254605832,40,105
Asia,Pakistan,212215030,2020-05-20,1932,46,45898,985,0.21628062819113236,0.0214606300928145,41,105
Asia,Pakistan,212215030,2020-05-21,2193,32,48091,1017,0.22661448625952646,0.021147408038926202,42,105
Asia,Pakistan,212215030,2020-05-22,2603,50,50694,1067,0.2388803469763664,0.02104785576202312,43,105
Asia,Pakistan,212215030,2020-05-23,1743,34,52437,1101,0.24709371433305174,0.020996624520853595,44,105
Asia,Pakistan,212215030,2020-05-24,2164,32,54601,1133,0.2572909185555802,0.020750535704474278,45,105
Asia,Pakistan,212215030,2020-05-25,1748,34,56349,1167,0.26552784692017334,0.02071021668530054,46,105
Asia,Pakistan,212215030,2020-05-26,1356,30,57705,1197,0.2719175922647892,0.020743436443982324,47,105
Asia,Pakistan,212215030,2020-05-27,1446,28,59151,1225,0.2787314357517467,0.020709709049720207,48,105
Asia,Palestine,4569087,2020-03-29,6,0,97,1,0.021229624211576623,0.010309278350515464,0,106
Asia,Palestine,4569087,2020-03-30,9,0,106,1,0.023199383159042495,0.009433962264150943,1,106
Asia,Palestine,4569087,2020-03-31,9,0,115,1,0.025169142106508367,0.008695652173913044,2,106
Asia,Palestine,4569087,2020-04-01,2,0,117,1,0.02560686631705634,0.008547008547008548,3,106
Asia,Palestine,4569087,2020-04-02,17,0,134,1,0.0293275221067141,0.007462686567164179,4,106
Asia,Palestine,4569087,2020-04-03,21,0,155,1,0.0339236263174678,0.0064516129032258064,5,106
Asia,Palestine,4569087,2020-04-04,0,0,155,1,0.0339236263174678,0.0064516129032258064,6,106
Asia,Palestine,4569087,2020-04-06,62,0,217,1,0.04749307684445492,0.004608294930875576,7,106
Asia,Palestine,4569087,2020-04-07,36,0,253,1,0.055372112634318404,0.003952569169960474,8,106
Asia,Palestine,4569087,2020-04-08,7,0,260,1,0.05690414737123631,0.0038461538461538464,9,106
Asia,Palestine,4569087,2020-04-09,3,0,263,1,0.05756073368705827,0.0038022813688212928,10,106
Asia,Palestine,4569087,2020-04-10,0,0,263,1,0.05756073368705827,0.0038022813688212928,11,106
Asia,Palestine,4569087,2020-04-11,3,1,266,2,0.05821732000288023,0.007518796992481203,12,106
Asia,Palestine,4569087,2020-04-12,2,0,268,2,0.0586550442134282,0.007462686567164179,13,106
Asia,Palestine,4569087,2020-04-13,0,0,268,2,0.0586550442134282,0.007462686567164179,14,106
Asia,Palestine,4569087,2020-04-14,0,0,268,2,0.0586550442134282,0.007462686567164179,15,106
Asia,Palestine,4569087,2020-04-15,19,0,287,2,0.06281342421363394,0.006968641114982578,16,106
Asia,Palestine,4569087,2020-04-16,4,0,291,2,0.06368887263472987,0.006872852233676976,17,106
Asia,Palestine,4569087,2020-04-17,3,0,294,2,0.06434545895055184,0.006802721088435374,18,106
Asia,Palestine,4569087,2020-04-18,13,0,307,2,0.06719066631911363,0.006514657980456026,19,106
Asia,Palestine,4569087,2020-04-19,6,0,313,2,0.06850383895075755,0.006389776357827476,20,106
Asia,Palestine,4569087,2020-04-20,9,0,322,2,0.07047359789822343,0.006211180124223602,21,106
Asia,Palestine,4569087,2020-04-21,7,0,329,2,0.07200563263514133,0.0060790273556231,22,106
Asia,Palestine,4569087,2020-04-22,0,0,329,2,0.07200563263514133,0.0060790273556231,23,106
Asia,Palestine,4569087,2020-04-23,6,0,335,2,0.07331880526678525,0.005970149253731343,24,106
Asia,Palestine,4569087,2020-04-24,1,0,336,2,0.07353766737205923,0.005952380952380952,25,106
Asia,Palestine,4569087,2020-04-25,4,0,340,2,0.07441311579315517,0.0058823529411764705,26,106
Asia,Palestine,4569087,2020-04-26,2,0,342,2,0.07485084000370314,0.005847953216374269,27,106
Asia,Palestine,4569087,2020-04-27,153,0,495,2,0.10833674211062298,0.00404040404040404,28,106
Asia,Palestine,4569087,2020-04-28,0,0,495,2,0.10833674211062298,0.00404040404040404,29,106
Asia,Palestine,4569087,2020-04-29,0,0,495,2,0.10833674211062298,0.00404040404040404,30,106
Asia,Palestine,4569087,2020-04-30,12,0,507,2,0.11096308737391081,0.0039447731755424065,31,106
Asia,Palestine,4569087,2020-05-01,0,2,507,4,0.11096308737391081,0.007889546351084813,32,106
Asia,Palestine,4569087,2020-05-02,10,0,517,4,0.11315170842665066,0.007736943907156673,33,106
Asia,Palestine,4569087,2020-05-03,0,0,517,4,0.11315170842665066,0.007736943907156673,34,106
Asia,Palestine,4569087,2020-05-04,5,0,522,4,0.1142460189530206,0.007662835249042145,35,106
Asia,Palestine,4569087,2020-05-05,2,0,524,4,0.11468374316356857,0.007633587786259542,36,106
Asia,Palestine,4569087,2020-05-06,14,0,538,4,0.11774781263740437,0.007434944237918215,37,106
Asia,Palestine,4569087,2020-05-07,8,0,546,4,0.11949870947959625,0.007326007326007326,38,106
Asia,Palestine,4569087,2020-05-08,1,0,547,4,0.11971757158487023,0.007312614259597806,39,106
Asia,Palestine,4569087,2020-05-09,0,0,547,4,0.11971757158487023,0.007312614259597806,40,106
Asia,Palestine,4569087,2020-05-10,0,0,547,4,0.11971757158487023,0.007312614259597806,41,106
Asia,Palestine,4569087,2020-05-11,0,0,547,4,0.11971757158487023,0.007312614259597806,42,106
Asia,Palestine,4569087,2020-05-12,0,0,547,4,0.11971757158487023,0.007312614259597806,43,106
Asia,Palestine,4569087,2020-05-13,0,0,547,4,0.11971757158487023,0.007312614259597806,44,106
Asia,Palestine,4569087,2020-05-14,1,0,548,4,0.11993643369014421,0.0072992700729927005,45,106
Asia,Palestine,4569087,2020-05-15,0,0,548,4,0.11993643369014421,0.0072992700729927005,46,106
Asia,Palestine,4569087,2020-05-16,6,0,554,4,0.12124960632178813,0.007220216606498195,47,106
Asia,Palestine,4569087,2020-05-17,0,0,554,4,0.12124960632178813,0.007220216606498195,48,106
Asia,Palestine,4569087,2020-05-18,6,0,560,4,0.12256277895343205,0.007142857142857143,49,106
Asia,Palestine,4569087,2020-05-19,7,0,567,4,0.12409481369034996,0.007054673721340388,50,106
Asia,Palestine,4569087,2020-05-20,3,0,570,4,0.12475140000617191,0.007017543859649123,51,106
Asia,Palestine,4569087,2020-05-21,7,0,577,4,0.1262834347430898,0.006932409012131715,52,106
Asia,Palestine,4569087,2020-05-22,25,0,602,4,0.13175498737493946,0.006644518272425249,53,106
Asia,Palestine,4569087,2020-05-23,0,0,602,4,0.13175498737493946,0.006644518272425249,54,106
Asia,Palestine,4569087,2020-05-24,0,1,602,5,0.13175498737493946,0.008305647840531562,55,106
Asia,Palestine,4569087,2020-05-25,0,0,602,5,0.13175498737493946,0.008305647840531562,56,106
Asia,Palestine,4569087,2020-05-26,0,0,602,5,0.13175498737493946,0.008305647840531562,57,106
Asia,Palestine,4569087,2020-05-27,3,0,605,5,0.1324115736907614,0.008264462809917356,58,106
America,Panama,4176873,2020-03-18,17,0,86,1,0.020589565447644686,0.011627906976744186,0,107
America,Panama,4176873,2020-03-19,23,0,109,1,0.026096077137131055,0.009174311926605505,1,107
America,Panama,4176873,2020-03-20,28,0,137,1,0.03279965658520142,0.0072992700729927005,2,107
America,Panama,4176873,2020-03-21,63,0,200,1,0.04788271034335974,0.005,3,107
America,Panama,4176873,2020-03-22,45,2,245,3,0.05865632017061567,0.012244897959183673,4,107
America,Panama,4176873,2020-03-23,68,0,313,3,0.07493644168735798,0.009584664536741214,5,107
America,Panama,4176873,2020-03-24,32,3,345,6,0.08259767534229553,0.017391304347826087,6,107
America,Panama,4176873,2020-03-25,98,0,443,6,0.10606020341054181,0.013544018058690745,7,107
America,Panama,4176873,2020-03-26,145,0,588,6,0.14077516840947762,0.01020408163265306,8,107
America,Panama,4176873,2020-03-27,86,3,674,9,0.1613647338571223,0.013353115727002967,9,107
America,Panama,4176873,2020-03-28,112,5,786,14,0.18817905164940377,0.017811704834605598,10,107
America,Panama,4176873,2020-03-29,115,3,901,17,0.2157116100968356,0.018867924528301886,11,107
America,Panama,4176873,2020-03-30,88,7,989,24,0.23678000264791388,0.024266936299292215,12,107
America,Panama,4176873,2020-03-31,86,2,1075,26,0.25736956809555855,0.024186046511627906,13,107
America,Panama,4176873,2020-04-01,106,4,1181,30,0.2827474045775392,0.02540220152413209,14,107
America,Panama,4176873,2020-04-02,136,2,1317,32,0.31530764761102387,0.024297646165527716,15,107
America,Panama,4176873,2020-04-03,158,5,1475,37,0.353134988782278,0.025084745762711864,16,107
America,Panama,4176873,2020-04-04,198,4,1673,41,0.4005388720222042,0.024506873879258817,17,107
America,Panama,4176873,2020-04-05,128,5,1801,46,0.43118380664195444,0.025541365907828985,18,107
America,Panama,4176873,2020-04-06,187,8,1988,54,0.47595414081299575,0.02716297786720322,19,107
America,Panama,4176873,2020-04-07,112,1,2100,55,0.5027684586052772,0.02619047619047619,20,107
America,Panama,4176873,2020-04-08,149,4,2249,59,0.5384410778110802,0.026233881725211204,21,107
America,Panama,4176873,2020-04-09,279,4,2528,63,0.605237458740067,0.024920886075949368,22,107
America,Panama,4176873,2020-04-10,224,3,2752,66,0.65886609432463,0.023982558139534885,23,107
America,Panama,4176873,2020-04-11,222,8,2974,74,0.7120159028057593,0.02488231338264963,24,107
America,Panama,4176873,2020-04-12,260,5,3234,79,0.7742634262521269,0.02442795299938157,25,107
America,Panama,4176873,2020-04-13,166,8,3400,87,0.8140060758371155,0.025588235294117648,26,107
America,Panama,4176873,2020-04-14,72,7,3472,94,0.831243851560725,0.02707373271889401,27,107
America,Panama,4176873,2020-04-15,102,1,3574,95,0.8556640338358384,0.026580861779518745,28,107
America,Panama,4176873,2020-04-16,177,8,3751,103,0.8980402324897119,0.027459344174886696,29,107
America,Panama,4176873,2020-04-17,265,6,4016,109,0.9614848236946635,0.027141434262948207,30,107
America,Panama,4176873,2020-04-18,194,7,4210,116,1.0079310527277225,0.027553444180522565,31,107
America,Panama,4176873,2020-04-19,63,4,4273,120,1.0230141064858806,0.02808331383103206,32,107
America,Panama,4176873,2020-04-20,194,6,4467,126,1.0694603355189396,0.028206850235057087,33,107
America,Panama,4176873,2020-04-21,191,10,4658,136,1.115188323896848,0.029197080291970802,34,107
America,Panama,4176873,2020-04-22,163,5,4821,141,1.1542127328266865,0.02924704418170504,35,107
America,Panama,4176873,2020-04-23,171,3,4992,144,1.195152450170259,0.028846153846153848,36,107
America,Panama,4176873,2020-04-24,174,2,5166,146,1.236810408168982,0.028261711188540456,37,107
America,Panama,4176873,2020-04-25,172,8,5338,154,1.2779895390642713,0.028849756463094792,38,107
America,Panama,4176873,2020-04-26,200,5,5538,159,1.3258722494076312,0.028710725893824486,39,107
America,Panama,4176873,2020-04-27,241,6,5779,165,1.3835709153713796,0.028551652535040665,40,107
America,Panama,4176873,2020-04-28,242,2,6021,167,1.4415089948868447,0.027736256435808005,41,107
America,Panama,4176873,2020-04-29,179,9,6200,176,1.4843640206441517,0.02838709677419355,42,107
America,Panama,4176873,2020-04-30,178,2,6378,178,1.526979632849742,0.027908435246158672,43,107
America,Panama,4176873,2020-05-01,154,10,6532,188,1.563849319814129,0.02878138395590937,44,107
America,Panama,4176873,2020-05-02,188,4,6720,192,1.6088590675368872,0.02857142857142857,45,107
America,Panama,4176873,2020-05-03,370,5,7090,197,1.6974420816721025,0.02778561354019746,46,107
America,Panama,4176873,2020-05-04,107,3,7197,200,1.7230593317058,0.027789356676392943,47,107
America,Panama,4176873,2020-05-05,190,3,7387,203,1.7685479065319918,0.027480709354271018,48,107
America,Panama,4176873,2020-05-06,136,7,7523,210,1.8011081495654764,0.02791439585271833,49,107
America,Panama,4176873,2020-05-07,208,8,7731,218,1.8509061683225705,0.02819816323890829,50,107
America,Panama,4176873,2020-05-08,137,7,7868,225,1.8837058249077718,0.028596847991865786,51,107
America,Panama,4176873,2020-05-09,202,6,8070,231,1.9320673623545652,0.02862453531598513,52,107
America,Panama,4176873,2020-05-10,212,6,8282,237,1.9828230353185265,0.02861627626177252,53,107
America,Panama,4176873,2020-05-11,166,7,8448,244,2.022565684903515,0.028882575757575756,54,107
America,Panama,4176873,2020-05-12,168,5,8616,249,2.0627871615919373,0.028899721448467967,55,107
America,Panama,4176873,2020-05-13,167,3,8783,252,2.1027692247286427,0.02869179095980872,56,107
America,Panama,4176873,2020-05-14,161,4,8944,256,2.141314806555047,0.028622540250447227,57,107
America,Panama,4176873,2020-05-15,174,4,9118,260,2.18297276455377,0.028515025224830008,58,107
America,Panama,4176873,2020-05-16,150,6,9268,266,2.21888479731129,0.028700906344410877,59,107
America,Panama,4176873,2020-05-17,181,3,9449,269,2.2622186501720307,0.028468621018097152,60,107
America,Panama,4176873,2020-05-18,157,6,9606,275,2.2998065777915677,0.028627940870289404,61,107
America,Panama,4176873,2020-05-19,120,4,9726,279,2.328536203997584,0.028685996298581123,62,107
America,Panama,4176873,2020-05-20,141,2,9867,281,2.3622935147896524,0.028478767609202392,63,107
America,Panama,4176873,2020-05-21,110,6,9977,287,2.3886290054785,0.028766162172997895,64,107
America,Panama,4176873,2020-05-22,139,4,10116,291,2.4219074891671353,0.028766310794780547,65,107
America,Panama,4176873,2020-05-23,151,4,10267,295,2.458058935476372,0.028732833349566573,66,107
America,Panama,4176873,2020-05-24,310,4,10577,299,2.5322771365085797,0.028268885317197692,67,107
America,Panama,4176873,2020-05-25,349,7,10926,306,2.615832466057742,0.02800658978583196,68,107
America,Panama,4176873,2020-05-26,257,4,11183,310,2.6773617488489596,0.027720647411249216,69,107
America,Panama,4176873,2020-05-27,264,3,11447,313,2.7405669265021944,0.027343408753385166,70,107
America,Paraguay,6956071,2020-04-13,13,0,147,6,0.021132619261649284,0.04081632653061224,0,108
America,Paraguay,6956071,2020-04-14,12,1,159,7,0.022857731038110448,0.0440251572327044,1,108
America,Paraguay,6956071,2020-04-15,2,1,161,8,0.023145249667520646,0.049689440993788817,2,108
America,Paraguay,6956071,2020-04-16,13,0,174,8,0.02501412075868691,0.04597701149425287,3,108
America,Paraguay,6956071,2020-04-17,0,0,174,8,0.02501412075868691,0.04597701149425287,4,108
America,Paraguay,6956071,2020-04-18,28,0,202,8,0.02903938157042963,0.039603960396039604,5,108
America,Paraguay,6956071,2020-04-19,0,0,202,8,0.02903938157042963,0.039603960396039604,6,108
America,Paraguay,6956071,2020-04-20,4,0,206,8,0.029614418829250016,0.038834951456310676,7,108
America,Paraguay,6956071,2020-04-21,2,0,208,8,0.029901937458660214,0.038461538461538464,8,108
America,Paraguay,6956071,2020-04-22,5,1,213,9,0.030620734032185695,0.04225352112676056,9,108
America,Paraguay,6956071,2020-04-23,0,0,213,9,0.030620734032185695,0.04225352112676056,10,108
America,Paraguay,6956071,2020-04-24,7,0,220,9,0.03162704923512138,0.04090909090909091,11,108
America,Paraguay,6956071,2020-04-25,3,0,223,9,0.03205832717923667,0.04035874439461883,12,108
America,Paraguay,6956071,2020-04-26,5,0,228,9,0.032777123752762156,0.039473684210526314,13,108
America,Paraguay,6956071,2020-04-27,0,0,228,9,0.032777123752762156,0.039473684210526314,14,108
America,Paraguay,6956071,2020-04-28,2,0,230,9,0.033064642382172355,0.0391304347826087,15,108
America,Paraguay,6956071,2020-04-29,9,0,239,9,0.03435847621451822,0.03765690376569038,16,108
America,Paraguay,6956071,2020-04-30,10,0,249,9,0.0357960693615692,0.03614457831325301,17,108
America,Paraguay,6956071,2020-05-01,17,1,266,10,0.03823997771155584,0.03759398496240601,18,108
America,Paraguay,6956071,2020-05-02,67,0,333,10,0.04787185179679736,0.03003003003003003,19,108
America,Paraguay,6956071,2020-05-03,37,0,370,10,0.053190946440885956,0.02702702702702703,20,108
America,Paraguay,6956071,2020-05-04,26,0,396,10,0.05692868862321848,0.025252525252525252,21,108
America,Paraguay,6956071,2020-05-05,19,0,415,10,0.059660115602615325,0.024096385542168676,22,108
America,Paraguay,6956071,2020-05-06,16,0,431,10,0.06196026463789688,0.02320185614849188,23,108
America,Paraguay,6956071,2020-05-07,9,0,440,10,0.06325409847024276,0.022727272727272728,24,108
America,Paraguay,6956071,2020-05-08,22,0,462,10,0.06641680339375489,0.021645021645021644,25,108
America,Paraguay,6956071,2020-05-09,101,0,563,10,0.0809364941789697,0.017761989342806393,26,108
America,Paraguay,6956071,2020-05-10,126,0,689,10,0.09905016783181195,0.01451378809869376,27,108
America,Paraguay,6956071,2020-05-11,24,0,713,10,0.10250039138473428,0.014025245441795231,28,108
America,Paraguay,6956071,2020-05-12,11,0,724,10,0.10408174384649035,0.013812154696132596,29,108
America,Paraguay,6956071,2020-05-13,13,0,737,10,0.10595061493765662,0.013568521031207599,30,108
America,Paraguay,6956071,2020-05-14,3,1,740,11,0.10638189288177191,0.014864864864864866,31,108
America,Paraguay,6956071,2020-05-15,14,0,754,11,0.10839452328764328,0.014588859416445624,32,108
America,Paraguay,6956071,2020-05-16,5,0,759,11,0.10911331986116876,0.014492753623188406,33,108
America,Paraguay,6956071,2020-05-17,19,0,778,11,0.1118447468405656,0.014138817480719794,34,108
America,Paraguay,6956071,2020-05-18,8,0,786,11,0.11299482135820638,0.013994910941475827,35,108
America,Paraguay,6956071,2020-05-19,2,0,788,11,0.11328233998761657,0.013959390862944163,36,108
America,Paraguay,6956071,2020-05-20,41,0,829,11,0.11917647189052556,0.013268998793727383,37,108
America,Paraguay,6956071,2020-05-21,4,0,833,11,0.11975150914934594,0.013205282112845138,38,108
America,Paraguay,6956071,2020-05-22,3,0,836,11,0.12018278709346122,0.013157894736842105,39,108
America,Paraguay,6956071,2020-05-23,2,0,838,11,0.12047030572287143,0.013126491646778043,40,108
America,Paraguay,6956071,2020-05-24,12,0,850,11,0.12219541749933259,0.012941176470588235,41,108
America,Paraguay,6956071,2020-05-25,12,0,862,11,0.12392052927579376,0.012761020881670533,42,108
America,Paraguay,6956071,2020-05-26,3,0,865,11,0.12435180721990906,0.012716763005780347,43,108
America,Paraguay,6956071,2020-05-27,12,0,877,11,0.12607691899637022,0.012542759407069556,44,108
America,Peru,31989256,2020-03-29,36,5,671,16,0.02097579262237296,0.02384500745156483,0,109
America,Peru,31989256,2020-03-30,181,2,852,18,0.02663394234614272,0.02112676056338028,1,109
America,Peru,31989256,2020-03-31,98,6,950,24,0.02969747092586336,0.02526315789473684,2,109
America,Peru,31989256,2020-04-01,115,6,1065,30,0.03329242793267839,0.028169014084507043,3,109
America,Peru,31989256,2020-04-02,258,17,1323,47,0.04135763582622865,0.03552532123960695,4,109
America,Peru,31989256,2020-04-03,91,8,1414,55,0.04420234093596925,0.038896746817538894,5,109
America,Peru,31989256,2020-04-04,181,6,1595,61,0.04986049065973901,0.03824451410658307,6,109
America,Peru,31989256,2020-04-05,151,12,1746,73,0.054580825512165705,0.0418098510882016,7,109
America,Peru,31989256,2020-04-06,535,10,2281,83,0.07130519071778349,0.03638754932047348,8,109
America,Peru,31989256,2020-04-07,280,9,2561,92,0.08005812951698532,0.035923467395548615,9,109
America,Peru,31989256,2020-04-08,393,15,2954,107,0.09234350433157933,0.036222071767095465,10,109
America,Peru,31989256,2020-04-09,1388,14,4342,121,0.13573307237905127,0.027867342238599723,11,109
America,Peru,31989256,2020-04-10,914,17,5256,138,0.16430516545930296,0.026255707762557076,12,109
America,Peru,31989256,2020-04-11,641,31,5897,169,0.18434314321033288,0.02865863998643378,13,109
America,Peru,31989256,2020-04-12,951,12,6848,181,0.2140718746319077,0.02643107476635514,14,109
America,Peru,31989256,2020-04-13,671,12,7519,193,0.23504766725428064,0.025668306955712195,15,109
America,Peru,31989256,2020-04-14,0,0,7519,193,0.23504766725428064,0.025668306955712195,16,109
America,Peru,31989256,2020-04-15,2784,37,10303,230,0.32207688731491596,0.022323595069397264,17,109
America,Peru,31989256,2020-04-16,1172,24,11475,254,0.35871418828871793,0.02213507625272331,18,109
America,Peru,31989256,2020-04-17,1016,20,12491,274,0.390474851931536,0.021935793771515492,19,109
America,Peru,31989256,2020-04-18,998,26,13489,300,0.42167282665154826,0.022240343983986954,20,109
America,Peru,31989256,2020-04-19,931,48,14420,348,0.45077634815889434,0.024133148404993063,21,109
America,Peru,31989256,2020-04-20,1208,52,15628,400,0.48853902697830803,0.025595085743537242,22,109
America,Peru,31989256,2020-04-21,697,45,16325,445,0.51032759248917825,0.027258805513016845,23,109
America,Peru,31989256,2020-04-22,1512,39,17837,484,0.5575934620048681,0.027134607837640858,24,109
America,Peru,31989256,2020-04-23,1413,46,19250,530,0.601764542445126,0.027532467532467533,25,109
America,Peru,31989256,2020-04-24,1664,42,20914,572,0.653782007308954,0.027350100411207803,26,109
America,Peru,31989256,2020-04-25,734,62,21648,634,0.6767272111611474,0.029286770140428676,27,109
America,Peru,31989256,2020-04-26,3683,66,25331,700,0.7918596168663629,0.0276341241956496,28,109
America,Peru,31989256,2020-04-27,2186,28,27517,728,0.86019506049156,0.026456372424319512,29,109
America,Peru,31989256,2020-04-28,1182,54,28699,782,0.8971449664224763,0.027248336178960938,30,109
America,Peru,31989256,2020-04-29,2491,72,31190,854,0.9750148612396613,0.027380570695735813,31,109
America,Peru,31989256,2020-04-30,2741,89,33931,943,1.060699879984705,0.027791694910259054,32,109
America,Peru,31989256,2020-05-01,3045,108,36976,1051,1.1558880894260248,0.02842384249242752,33,109
America,Peru,31989256,2020-05-02,3483,73,40459,1124,1.2647683959889533,0.0277812106082701,34,109
America,Peru,31989256,2020-05-03,2075,76,42534,1200,1.3296339245901811,0.028212723938496262,35,109
America,Peru,31989256,2020-05-04,3394,86,45928,1286,1.435732047034792,0.028000348371363875,36,109
America,Peru,31989256,2020-05-05,1444,58,47372,1344,1.4808722028421042,0.028371189732331336,37,109
America,Peru,31989256,2020-05-06,3817,100,51189,1444,1.6001935149726523,0.028209185567211706,38,109
America,Peru,31989256,2020-05-07,3628,89,54817,1533,1.7136065934137386,0.02796577703996935,39,109
America,Peru,31989256,2020-05-08,3709,94,58526,1627,1.8295517720074514,0.027799610429552677,40,109
America,Peru,31989256,2020-05-09,3321,87,61847,1714,1.9333678782651276,0.02771355118275745,41,109
America,Peru,31989256,2020-05-10,3168,100,65015,1814,2.032401128678954,0.02790125355687149,42,109
America,Peru,31989256,2020-05-11,2292,75,67307,1889,2.104050184849563,0.02806543153015288,43,109
America,Peru,31989256,2020-05-12,1515,72,68822,1961,2.1514098358523874,0.02849379558861992,44,109
America,Peru,31989256,2020-05-13,3237,96,72059,2057,2.2526000604703027,0.028546052540279494,45,109
America,Peru,31989256,2020-05-14,4247,112,76306,2169,2.3853633857567678,0.028425025555002228,46,109
America,Peru,31989256,2020-05-15,4298,98,80604,2267,2.519720996324516,0.0281251550791524,47,109
America,Peru,31989256,2020-05-16,3891,126,84495,2393,2.64135558513771,0.028321202438014084,48,109
America,Peru,31989256,2020-05-17,4046,130,88541,2523,2.7678355507861765,0.02849527337617601,49,109
America,Peru,31989256,2020-05-18,3732,125,92273,2648,2.8844997207812524,0.028697452125757264,50,109
America,Peru,31989256,2020-05-19,2660,141,94933,2789,2.9676526393736697,0.029378614391202217,51,109
America,Peru,31989256,2020-05-20,4550,125,99483,2914,3.1098878948606994,0.029291436727883157,52,109
America,Peru,31989256,2020-05-21,4537,110,104020,3024,3.2517167639034805,0.029071332436069987,53,109
America,Peru,31989256,2020-05-22,4749,124,108769,3148,3.400172858037086,0.028942069891237394,54,109
America,Peru,31989256,2020-05-23,2929,96,111698,3244,3.4917348499758796,0.029042597002632096,55,109
America,Peru,31989256,2020-05-24,4056,129,115754,3373,3.61852742058146,0.02913938179242186,56,109
America,Peru,31989256,2020-05-25,4205,83,119959,3456,3.749977805048045,0.028809843363149075,57,109
America,Peru,31989256,2020-05-26,4020,173,123979,3629,3.875644997808014,0.0292710862323458,58,109
America,Peru,31989256,2020-05-27,5772,159,129751,3788,4.056080579054417,0.02919438000477838,59,109
Asia,Philippines,106651922,2020-04-02,227,8,2311,96,0.021668620280467142,0.04154045867589788,0,110
Asia,Philippines,106651922,2020-04-03,322,11,2633,107,0.024687787623742966,0.04063805545005697,1,110
Asia,Philippines,106651922,2020-04-04,385,29,3018,136,0.028297661621137966,0.04506295559973492,2,110
Asia,Philippines,106651922,2020-04-05,76,8,3094,144,0.029010260124519835,0.04654169360051713,3,110
Asia,Philippines,106651922,2020-04-06,152,8,3246,152,0.030435457131283577,0.04682686383240912,4,110
Asia,Philippines,106651922,2020-04-07,414,11,3660,163,0.03431724371549535,0.04453551912568306,5,110
Asia,Philippines,106651922,2020-04-08,104,14,3764,177,0.03529237850959686,0.04702444208289054,6,110
Asia,Philippines,106651922,2020-04-09,106,5,3870,182,0.03628626589589262,0.047028423772609816,7,110
Asia,Philippines,106651922,2020-04-10,206,21,4076,203,0.03821778289190138,0.04980372914622178,8,110
Asia,Philippines,106651922,2020-04-11,0,0,4076,203,0.03821778289190138,0.04980372914622178,9,110
Asia,Philippines,106651922,2020-04-12,352,44,4428,247,0.0415182391180911,0.055781391147244806,10,110
Asia,Philippines,106651922,2020-04-13,220,50,4648,297,0.043581024259459665,0.06389845094664372,11,110
Asia,Philippines,106651922,2020-04-14,284,18,4932,315,0.04624389235104455,0.06386861313868614,12,110
Asia,Philippines,106651922,2020-04-15,291,20,5223,335,0.04897239451530934,0.06413938349607505,13,110
Asia,Philippines,106651922,2020-04-16,230,14,5453,349,0.05112894261764921,0.06400146708234,14,110
Asia,Philippines,106651922,2020-04-17,207,13,5660,362,0.0530698359097551,0.06395759717314488,15,110
Asia,Philippines,106651922,2020-04-18,218,25,5878,387,0.05511386845892941,0.06583872065328343,16,110
Asia,Philippines,106651922,2020-04-19,209,10,6087,397,0.057073514343229555,0.06522096270740924,17,110
Asia,Philippines,106651922,2020-04-20,172,12,6259,409,0.0586862372719359,0.06534590190126219,18,110
Asia,Philippines,106651922,2020-04-21,200,19,6459,428,0.06056149649136187,0.06626412757392786,19,110
Asia,Philippines,106651922,2020-04-22,140,9,6599,437,0.06187417794496005,0.0662221548719503,20,110
Asia,Philippines,106651922,2020-04-23,111,9,6710,446,0.06291494681174147,0.06646795827123696,21,110
Asia,Philippines,106651922,2020-04-24,271,16,6981,462,0.06545592305406366,0.06617963042544048,22,110
Asia,Philippines,106651922,2020-04-25,211,15,7192,477,0.06743432153055808,0.06632369299221356,23,110
Asia,Philippines,106651922,2020-04-26,102,17,7294,494,0.06839070373246531,0.06772689882094872,24,110
Asia,Philippines,106651922,2020-04-27,285,7,7579,501,0.07106294812014734,0.06610370761314158,25,110
Asia,Philippines,106651922,2020-04-28,198,10,7777,511,0.07291945474737904,0.06570657065706571,26,110
Asia,Philippines,106651922,2020-04-29,181,19,7958,530,0.07461656434095956,0.06659964815280221,27,110
Asia,Philippines,106651922,2020-04-30,254,28,8212,558,0.07699814354963054,0.06794934242571846,28,110
Asia,Philippines,106651922,2020-05-01,276,10,8488,568,0.0795860012724384,0.06691800188501414,29,110
Asia,Philippines,106651922,2020-05-02,284,11,8772,579,0.08224886936402327,0.06600547195622435,30,110
Asia,Philippines,106651922,2020-05-03,156,24,8928,603,0.08371157155517554,0.06754032258064516,31,110
Asia,Philippines,106651922,2020-05-04,295,4,9223,607,0.08647757890382884,0.06581372655318227,32,110
Asia,Philippines,106651922,2020-05-05,262,16,9485,623,0.08893416848127687,0.06568265682656826,33,110
Asia,Philippines,106651922,2020-05-06,199,14,9684,637,0.09080005140460572,0.0657786038826931,34,110
Asia,Philippines,106651922,2020-05-07,320,21,10004,658,0.09380046615568728,0.06577369052379048,35,110
Asia,Philippines,106651922,2020-05-08,339,27,10343,685,0.09697903053261431,0.06622836701150536,36,110
Asia,Philippines,106651922,2020-05-09,120,11,10463,696,0.0981041860642699,0.06652011851285482,37,110
Asia,Philippines,106651922,2020-05-10,147,8,10610,704,0.099482501590548,0.06635249764373233,38,110
Asia,Philippines,106651922,2020-05-11,184,15,10794,719,0.10120774007241988,0.06661108022975727,39,110
Asia,Philippines,106651922,2020-05-12,292,7,11086,726,0.10394561853278181,0.06548800288652354,40,110
Asia,Philippines,106651922,2020-05-13,264,25,11350,751,0.1064209607024241,0.06616740088105727,41,110
Asia,Philippines,106651922,2020-05-14,268,21,11618,772,0.1089338080564549,0.06644861421931486,42,110
Asia,Philippines,106651922,2020-05-15,258,18,11876,790,0.1113528924495144,0.06652071404513304,43,110
Asia,Philippines,106651922,2020-05-16,215,16,12091,806,0.11336879611039734,0.06666115292366223,44,110
Asia,Philippines,106651922,2020-05-17,214,11,12305,817,0.11537532347518313,0.06639577407557903,45,110
Asia,Philippines,106651922,2020-05-18,208,7,12513,824,0.11732559306338614,0.06585151442499801,46,110
Asia,Philippines,106651922,2020-05-19,205,7,12718,831,0.11924773376329777,0.06534046233684541,47,110
Asia,Philippines,106651922,2020-05-20,224,6,12942,837,0.12134802408905486,0.06467315716272601,48,110
Asia,Philippines,106651922,2020-05-21,279,5,13221,842,0.1239640107001541,0.0636865592617805,49,110
Asia,Philippines,106651922,2020-05-22,213,4,13434,846,0.12596116176884278,0.06297454220634212,50,110
Asia,Philippines,106651922,2020-05-23,163,11,13597,857,0.12748949803267495,0.06302860925204089,51,110
Asia,Philippines,106651922,2020-05-24,180,6,13777,863,0.1291772313301583,0.06264063293895623,52,110
Asia,Philippines,106651922,2020-05-25,258,5,14035,868,0.13159631572321784,0.061845386533665836,53,110
Asia,Philippines,106651922,2020-05-26,284,5,14319,873,0.1342591838148027,0.06096794468887492,54,110
Asia,Philippines,106651922,2020-05-27,350,13,14669,886,0.13754088744879817,0.06039948190060672,55,110
Europe,Poland,37978548,2020-03-25,152,2,901,10,0.02372391909243081,0.011098779134295227,0,111
Europe,Poland,37978548,2020-03-26,150,4,1051,14,0.0276735171655325,0.013320647002854425,1,111
Europe,Poland,37978548,2020-03-27,170,2,1221,16,0.03214972831504775,0.013104013104013105,2,111
Europe,Poland,37978548,2020-03-28,168,0,1389,16,0.03657327815692164,0.011519078473722102,3,111
Europe,Poland,37978548,2020-03-29,249,2,1638,18,0.04312961095827045,0.01098901098901099,4,111
Europe,Poland,37978548,2020-03-30,224,4,1862,22,0.0490276774141023,0.011815252416756176,5,111
Europe,Poland,37978548,2020-03-31,193,9,2055,31,0.05410949360149314,0.01508515815085158,6,111
Europe,Poland,37978548,2020-04-01,256,2,2311,33,0.06085014097958669,0.014279532669839896,7,111
Europe,Poland,37978548,2020-04-02,243,10,2554,43,0.06724848985801142,0.016836335160532498,8,111
Europe,Poland,37978548,2020-04-03,392,14,2946,57,0.07757010615571718,0.019348268839103868,9,111
Europe,Poland,37978548,2020-04-04,437,14,3383,71,0.08907660187535343,0.020987289388117055,10,111
Europe,Poland,37978548,2020-04-05,244,8,3627,79,0.09550128140759884,0.02178108629721533,11,111
Europe,Poland,37978548,2020-04-06,475,15,4102,94,0.10800834197242086,0.022915650901999023,12,111
Europe,Poland,37978548,2020-04-07,311,13,4413,107,0.11619717531065168,0.02424654430092907,13,111
Europe,Poland,37978548,2020-04-08,435,22,4848,129,0.12765100972264656,0.026608910891089108,14,111
Europe,Poland,37978548,2020-04-09,357,30,5205,159,0.1370510531366286,0.03054755043227666,15,111
Europe,Poland,37978548,2020-04-10,370,15,5575,174,0.1467933950502794,0.031210762331838567,16,111
Europe,Poland,37978548,2020-04-11,380,7,5955,181,0.15679904350213705,0.030394626364399664,17,111
Europe,Poland,37978548,2020-04-12,401,27,6356,208,0.1673576356842289,0.032724984266834484,18,111
Europe,Poland,37978548,2020-04-13,318,24,6674,232,0.1757307835992045,0.03476176206173209,19,111
Europe,Poland,37978548,2020-04-14,260,13,6934,245,0.18257675359258074,0.03533314104413037,20,111
Europe,Poland,37978548,2020-04-15,268,18,7202,263,0.1896333688165224,0.03651763399055818,21,111
Europe,Poland,37978548,2020-04-16,380,23,7582,286,0.19963901726838001,0.03772091796359799,22,111
Europe,Poland,37978548,2020-04-17,336,28,7918,314,0.20848611695212782,0.03965647890881536,23,111
Europe,Poland,37978548,2020-04-18,461,18,8379,332,0.22062454836346035,0.039622866690535864,24,111
Europe,Poland,37978548,2020-04-19,363,15,8742,347,0.23018257570036643,0.03969343399679707,25,111
Europe,Poland,37978548,2020-04-20,545,13,9287,360,0.2445327820326359,0.03876386346505868,26,111
Europe,Poland,37978548,2020-04-21,306,20,9593,380,0.2525899621017633,0.039612217241738766,27,111
Europe,Poland,37978548,2020-04-22,263,21,9856,401,0.25951492405660165,0.040685876623376624,28,111
Europe,Poland,37978548,2020-04-23,313,25,10169,426,0.2677564187024738,0.04189202478119776,29,111
Europe,Poland,37978548,2020-04-24,342,28,10511,454,0.27676150230914565,0.043192845590333935,30,111
Europe,Poland,37978548,2020-04-25,381,40,10892,494,0.28679348141482397,0.045354388542049213,31,111
Europe,Poland,37978548,2020-04-26,381,30,11273,524,0.2968254605205023,0.046482746385168104,32,111
Europe,Poland,37978548,2020-04-27,344,11,11617,535,0.30588320543481545,0.046053197899629854,33,111
Europe,Poland,37978548,2020-04-28,285,27,11902,562,0.3133874417737087,0.04721895479751302,34,111
Europe,Poland,37978548,2020-04-29,316,34,12218,596,0.3217079283810429,0.04878048780487805,35,111
Europe,Poland,37978548,2020-04-30,422,28,12640,624,0.332819464293369,0.049367088607594936,36,111
Europe,Poland,37978548,2020-05-01,237,20,12877,644,0.3390598292488697,0.050011648675933836,37,111
Europe,Poland,37978548,2020-05-02,228,7,13105,651,0.3450632183199842,0.049675696299122475,38,111
Europe,Poland,37978548,2020-05-03,270,13,13375,664,0.35217249485156726,0.04964485981308411,39,111
Europe,Poland,37978548,2020-05-04,318,14,13693,678,0.36054564276654283,0.049514350398013586,40,111
Europe,Poland,37978548,2020-05-05,313,20,14006,698,0.36878713741241503,0.04983578466371555,41,111
Europe,Poland,37978548,2020-05-06,425,18,14431,716,0.3799776652862032,0.04961541126741044,42,111
Europe,Poland,37978548,2020-05-07,309,17,14740,733,0.3881138373167926,0.04972862957937585,43,111
Europe,Poland,37978548,2020-05-08,307,22,15047,755,0.3961973480397407,0.05017611484016748,44,111
Europe,Poland,37978548,2020-05-09,319,21,15366,776,0.404596826608537,0.05050110633866979,45,111
Europe,Poland,37978548,2020-05-10,285,9,15651,785,0.4121010629474302,0.050156539518241644,46,111
Europe,Poland,37978548,2020-05-11,345,15,15996,800,0.4211851385155641,0.05001250312578145,47,111
Europe,Poland,37978548,2020-05-12,330,11,16326,811,0.4298742542763878,0.0496753644493446,48,111
Europe,Poland,37978548,2020-05-13,595,28,16921,839,0.44554099329969116,0.04958335795756752,49,111
Europe,Poland,37978548,2020-05-14,283,22,17204,861,0.45299256833094304,0.050046500813764244,50,111
Europe,Poland,37978548,2020-05-15,411,22,17615,883,0.46381446705124163,0.050127732046551236,51,111
Europe,Poland,37978548,2020-05-16,401,24,18016,907,0.4743730592333335,0.050344138543516874,52,111
Europe,Poland,37978548,2020-05-17,241,8,18257,915,0.4807187468041169,0.05011776304978912,53,111
Europe,Poland,37978548,2020-05-18,272,10,18529,925,0.48788068464334133,0.049921744292730316,54,111
Europe,Poland,37978548,2020-05-19,356,11,18885,936,0.49725439740350263,0.04956314535345512,55,111
Europe,Poland,37978548,2020-05-20,383,12,19268,948,0.5073390378168222,0.04920074735312435,56,111
Europe,Poland,37978548,2020-05-21,471,14,19739,962,0.5197407757663616,0.04873600486346826,57,111
Europe,Poland,37978548,2020-05-22,404,10,20143,972,0.5303783599099154,0.04825497691505734,58,111
Europe,Poland,37978548,2020-05-23,476,10,20619,982,0.5429117511285582,0.047625976041515104,59,111
Europe,Poland,37978548,2020-05-24,312,11,20931,993,0.5511269151206097,0.04744159380822703,60,111
Europe,Poland,37978548,2020-05-25,395,3,21326,996,0.5615275233797775,0.04670355434680672,61,111
Europe,Poland,37978548,2020-05-26,305,11,21631,1007,0.5695583727950843,0.046553557394480145,62,111
Europe,Poland,37978548,2020-05-27,443,17,22074,1024,0.5812228524376445,0.046389417414152395,63,111
Europe,Portugal,10281762,2020-03-16,76,0,245,0,0.02382860058421893,0,0,112
Europe,Portugal,10281762,2020-03-17,86,0,331,0,0.032192925687250885,0,1,112
Europe,Portugal,10281762,2020-03-18,117,1,448,1,0.04357229821114319,0.002232142857142857,2,112
Europe,Portugal,10281762,2020-03-19,194,1,642,2,0.062440659490075726,0.003115264797507788,3,112
Europe,Portugal,10281762,2020-03-20,143,1,785,3,0.07634878146372188,0.003821656050955414,4,112
Europe,Portugal,10281762,2020-03-21,235,3,1020,6,0.09920478610572779,0.0058823529411764705,5,112
Europe,Portugal,10281762,2020-03-22,260,6,1280,12,0.12449228060326627,0.009375,6,112
Europe,Portugal,10281762,2020-03-23,320,2,1600,14,0.1556153507540828,0.00875,7,112
Europe,Portugal,10281762,2020-03-24,460,9,2060,23,0.20035476409588163,0.01116504854368932,8,112
Europe,Portugal,10281762,2020-03-25,302,10,2362,33,0.22972716155071474,0.01397121083827265,9,112
Europe,Portugal,10281762,2020-03-26,633,10,2995,43,0.2912924846927988,0.014357262103505844,10,112
Europe,Portugal,10281762,2020-03-27,549,17,3544,60,0.3446880019202934,0.016930022573363433,11,112
Europe,Portugal,10281762,2020-03-28,724,16,4268,76,0.4151039481365159,0.01780693533270853,12,112
Europe,Portugal,10281762,2020-03-29,902,24,5170,100,0.5028321021241301,0.019342359767891684,13,112
Europe,Portugal,10281762,2020-03-30,792,19,5962,119,0.5798617007474011,0.019959745051995974,14,112
Europe,Portugal,10281762,2020-03-31,446,21,6408,140,0.6232394797701016,0.02184769038701623,15,112
Europe,Portugal,10281762,2020-04-01,1035,20,7443,160,0.723903159789149,0.02149670831653903,16,112
Europe,Portugal,10281762,2020-04-02,808,27,8251,187,0.8024889119199609,0.02266391952490607,17,112
Europe,Portugal,10281762,2020-04-03,783,22,9034,209,0.8786431741952401,0.02313482399822891,18,112
Europe,Portugal,10281762,2020-04-04,852,37,9886,246,0.9615083484717892,0.024883673882257738,19,112
Europe,Portugal,10281762,2020-04-05,638,20,10524,266,1.0235599695849797,0.025275560623337134,20,112
Europe,Portugal,10281762,2020-04-06,754,29,11278,295,1.0968937036278412,0.02615712005674765,21,112
Europe,Portugal,10281762,2020-04-07,452,16,11730,311,1.1408550402158695,0.026513213981244673,22,112
Europe,Portugal,10281762,2020-04-08,712,34,12442,345,1.2101038713014365,0.027728660986979584,23,112
Europe,Portugal,10281762,2020-04-09,699,35,13141,380,1.2780883276621262,0.02891712959439921,24,112
Europe,Portugal,10281762,2020-04-10,815,29,13956,409,1.3573548969524873,0.029306391516193752,25,112
Europe,Portugal,10281762,2020-04-11,1516,26,15472,435,1.5048004417919807,0.0281153050672182,26,112
Europe,Portugal,10281762,2020-04-12,515,35,15987,470,1.5548891328159513,0.02939888659535873,27,112
Europe,Portugal,10281762,2020-04-13,598,34,16585,504,1.6130503701602896,0.03038890563762436,28,112
Europe,Portugal,10281762,2020-04-14,349,31,16934,535,1.646993968543524,0.03159324436045825,29,112
Europe,Portugal,10281762,2020-04-15,514,32,17448,567,1.6969853999732731,0.03249656121045392,30,112
Europe,Portugal,10281762,2020-04-16,643,32,18091,599,1.75952331905757,0.03311038637996794,31,112
Europe,Portugal,10281762,2020-04-17,750,30,18841,629,1.8324680147235464,0.033384639881110345,32,112
Europe,Portugal,10281762,2020-04-18,181,28,19022,657,1.850072001277602,0.034538954894332875,33,112
Europe,Portugal,10281762,2020-04-19,663,30,19685,687,1.9145551122463251,0.034899669799339596,34,112
Europe,Portugal,10281762,2020-04-20,521,27,20206,714,1.9652273608356234,0.03533603880035633,35,112
Europe,Portugal,10281762,2020-04-21,657,21,20863,735,2.029126914239019,0.03522983271820927,36,112
Europe,Portugal,10281762,2020-04-22,516,27,21379,762,2.0793128648572106,0.035642452874315916,37,112
Europe,Portugal,10281762,2020-04-23,603,23,21982,785,2.1379604001726555,0.035711036302429264,38,112
Europe,Portugal,10281762,2020-04-24,371,35,22353,820,2.174043709628758,0.03668411398917371,39,112
Europe,Portugal,10281762,2020-04-25,918,60,23271,880,2.263328017123913,0.037815306604787075,40,112
Europe,Portugal,10281762,2020-04-26,412,23,23683,903,2.30339896994309,0.038128615462568086,41,112
Europe,Portugal,10281762,2020-04-27,163,25,23846,928,2.3192522838011618,0.0389163801056781,42,112
Europe,Portugal,10281762,2020-04-28,298,20,24144,948,2.3482356428791094,0.03926441351888668,43,112
Europe,Portugal,10281762,2020-04-29,180,25,24324,973,2.365742369838944,0.04000164446637066,44,112
Europe,Portugal,10281762,2020-04-30,368,16,24692,989,2.401533900512383,0.040053458610076136,45,112
Europe,Portugal,10281762,2020-05-01,295,18,24987,1007,2.430225480807667,0.04030095649737864,46,112
Europe,Portugal,10281762,2020-05-02,364,0,25351,1007,2.4656279731042208,0.039722298923119403,47,112
Europe,Portugal,10281762,2020-05-04,334,40,25524,1063,2.482453882904506,0.041647077260617456,49,112
Europe,Portugal,10281762,2020-05-05,0,0,25524,1063,2.482453882904506,0.041647077260617456,50,112
Europe,Portugal,10281762,2020-05-06,178,11,25702,1074,2.499766090675898,0.04178663139055326,51,112
Europe,Portugal,10281762,2020-05-07,480,15,26182,1089,2.5464506959021223,0.04159346115651975,52,112
Europe,Portugal,10281762,2020-05-08,533,16,26715,1105,2.5982900596220766,0.0413625304136253,53,112
Europe,Portugal,10281762,2020-05-09,553,9,27268,1114,2.6520746152264567,0.04085374798298372,54,112
Europe,Portugal,10281762,2020-05-10,138,12,27406,1126,2.665496439228996,0.041085893599941616,55,112
Europe,Portugal,10281762,2020-05-11,175,9,27581,1135,2.6825168682177236,0.0411515173488996,56,112
Europe,Portugal,10281762,2020-05-12,98,9,27679,1144,2.6920483084514113,0.041330972939773836,57,112
Europe,Portugal,10281762,2020-05-13,234,19,27913,1163,2.714807053499196,0.04166517393329273,58,112
Europe,Portugal,10281762,2020-05-14,219,12,28132,1175,2.7361069046336612,0.04176738234039528,59,112
Europe,Portugal,10281762,2020-05-15,187,9,28319,1184,2.7542944487530443,0.041809385924644234,60,112
Europe,Portugal,10281762,2020-05-16,264,6,28583,1190,2.7799709816274683,0.04163313857887556,61,112
Europe,Portugal,10281762,2020-05-17,227,13,28810,1203,2.8020489095157037,0.04175633460603957,62,112
Europe,Portugal,10281762,2020-05-18,226,15,29036,1218,2.8240295778097178,0.041947926711668276,63,112
Europe,Portugal,10281762,2020-05-19,173,13,29209,1231,2.840855487610003,0.042144544489712076,64,112
Europe,Portugal,10281762,2020-05-20,223,16,29432,1247,2.8625443771213535,0.04236885023104105,65,112
Europe,Portugal,10281762,2020-05-21,228,16,29660,1263,2.8847195646038104,0.042582602832097104,66,112
Europe,Portugal,10281762,2020-05-22,252,14,29912,1277,2.909228982347578,0.042691896228938216,67,112
Europe,Portugal,10281762,2020-05-23,288,12,30200,1289,2.937239745483313,0.04268211920529801,68,112
Europe,Portugal,10281762,2020-05-24,271,13,30471,1302,2.963597095517286,0.042729152308752585,69,112
Europe,Portugal,10281762,2020-05-25,152,14,30623,1316,2.9783805538389236,0.04297423505208504,70,112
Europe,Portugal,10281762,2020-05-26,165,14,30788,1330,2.9944283868854384,0.04319864882421723,71,112
Europe,Portugal,10281762,2020-05-27,219,12,31007,1342,3.015728238019904,0.04328054955332667,72,112
America,Puerto Rico,3195153,2020-03-28,64,2,64,2,0.02003033970517218,0.03125,0,113
America,Puerto Rico,3195153,2020-03-29,36,1,100,3,0.03129740578933153,0.03,1,113
America,Puerto Rico,3195153,2020-03-30,27,2,127,5,0.03974770535245104,0.03937007874015748,2,113
America,Puerto Rico,3195153,2020-03-31,47,1,174,6,0.05445748607343686,0.034482758620689655,3,113
America,Puerto Rico,3195153,2020-04-01,65,2,239,8,0.07480079983650235,0.03347280334728033,4,113
America,Puerto Rico,3195153,2020-04-02,47,3,286,11,0.08951058055748817,0.038461538461538464,5,113
America,Puerto Rico,3195153,2020-04-03,30,1,316,12,0.09889980229428763,0.0379746835443038,6,113
America,Puerto Rico,3195153,2020-04-04,62,3,378,15,0.11830419388367318,0.03968253968253968,7,113
America,Puerto Rico,3195153,2020-04-05,74,3,452,18,0.14146427416777851,0.03982300884955752,8,113
America,Puerto Rico,3195153,2020-04-06,23,2,475,20,0.14866267749932477,0.042105263157894736,9,113
America,Puerto Rico,3195153,2020-04-07,38,1,513,21,0.16055569169927075,0.04093567251461988,10,113
America,Puerto Rico,3195153,2020-04-08,60,2,573,23,0.17933413517286967,0.04013961605584642,11,113
America,Puerto Rico,3195153,2020-04-09,47,1,620,24,0.19404391589385547,0.03870967741935484,12,113
America,Puerto Rico,3195153,2020-04-10,63,9,683,33,0.21376128154113436,0.048316251830161056,13,113
America,Puerto Rico,3195153,2020-04-11,42,6,725,39,0.22690619197265358,0.05379310344827586,14,113
America,Puerto Rico,3195153,2020-04-12,63,3,788,42,0.24662355761993246,0.0532994923857868,15,113
America,Puerto Rico,3195153,2020-04-13,109,2,897,44,0.28073772993030377,0.04905239687848383,16,113
America,Puerto Rico,3195153,2020-04-14,6,1,903,45,0.28261557427766365,0.04983388704318937,17,113
America,Puerto Rico,3195153,2020-04-15,20,0,923,45,0.28887505543553,0.04875406283856988,18,113
America,Puerto Rico,3195153,2020-04-16,51,6,974,51,0.3048367323880891,0.052361396303901436,19,113
America,Puerto Rico,3195153,2020-04-17,69,5,1043,56,0.3264319423827279,0.053691275167785234,20,113
America,Puerto Rico,3195153,2020-04-18,25,2,1068,58,0.3342562938300607,0.054307116104868915,21,113
America,Puerto Rico,3195153,2020-04-19,50,2,1118,60,0.34990499672472647,0.05366726296958855,22,113
America,Puerto Rico,3195153,2020-04-20,95,2,1213,62,0.37963753222459146,0.051112943116240726,23,113
America,Puerto Rico,3195153,2020-04-21,39,1,1252,63,0.3918435204824307,0.050319488817891375,24,113
America,Puerto Rico,3195153,2020-04-22,0,0,1252,63,0.3918435204824307,0.050319488817891375,25,113
America,Puerto Rico,3195153,2020-04-23,0,1,1252,64,0.3918435204824307,0.051118210862619806,26,113
America,Puerto Rico,3195153,2020-04-24,0,5,1252,69,0.3918435204824307,0.05511182108626198,27,113
America,Puerto Rico,3195153,2020-04-25,24,8,1276,77,0.39935489787187034,0.0603448275862069,28,113
America,Puerto Rico,3195153,2020-04-26,31,6,1307,83,0.40905709366656307,0.06350420811017597,29,113
America,Puerto Rico,3195153,2020-04-27,64,1,1371,84,0.4290874333717352,0.061269146608315096,30,113
America,Puerto Rico,3195153,2020-04-28,18,0,1389,84,0.43472096641381497,0.06047516198704104,31,113
America,Puerto Rico,3195153,2020-04-29,11,2,1400,86,0.43816368105064135,0.06142857142857143,32,113
America,Puerto Rico,3195153,2020-04-30,33,0,1433,86,0.44849182496112083,0.06001395673412421,33,113
America,Puerto Rico,3195153,2020-05-01,106,6,1539,92,0.4816670750978122,0.05977907732293697,34,113
America,Puerto Rico,3195153,2020-05-02,36,2,1575,94,0.4929341411819716,0.059682539682539684,35,113
America,Puerto Rico,3195153,2020-05-03,182,1,1757,95,0.5498954197185549,0.05406943653955606,36,113
America,Puerto Rico,3195153,2020-05-04,51,2,1808,97,0.5658570966711141,0.053650442477876106,37,113
America,Puerto Rico,3195153,2020-05-05,35,0,1843,97,0.5768111886973801,0.05263157894736842,38,113
America,Puerto Rico,3195153,2020-05-06,81,2,1924,99,0.6021620873867386,0.05145530145530146,39,113
America,Puerto Rico,3195153,2020-05-07,44,0,1968,99,0.6159329459340445,0.05030487804878049,40,113
America,Puerto Rico,3195153,2020-05-08,63,3,2031,102,0.6356503115813233,0.050221565731166914,41,113
America,Puerto Rico,3195153,2020-05-09,125,5,2156,107,0.6747720688179878,0.04962894248608534,42,113
America,Puerto Rico,3195153,2020-05-10,17,1,2173,108,0.6800926278021742,0.049700874367234235,43,113
America,Puerto Rico,3195153,2020-05-11,25,3,2198,111,0.687916979249507,0.050500454959053684,44,113
America,Puerto Rico,3195153,2020-05-12,58,2,2256,113,0.7060694746073193,0.050088652482269506,45,113
America,Puerto Rico,3195153,2020-05-13,43,1,2299,114,0.7195273590967318,0.049586776859504134,46,113
America,Puerto Rico,3195153,2020-05-14,30,1,2329,115,0.7289165808335313,0.04937741519965651,47,113
America,Puerto Rico,3195153,2020-05-15,98,2,2427,117,0.7595880385070761,0.048207663782447466,48,113
America,Puerto Rico,3195153,2020-05-16,115,5,2542,122,0.7955800551648075,0.04799370574350905,49,113
America,Puerto Rico,3195153,2020-05-17,47,0,2589,122,0.8102898358857933,0.04712244109694863,50,113
America,Puerto Rico,3195153,2020-05-18,57,1,2646,123,0.8281293571857122,0.046485260770975055,51,113
America,Puerto Rico,3195153,2020-05-19,64,1,2710,124,0.8481596968908844,0.045756457564575644,52,113
America,Puerto Rico,3195153,2020-05-20,95,0,2805,124,0.8778922323907493,0.04420677361853832,53,113
America,Puerto Rico,3195153,2020-05-21,61,1,2866,125,0.8969836499222417,0.04361479413817167,54,113
America,Puerto Rico,3195153,2020-05-22,47,1,2913,126,0.9116934306432275,0.04325437693099897,55,113
America,Puerto Rico,3195153,2020-05-23,117,0,3030,126,0.9483113954167454,0.041584158415841586,56,113
America,Puerto Rico,3195153,2020-05-24,70,1,3100,127,0.9702195794692774,0.04096774193548387,57,113
America,Puerto Rico,3195153,2020-05-25,89,0,3189,127,0.9980742706217824,0.03982439636249608,58,113
America,Puerto Rico,3195153,2020-05-26,71,2,3260,129,1.0202954287322077,0.039570552147239264,59,113
America,Puerto Rico,3195153,2020-05-27,64,0,3324,129,1.0403257684373801,0.0388086642599278,60,113
Asia,Qatar,2781677,2020-03-12,238,0,262,0,0.09418778672002537,0,0,114
Asia,Qatar,2781677,2020-03-14,58,0,320,0,0.11503851813132869,0,1,114
Asia,Qatar,2781677,2020-03-15,17,0,337,0,0.12114993940705553,0,2,114
Asia,Qatar,2781677,2020-03-16,64,0,401,0,0.14415764303332126,0,3,114
Asia,Qatar,2781677,2020-03-17,38,0,439,0,0.15781846706141656,0,4,114
Asia,Qatar,2781677,2020-03-18,3,0,442,0,0.15889695316889776,0,5,114
Asia,Qatar,2781677,2020-03-19,10,0,452,0,0.16249190686050177,0,6,114
Asia,Qatar,2781677,2020-03-20,8,0,460,0,0.16536786981378498,0,7,114
Asia,Qatar,2781677,2020-03-21,10,0,470,0,0.168962823505389,0,8,114
Asia,Qatar,2781677,2020-03-22,11,0,481,0,0.17291727256615344,0,9,114
Asia,Qatar,2781677,2020-03-23,13,0,494,0,0.17759071236523866,0,10,114
Asia,Qatar,2781677,2020-03-24,7,0,501,0,0.18010717994936148,0,11,114
Asia,Qatar,2781677,2020-03-25,25,0,526,0,0.18909456417837153,0,12,114
Asia,Qatar,2781677,2020-03-26,11,0,537,0,0.19304901323913595,0,13,114
Asia,Qatar,2781677,2020-03-27,12,0,549,0,0.19736295766906078,0,14,114
Asia,Qatar,2781677,2020-03-28,13,0,562,0,0.20203639746814603,0,15,114
Asia,Qatar,2781677,2020-03-29,28,1,590,1,0.21210226780463728,0.001694915254237288,16,114
Asia,Qatar,2781677,2020-03-30,44,0,634,1,0.22792006404769496,0.0015772870662460567,17,114
Asia,Qatar,2781677,2020-03-31,59,0,693,1,0.2491302908281587,0.001443001443001443,18,114
Asia,Qatar,2781677,2020-04-01,88,1,781,2,0.2807658833142741,0.002560819462227913,19,114
Asia,Qatar,2781677,2020-04-02,54,0,835,2,0.30017863324893584,0.0023952095808383233,20,114
Asia,Qatar,2781677,2020-04-03,114,1,949,3,0.3411611053332217,0.003161222339304531,21,114
Asia,Qatar,2781677,2020-04-04,0,0,949,3,0.3411611053332217,0.003161222339304531,22,114
Asia,Qatar,2781677,2020-04-05,376,0,1325,3,0.47633136413753285,0.0022641509433962265,23,114
Asia,Qatar,2781677,2020-04-06,279,1,1604,4,0.5766305721332851,0.0024937655860349127,24,114
Asia,Qatar,2781677,2020-04-07,228,0,1832,4,0.6585955163018568,0.002183406113537118,25,114
Asia,Qatar,2781677,2020-04-08,225,2,2057,6,0.7394819743629473,0.002916869227029655,26,114
Asia,Qatar,2781677,2020-04-09,153,0,2210,6,0.7944847658444888,0.0027149321266968325,27,114
Asia,Qatar,2781677,2020-04-10,166,0,2376,6,0.8541609971251155,0.0025252525252525255,28,114
Asia,Qatar,2781677,2020-04-11,136,0,2512,6,0.9030523673309302,0.0023885350318471337,29,114
Asia,Qatar,2781677,2020-04-12,216,0,2728,6,0.9807033670695771,0.0021994134897360706,30,114
Asia,Qatar,2781677,2020-04-13,251,1,2979,7,1.070936704728838,0.0023497818059751594,31,114
Asia,Qatar,2781677,2020-04-14,252,0,3231,7,1.1615295377572594,0.002166511915815537,32,114
Asia,Qatar,2781677,2020-04-15,197,0,3428,7,1.2323501254818585,0.002042007001166861,33,114
Asia,Qatar,2781677,2020-04-16,283,0,3711,7,1.3340873149542525,0.001886284020479655,34,114
Asia,Qatar,2781677,2020-04-17,392,0,4103,7,1.47500949966513,0.0017060687301974165,35,114
Asia,Qatar,2781677,2020-04-18,560,0,4663,7,1.6763269063949553,0.0015011794981771391,36,114
Asia,Qatar,2781677,2020-04-19,345,1,5008,8,1.800352808755294,0.001597444089456869,37,114
Asia,Qatar,2781677,2020-04-20,440,0,5448,8,1.9585307711858708,0.0014684287812041115,38,114
Asia,Qatar,2781677,2020-04-21,567,1,6015,9,2.162364645499819,0.0014962593516209476,39,114
Asia,Qatar,2781677,2020-04-22,518,0,6533,9,2.3485832467249073,0.0013776213072095515,40,114
Asia,Qatar,2781677,2020-04-23,608,1,7141,10,2.567156431174432,0.0014003640946646128,41,114
Asia,Qatar,2781677,2020-04-24,623,0,7764,10,2.7911220461613624,0.001287995878413189,42,114
Asia,Qatar,2781677,2020-04-25,761,0,8525,10,3.0646980220924283,0.0011730205278592375,43,114
Asia,Qatar,2781677,2020-04-26,833,0,9358,10,3.3641576646030438,0.0010686044026501388,44,114
Asia,Qatar,2781677,2020-04-27,929,0,10287,10,3.698128862553057,9.72100709633518e-4,45,114
Asia,Qatar,2781677,2020-04-28,957,0,11244,10,4.042165930839562,8.893632159373888e-4,46,114
Asia,Qatar,2781677,2020-04-29,677,0,11921,10,4.285544295761154,8.388558006878617e-4,47,114
Asia,Qatar,2781677,2020-04-30,643,0,12564,10,4.5166998181312925,7.95924864692773e-4,48,114
Asia,Qatar,2781677,2020-05-01,845,0,13409,10,4.820473405071833,7.457677679170706e-4,49,114
Asia,Qatar,2781677,2020-05-02,687,2,14096,12,5.06744672368503,8.51305334846765e-4,50,114
Asia,Qatar,2781677,2020-05-03,776,0,14872,12,5.346415130153501,8.068854222700376e-4,51,114
Asia,Qatar,2781677,2020-05-04,679,0,15551,12,5.590512485813415,7.716545559771075e-4,52,114
Asia,Qatar,2781677,2020-05-05,640,0,16191,12,5.820589522076072,7.411524921252547e-4,53,114
Asia,Qatar,2781677,2020-05-06,951,0,17142,12,6.162469618147614,7.000350017500875e-4,54,114
Asia,Qatar,2781677,2020-05-07,830,0,17972,12,6.460850774550748,6.677053193857111e-4,55,114
Asia,Qatar,2781677,2020-05-08,918,0,18890,12,6.790867523439997,6.352567496029645e-4,56,114
Asia,Qatar,2781677,2020-05-09,1311,0,20201,12,7.262165952409284,5.94029998514925e-4,57,114
Asia,Qatar,2781677,2020-05-10,1130,1,21331,13,7.668395719560539,6.094416576813089e-4,58,114
Asia,Qatar,2781677,2020-05-11,1189,1,22520,14,8.095835713492258,6.216696269982238e-4,59,114
Asia,Qatar,2781677,2020-05-12,1103,0,23623,14,8.492359105676181,5.926427634085425e-4,60,114
Asia,Qatar,2781677,2020-05-13,1526,0,25149,14,9.040949039014954,5.566821742415205e-4,61,114
Asia,Qatar,2781677,2020-05-14,1390,0,26539,14,9.540647602147912,5.275255284675383e-4,62,114
Asia,Qatar,2781677,2020-05-15,1733,0,28272,14,10.16365307690289,4.951895868704018e-4,63,114
Asia,Qatar,2781677,2020-05-16,1153,0,29425,14,10.578151237544834,4.75785896346644e-4,64,114
Asia,Qatar,2781677,2020-05-17,1547,1,30972,15,11.134290573635976,4.8430840759395585e-4,65,114
Asia,Qatar,2781677,2020-05-18,1632,0,32604,15,11.720987016105752,4.6006624953993377e-4,66,114
Asia,Qatar,2781677,2020-05-19,1365,0,33969,15,12.211698195009701,4.415790868144485e-4,67,114
Asia,Qatar,2781677,2020-05-20,1637,0,35606,15,12.800192114325279,4.2127731281244734e-4,68,114
Asia,Qatar,2781677,2020-05-21,1491,1,37097,16,13.33619970974344,4.3130172251125426e-4,69,114
Asia,Qatar,2781677,2020-05-22,1554,1,38651,17,13.894855513418705,4.39833380766345e-4,70,114
Asia,Qatar,2781677,2020-05-23,1830,2,40481,19,14.55273203898224,4.693559941701045e-4,71,114
Asia,Qatar,2781677,2020-05-24,1732,2,42213,21,15.175378018368058,4.974770805202189e-4,72,114
Asia,Qatar,2781677,2020-05-25,1501,2,43714,23,15.714980567477822,5.261472297204557e-4,73,114
Asia,Qatar,2781677,2020-05-26,1751,3,45465,26,16.344456958877686,5.71868470251842e-4,74,114
Asia,Qatar,2781677,2020-05-27,1742,2,47207,28,16.970697891955105,5.931323744359947e-4,75,114
Europe,Romania,19473936,2020-03-23,66,2,433,2,0.022234847644564508,0.004618937644341801,0,115
Europe,Romania,19473936,2020-03-24,143,5,576,7,0.02957799594288489,0.012152777777777778,1,115
Europe,Romania,19473936,2020-03-25,186,4,762,11,0.03912922379944147,0.014435695538057743,2,115
Europe,Romania,19473936,2020-03-26,144,2,906,13,0.04652372278516269,0.01434878587196468,3,115
Europe,Romania,19473936,2020-03-27,123,4,1029,17,0.052839857335466235,0.01652089407191448,4,115
Europe,Romania,19473936,2020-03-28,263,7,1292,24,0.06634508812188764,0.018575851393188854,5,115
Europe,Romania,19473936,2020-03-29,160,5,1452,29,0.074561198106022325,0.01997245179063361,6,115
Europe,Romania,19473936,2020-03-30,308,11,1760,40,0.09037720982548161,0.022727272727272728,7,115
Europe,Romania,19473936,2020-03-31,192,4,1952,44,0.10023654180644324,0.022540983606557378,8,115
Europe,Romania,19473936,2020-04-01,293,25,2245,69,0.11528229321488989,0.030734966592427616,9,115
Europe,Romania,19473936,2020-04-02,215,16,2460,85,0.12632269100607088,0.034552845528455285,10,115
Europe,Romania,19473936,2020-04-03,278,9,2738,94,0.14059818210350492,0.03433162892622352,11,115
Europe,Romania,19473936,2020-04-04,445,39,3183,133,0.16344923799687952,0.041784480050267046,12,115
Europe,Romania,19473936,2020-04-05,430,8,3613,141,0.18553003357924153,0.039025740381954055,13,115
Europe,Romania,19473936,2020-04-06,251,7,3864,148,0.19841905611685282,0.038302277432712216,14,115
Europe,Romania,19473936,2020-04-07,193,9,4057,157,0.2083297387852153,0.03869854572344097,15,115
Europe,Romania,19473936,2020-04-08,360,25,4417,182,0.22681598624951835,0.04120443740095087,16,115
Europe,Romania,19473936,2020-04-09,344,27,4761,209,0.24448062271540794,0.0438983406847301,17,115
Europe,Romania,19473936,2020-04-10,441,20,5202,229,0.26712627585917914,0.04402153018069973,18,115
Europe,Romania,19473936,2020-04-11,265,28,5467,257,0.2807342080204023,0.04700932869946955,19,115
Europe,Romania,19473936,2020-04-12,523,25,5990,282,0.3075906175310425,0.04707846410684474,20,115
Europe,Romania,19473936,2020-04-13,310,24,6300,306,0.32350933062530346,0.04857142857142857,21,115
Europe,Romania,19473936,2020-04-14,333,12,6633,318,0.3406091095297838,0.04794210764360018,22,115
Europe,Romania,19473936,2020-04-15,246,26,6879,344,0.3532413786303909,0.05000726849832825,23,115
Europe,Romania,19473936,2020-04-16,337,28,7216,372,0.3705465602844746,0.05155210643015521,24,115
Europe,Romania,19473936,2020-04-17,491,15,7707,387,0.39575974779828793,0.05021409108602569,25,115
Europe,Romania,19473936,2020-04-18,360,13,8067,400,0.414245995262591,0.04958472790380563,26,115
Europe,Romania,19473936,2020-04-19,351,17,8418,417,0.4322700865402864,0.04953670705630791,27,115
Europe,Romania,19473936,2020-04-20,328,17,8746,434,0.44911311200776255,0.04962268465584267,28,115
Europe,Romania,19473936,2020-04-21,190,17,8936,451,0.45886974261392255,0.05047000895255148,29,115
Europe,Romania,19473936,2020-04-22,306,32,9242,483,0.4745830529585801,0.05226141527807834,30,115
Europe,Romania,19473936,2020-04-23,468,25,9710,508,0.49861517466217414,0.05231719876416066,31,115
Europe,Romania,19473936,2020-04-24,386,19,10096,527,0.518436539998899,0.05219889064976228,32,115
Europe,Romania,19473936,2020-04-25,321,25,10417,552,0.5349201106545693,0.052990304310262075,33,115
Europe,Romania,19473936,2020-04-26,218,23,10635,575,0.5461145605079528,0.0540667606958157,34,115
Europe,Romania,19473936,2020-04-27,401,33,11036,608,0.5667061861556904,0.055092424791591155,35,115
Europe,Romania,19473936,2020-04-28,303,23,11339,631,0.5822654444381454,0.05564864626510274,36,115
Europe,Romania,19473936,2020-04-29,277,19,11616,650,0.5964895848481786,0.0559573002754821,37,115
Europe,Romania,19473936,2020-04-30,362,25,11978,675,0.6150785336872833,0.056353314409751214,38,115
Europe,Romania,19473936,2020-05-01,262,42,12240,717,0.628532413786304,0.05857843137254902,39,115
Europe,Romania,19473936,2020-05-02,327,27,12567,744,0.6453240885663792,0.05920267366913345,40,115
Europe,Romania,19473936,2020-05-03,165,27,12732,771,0.6537969519875181,0.06055607917059378,41,115
Europe,Romania,19473936,2020-05-04,431,9,13163,780,0.6759290982572809,0.05925700828078705,42,115
Europe,Romania,19473936,2020-05-05,349,23,13512,803,0.6938504881601747,0.05942865600947306,43,115
Europe,Romania,19473936,2020-05-06,325,24,13837,827,0.7105394615654483,0.059767290597672905,44,115
Europe,Romania,19473936,2020-05-07,270,31,14107,858,0.7244041471636755,0.06082086907209187,45,115
Europe,Romania,19473936,2020-05-08,392,18,14499,876,0.7445336166248055,0.060417959859300645,46,115
Europe,Romania,19473936,2020-05-09,312,22,14811,898,0.7605550310938682,0.06063061238268854,47,115
Europe,Romania,19473936,2020-05-10,320,28,15131,926,0.7769872510621376,0.0611988632608552,48,115
Europe,Romania,19473936,2020-05-11,231,26,15362,952,0.788849259851732,0.06197109751334462,49,115
Europe,Romania,19473936,2020-05-12,226,20,15588,972,0.8004545152043224,0.06235565819861432,50,115
Europe,Romania,19473936,2020-05-13,190,30,15778,1002,0.8102111458104823,0.0635061478007352,51,115
Europe,Romania,19473936,2020-05-14,224,14,16002,1016,0.8217136997882708,0.06349206349206349,52,115
Europe,Romania,19473936,2020-05-15,245,30,16247,1046,0.8342946182014771,0.06438111651381793,53,115
Europe,Romania,19473936,2020-05-16,190,10,16437,1056,0.844051248807637,0.06424530023726957,54,115
Europe,Romania,19473936,2020-05-17,267,25,16704,1081,0.8577618823436619,0.06471503831417624,55,115
Europe,Romania,19473936,2020-05-18,167,16,16871,1097,0.8663374471396024,0.0650228202240531,56,115
Europe,Romania,19473936,2020-05-19,165,10,17036,1107,0.8748103105607412,0.06498004226344212,57,115
Europe,Romania,19473936,2020-05-20,155,19,17191,1126,0.8827696671078719,0.06549938921528707,58,115
Europe,Romania,19473936,2020-05-21,196,15,17387,1141,0.8928344018384368,0.06562374187611433,59,115
Europe,Romania,19473936,2020-05-22,198,10,17585,1151,0.9030018379438035,0.06545351151549617,60,115
Europe,Romania,19473936,2020-05-23,127,8,17712,1159,0.9095233752437103,0.06543586269196025,61,115
Europe,Romania,19473936,2020-05-24,145,11,17857,1170,0.9169692249168324,0.06552052416419331,62,115
Europe,Romania,19473936,2020-05-25,213,9,18070,1179,0.9279069213332117,0.06524626452684007,63,115
Europe,Romania,19473936,2020-05-26,213,18,18283,1197,0.938844617749591,0.06547065580047039,64,115
Europe,Romania,19473936,2020-05-27,146,13,18429,1210,0.9463418181101139,0.06565738781268653,65,115
Europe,Russia,144478050,2020-04-03,771,6,3548,30,0.024557363557993758,0.008455467869222097,0,116
Europe,Russia,144478050,2020-04-04,601,4,4149,34,0.028717164994959445,0.008194745721860689,1,116
Europe,Russia,144478050,2020-04-05,582,9,4731,43,0.03274545856619743,0.009088987529063623,2,116
Europe,Russia,144478050,2020-04-06,658,2,5389,45,0.03729978360034621,0.00835034329189089,3,116
Europe,Russia,144478050,2020-04-07,954,2,6343,47,0.043902862753200225,0.00740974302380577,4,116
Europe,Russia,144478050,2020-04-08,1154,11,7497,58,0.05189023522950372,0.007736427904495131,5,116
Europe,Russia,144478050,2020-04-09,1175,5,8672,63,0.06002295850476941,0.007264760147601476,6,116
Europe,Russia,144478050,2020-04-10,1459,13,10131,76,0.07012137829933336,0.007501727371434212,7,116
Europe,Russia,144478050,2020-04-11,1786,18,11917,94,0.0824831176777372,0.007887891247797265,8,116
Europe,Russia,144478050,2020-04-12,1667,12,13584,106,0.09402120252868862,0.007803297997644287,9,116
Europe,Russia,144478050,2020-04-13,2186,24,15770,130,0.1091515285539914,0.008243500317057704,10,116
Europe,Russia,144478050,2020-04-14,2558,18,18328,148,0.12685664016091025,0.008075076385857704,11,116
Europe,Russia,144478050,2020-04-15,2774,22,21102,170,0.14605678855715454,0.008056108425741636,12,116
Europe,Russia,144478050,2020-04-16,3388,28,24490,198,0.16950671745638868,0.008084932625561453,13,116
Europe,Russia,144478050,2020-04-17,3448,34,27938,232,0.19337193435265773,0.008304101940010022,14,116
Europe,Russia,144478050,2020-04-18,4070,41,32008,273,0.22154230348485462,0.008529117720569858,15,116
Europe,Russia,144478050,2020-04-19,4785,40,36793,313,0.2546615212483834,0.008507052972032724,16,116
Europe,Russia,144478050,2020-04-20,6060,48,42853,361,0.2966056089489026,0.008424147667607868,17,116
Europe,Russia,144478050,2020-04-21,4268,44,47121,405,0.32614642847131453,0.00859489399630738,18,116
Europe,Russia,144478050,2020-04-22,5642,51,52763,456,0.3651973431258243,0.008642419877565718,19,116
Europe,Russia,144478050,2020-04-23,5236,57,57999,513,0.40143814233373165,0.00884498008586355,20,116
Europe,Russia,144478050,2020-04-24,4774,42,62773,555,0.43448122396447075,0.008841380848453952,21,116
Europe,Russia,144478050,2020-04-25,5849,60,68622,615,0.4749648822087507,0.008962140421439188,22,116
Europe,Russia,144478050,2020-04-26,5966,66,74588,681,0.5162583520472487,0.00913015498471604,23,116
Europe,Russia,144478050,2020-04-27,6361,66,80949,747,0.5602858011995594,0.009228032464885298,24,116
Europe,Russia,144478050,2020-04-28,6198,48,87147,795,0.6031850512932587,0.009122517126234983,25,116
Europe,Russia,144478050,2020-04-29,6411,72,93558,867,0.6475585737764318,0.009266978772526134,26,116
Europe,Russia,144478050,2020-04-30,5841,105,99399,972,0.6879868602877738,0.009778770410165092,27,116
Europe,Russia,144478050,2020-05-01,7099,101,106498,1073,0.7371223518036131,0.010075306578527296,28,116
Europe,Russia,144478050,2020-05-02,7933,96,114431,1169,0.7920303464782366,0.010215763211017994,29,116
Europe,Russia,144478050,2020-05-03,9623,53,124054,1222,0.8586356197360083,0.009850548954487563,30,116
Europe,Russia,144478050,2020-05-04,10633,58,134687,1280,0.9322315742771998,0.009503515558294416,31,116
Europe,Russia,144478050,2020-05-05,10581,76,145268,1356,1.0054676125542945,0.009334471459646998,32,116
Europe,Russia,144478050,2020-05-06,10102,95,155370,1451,1.0753882683217277,0.00933899723241295,33,116
Europe,Russia,144478050,2020-05-07,10559,86,165929,1537,1.148472034333243,0.009262998029277582,34,116
Europe,Russia,144478050,2020-05-08,11231,88,177160,1625,1.2262070259115485,0.009172499435538497,35,116
Europe,Russia,144478050,2020-05-09,10699,98,187859,1723,1.3002597972494785,0.009171772446356044,36,116
Europe,Russia,144478050,2020-05-10,10817,104,198676,1827,1.3751293016482433,0.009195876703779016,37,116
Europe,Russia,144478050,2020-05-11,11012,88,209688,1915,1.4513484920373718,0.009132616077219487,38,116
Europe,Russia,144478050,2020-05-12,11656,94,221344,2009,1.5320251069280075,0.009076369813502964,39,116
Europe,Russia,144478050,2020-05-13,10899,107,232243,2116,1.6074621715893869,0.009111146514641991,40,116
Europe,Russia,144478050,2020-05-14,10028,96,242271,2212,1.6768706388271435,0.009130271472854778,41,116
Europe,Russia,144478050,2020-05-15,9974,93,252245,2305,1.7459053468675692,0.00913794128724058,42,116
Europe,Russia,144478050,2020-05-16,10598,113,262843,2418,1.819259050077157,0.009199408011626713,43,116
Europe,Russia,144478050,2020-05-17,9200,119,272043,2537,1.8829365429558331,0.009325731593902434,44,116
Europe,Russia,144478050,2020-05-18,9709,94,281752,2631,1.9501370623426881,0.009337999375337176,45,116
Europe,Russia,144478050,2020-05-19,8926,91,290678,2722,2.0119180733682382,0.00936431377675641,46,116
Europe,Russia,144478050,2020-05-20,9263,115,299941,2837,2.076031618643801,0.009458526843612577,47,116
Europe,Russia,144478050,2020-05-21,8764,135,308705,2972,2.136691352077357,0.009627314102460278,48,116
Europe,Russia,144478050,2020-05-22,8849,127,317554,3099,2.197939410173379,0.009758970127915252,49,116
Europe,Russia,144478050,2020-05-23,8894,150,326448,3249,2.2594989342671776,0.009952580502867226,50,116
Europe,Russia,144478050,2020-05-24,9434,139,335882,3388,2.3247960503342893,0.010086875748030558,51,116
Europe,Russia,144478050,2020-05-25,8599,153,344481,3541,2.384313741776,0.010279231655737181,52,116
Europe,Russia,144478050,2020-05-26,8946,92,353427,3633,2.446233182133895,0.010279350474072439,53,116
Europe,Russia,144478050,2020-05-27,8915,174,362342,3807,2.5079380570266556,0.010506648415033312,54,116
Africa,Rwanda,12301939,2020-05-02,6,0,249,0,0.020240711647163914,0,0,117
Africa,Rwanda,12301939,2020-05-03,6,0,255,0,0.02072843963866184,0,1,117
Africa,Rwanda,12301939,2020-05-04,4,0,259,0,0.02105359163299379,0,2,117
Africa,Rwanda,12301939,2020-05-05,2,0,261,0,0.021216167630159766,0,3,117
Africa,Rwanda,12301939,2020-05-06,0,0,261,0,0.021216167630159766,0,4,117
Africa,Rwanda,12301939,2020-05-07,7,0,268,0,0.021785183620240678,0,5,117
Africa,Rwanda,12301939,2020-05-08,3,0,271,0,0.02202904761598964,0,6,117
Africa,Rwanda,12301939,2020-05-09,2,0,273,0,0.022191623613155617,0,7,117
Africa,Rwanda,12301939,2020-05-10,7,0,280,0,0.02276063960323653,0,8,117
Africa,Rwanda,12301939,2020-05-11,4,0,284,0,0.02308579159756848,0,9,117
Africa,Rwanda,12301939,2020-05-12,1,0,285,0,0.02316707959615147,0,10,117
Africa,Rwanda,12301939,2020-05-13,1,0,286,0,0.023248367594734455,0,11,117
Africa,Rwanda,12301939,2020-05-14,1,0,287,0,0.02332965559331744,0,12,117
Africa,Rwanda,12301939,2020-05-15,0,0,287,0,0.02332965559331744,0,13,117
Africa,Rwanda,12301939,2020-05-16,0,0,287,0,0.02332965559331744,0,14,117
Africa,Rwanda,12301939,2020-05-17,2,0,289,0,0.023492231590483418,0,15,117
Africa,Rwanda,12301939,2020-05-18,3,0,292,0,0.02373609558623238,0,16,117
Africa,Rwanda,12301939,2020-05-19,5,0,297,0,0.02414253557914732,0,17,117
Africa,Rwanda,12301939,2020-05-20,11,0,308,0,0.025036703563560185,0,18,117
Africa,Rwanda,12301939,2020-05-21,6,0,314,0,0.02552443155505811,0,19,117
Africa,Rwanda,12301939,2020-05-22,6,0,320,0,0.026012159546556037,0,20,117
Africa,Rwanda,12301939,2020-05-23,1,0,321,0,0.026093447545139023,0,21,117
Africa,Rwanda,12301939,2020-05-24,4,0,325,0,0.026418599539470972,0,22,117
Africa,Rwanda,12301939,2020-05-25,2,0,327,0,0.02658117553663695,0,23,117
Africa,Rwanda,12301939,2020-05-26,9,0,336,0,0.027312767523883837,0,24,117
Africa,Rwanda,12301939,2020-05-27,3,0,339,0,0.0275566315196328,0,25,117
America,Saint Lucia,181889,2020-03-29,1,0,4,0,0.021991434336326,0,0,118
America,Saint Lucia,181889,2020-03-30,5,0,9,0,0.0494807272567335,0,1,118
America,Saint Lucia,181889,2020-03-31,0,0,9,0,0.0494807272567335,0,2,118
America,Saint Lucia,181889,2020-04-01,4,0,13,0,0.0714721615930595,0,3,118
America,Saint Lucia,181889,2020-04-02,0,0,13,0,0.0714721615930595,0,4,118
America,Saint Lucia,181889,2020-04-03,0,0,13,0,0.0714721615930595,0,5,118
America,Saint Lucia,181889,2020-04-04,0,0,13,0,0.0714721615930595,0,6,118
America,Saint Lucia,181889,2020-04-05,1,0,14,0,0.07697002017714101,0,7,118
America,Saint Lucia,181889,2020-04-06,0,0,14,0,0.07697002017714101,0,8,118
America,Saint Lucia,181889,2020-04-07,0,0,14,0,0.07697002017714101,0,9,118
America,Saint Lucia,181889,2020-04-08,0,0,14,0,0.07697002017714101,0,10,118
America,Saint Lucia,181889,2020-04-09,0,0,14,0,0.07697002017714101,0,11,118
America,Saint Lucia,181889,2020-04-10,0,0,14,0,0.07697002017714101,0,12,118
America,Saint Lucia,181889,2020-04-11,1,0,15,0,0.0824678787612225,0,13,118
America,Saint Lucia,181889,2020-04-12,0,0,15,0,0.0824678787612225,0,14,118
America,Saint Lucia,181889,2020-04-13,0,0,15,0,0.0824678787612225,0,15,118
America,Saint Lucia,181889,2020-04-14,0,0,15,0,0.0824678787612225,0,16,118
America,Saint Lucia,181889,2020-04-15,0,0,15,0,0.0824678787612225,0,17,118
America,Saint Lucia,181889,2020-04-16,0,0,15,0,0.0824678787612225,0,18,118
America,Saint Lucia,181889,2020-04-17,0,0,15,0,0.0824678787612225,0,19,118
America,Saint Lucia,181889,2020-04-18,0,0,15,0,0.0824678787612225,0,20,118
America,Saint Lucia,181889,2020-04-19,0,0,15,0,0.0824678787612225,0,21,118
America,Saint Lucia,181889,2020-04-20,0,0,15,0,0.0824678787612225,0,22,118
America,Saint Lucia,181889,2020-04-21,0,0,15,0,0.0824678787612225,0,23,118
America,Saint Lucia,181889,2020-04-22,0,0,15,0,0.0824678787612225,0,24,118
America,Saint Lucia,181889,2020-04-23,0,0,15,0,0.0824678787612225,0,25,118
America,Saint Lucia,181889,2020-04-24,0,0,15,0,0.0824678787612225,0,26,118
America,Saint Lucia,181889,2020-04-25,0,0,15,0,0.0824678787612225,0,27,118
America,Saint Lucia,181889,2020-04-26,0,0,15,0,0.0824678787612225,0,28,118
America,Saint Lucia,181889,2020-04-27,0,0,15,0,0.0824678787612225,0,29,118
America,Saint Lucia,181889,2020-04-28,0,0,15,0,0.0824678787612225,0,30,118
America,Saint Lucia,181889,2020-04-29,0,0,15,0,0.0824678787612225,0,31,118
America,Saint Lucia,181889,2020-04-30,2,0,17,0,0.09346359592938551,0,32,118
America,Saint Lucia,181889,2020-05-01,0,0,17,0,0.09346359592938551,0,33,118
America,Saint Lucia,181889,2020-05-02,0,0,17,0,0.09346359592938551,0,34,118
America,Saint Lucia,181889,2020-05-03,0,0,17,0,0.09346359592938551,0,35,118
America,Saint Lucia,181889,2020-05-04,1,0,18,0,0.098961454513467,0,36,118
America,Saint Lucia,181889,2020-05-05,0,0,18,0,0.098961454513467,0,37,118
America,Saint Lucia,181889,2020-05-06,0,0,18,0,0.098961454513467,0,38,118
America,Saint Lucia,181889,2020-05-07,0,0,18,0,0.098961454513467,0,39,118
America,Saint Lucia,181889,2020-05-08,0,0,18,0,0.098961454513467,0,40,118
America,Saint Lucia,181889,2020-05-09,0,0,18,0,0.098961454513467,0,41,118
America,Saint Lucia,181889,2020-05-10,0,0,18,0,0.098961454513467,0,42,118
America,Saint Lucia,181889,2020-05-11,0,0,18,0,0.098961454513467,0,43,118
America,Saint Lucia,181889,2020-05-12,0,0,18,0,0.098961454513467,0,44,118
America,Saint Lucia,181889,2020-05-13,0,0,18,0,0.098961454513467,0,45,118
America,Saint Lucia,181889,2020-05-14,0,0,18,0,0.098961454513467,0,46,118
America,Saint Lucia,181889,2020-05-15,0,0,18,0,0.098961454513467,0,47,118
America,Saint Lucia,181889,2020-05-16,0,0,18,0,0.098961454513467,0,48,118
America,Saint Lucia,181889,2020-05-17,0,0,18,0,0.098961454513467,0,49,118
America,Saint Lucia,181889,2020-05-18,0,0,18,0,0.098961454513467,0,50,118
America,Saint Lucia,181889,2020-05-19,0,0,18,0,0.098961454513467,0,51,118
America,Saint Lucia,181889,2020-05-20,0,0,18,0,0.098961454513467,0,52,118
America,Saint Lucia,181889,2020-05-21,0,0,18,0,0.098961454513467,0,53,118
America,Saint Lucia,181889,2020-05-22,0,0,18,0,0.098961454513467,0,54,118
America,Saint Lucia,181889,2020-05-23,0,0,18,0,0.098961454513467,0,55,118
America,Saint Lucia,181889,2020-05-24,0,0,18,0,0.098961454513467,0,56,118
America,Saint Lucia,181889,2020-05-25,0,0,18,0,0.098961454513467,0,57,118
America,Saint Lucia,181889,2020-05-26,0,0,18,0,0.098961454513467,0,58,118
America,Saint Lucia,181889,2020-05-27,0,0,18,0,0.098961454513467,0,59,118
America,Saint Vincent And The Grenadines,110210,2020-04-04,5,0,7,0,0.06351510752200344,0,0,119
America,Saint Vincent And The Grenadines,110210,2020-04-05,0,0,7,0,0.06351510752200344,0,1,119
America,Saint Vincent And The Grenadines,110210,2020-04-06,0,0,7,0,0.06351510752200344,0,2,119
America,Saint Vincent And The Grenadines,110210,2020-04-07,0,0,7,0,0.06351510752200344,0,3,119
America,Saint Vincent And The Grenadines,110210,2020-04-08,1,0,8,0,0.07258869431086108,0,4,119
America,Saint Vincent And The Grenadines,110210,2020-04-09,0,0,8,0,0.07258869431086108,0,5,119
America,Saint Vincent And The Grenadines,110210,2020-04-10,4,0,12,0,0.10888304146629163,0,6,119
America,Saint Vincent And The Grenadines,110210,2020-04-11,0,0,12,0,0.10888304146629163,0,7,119
America,Saint Vincent And The Grenadines,110210,2020-04-12,0,0,12,0,0.10888304146629163,0,8,119
America,Saint Vincent And The Grenadines,110210,2020-04-13,0,0,12,0,0.10888304146629163,0,9,119
America,Saint Vincent And The Grenadines,110210,2020-04-14,0,0,12,0,0.10888304146629163,0,10,119
America,Saint Vincent And The Grenadines,110210,2020-04-15,0,0,12,0,0.10888304146629163,0,11,119
America,Saint Vincent And The Grenadines,110210,2020-04-16,0,0,12,0,0.10888304146629163,0,12,119
America,Saint Vincent And The Grenadines,110210,2020-04-17,0,0,12,0,0.10888304146629163,0,13,119
America,Saint Vincent And The Grenadines,110210,2020-04-18,0,0,12,0,0.10888304146629163,0,14,119
America,Saint Vincent And The Grenadines,110210,2020-04-19,0,0,12,0,0.10888304146629163,0,15,119
America,Saint Vincent And The Grenadines,110210,2020-04-20,0,0,12,0,0.10888304146629163,0,16,119
America,Saint Vincent And The Grenadines,110210,2020-04-21,0,0,12,0,0.10888304146629163,0,17,119
America,Saint Vincent And The Grenadines,110210,2020-04-22,0,0,12,0,0.10888304146629163,0,18,119
America,Saint Vincent And The Grenadines,110210,2020-04-23,1,0,13,0,0.11795662825514926,0,19,119
America,Saint Vincent And The Grenadines,110210,2020-04-24,0,0,13,0,0.11795662825514926,0,20,119
America,Saint Vincent And The Grenadines,110210,2020-04-25,1,0,14,0,0.12703021504400688,0,21,119
America,Saint Vincent And The Grenadines,110210,2020-04-26,0,0,14,0,0.12703021504400688,0,22,119
America,Saint Vincent And The Grenadines,110210,2020-04-27,0,0,14,0,0.12703021504400688,0,23,119
America,Saint Vincent And The Grenadines,110210,2020-04-28,1,0,15,0,0.13610380183286452,0,24,119
America,Saint Vincent And The Grenadines,110210,2020-04-29,1,0,16,0,0.14517738862172216,0,25,119
America,Saint Vincent And The Grenadines,110210,2020-04-30,0,0,16,0,0.14517738862172216,0,26,119
America,Saint Vincent And The Grenadines,110210,2020-05-01,0,0,16,0,0.14517738862172216,0,27,119
America,Saint Vincent And The Grenadines,110210,2020-05-02,0,0,16,0,0.14517738862172216,0,28,119
America,Saint Vincent And The Grenadines,110210,2020-05-03,0,0,16,0,0.14517738862172216,0,29,119
America,Saint Vincent And The Grenadines,110210,2020-05-04,1,0,17,0,0.15425097541057978,0,30,119
America,Saint Vincent And The Grenadines,110210,2020-05-05,0,0,17,0,0.15425097541057978,0,31,119
America,Saint Vincent And The Grenadines,110210,2020-05-06,0,0,17,0,0.15425097541057978,0,32,119
America,Saint Vincent And The Grenadines,110210,2020-05-07,0,0,17,0,0.15425097541057978,0,33,119
America,Saint Vincent And The Grenadines,110210,2020-05-08,0,0,17,0,0.15425097541057978,0,34,119
America,Saint Vincent And The Grenadines,110210,2020-05-09,0,0,17,0,0.15425097541057978,0,35,119
America,Saint Vincent And The Grenadines,110210,2020-05-10,0,0,17,0,0.15425097541057978,0,36,119
America,Saint Vincent And The Grenadines,110210,2020-05-11,0,0,17,0,0.15425097541057978,0,37,119
America,Saint Vincent And The Grenadines,110210,2020-05-12,0,0,17,0,0.15425097541057978,0,38,119
America,Saint Vincent And The Grenadines,110210,2020-05-13,0,0,17,0,0.15425097541057978,0,39,119
America,Saint Vincent And The Grenadines,110210,2020-05-14,0,0,17,0,0.15425097541057978,0,40,119
America,Saint Vincent And The Grenadines,110210,2020-05-15,0,0,17,0,0.15425097541057978,0,41,119
America,Saint Vincent And The Grenadines,110210,2020-05-16,0,0,17,0,0.15425097541057978,0,42,119
America,Saint Vincent And The Grenadines,110210,2020-05-17,0,0,17,0,0.15425097541057978,0,43,119
America,Saint Vincent And The Grenadines,110210,2020-05-18,0,0,17,0,0.15425097541057978,0,44,119
America,Saint Vincent And The Grenadines,110210,2020-05-19,0,0,17,0,0.15425097541057978,0,45,119
America,Saint Vincent And The Grenadines,110210,2020-05-20,0,0,17,0,0.15425097541057978,0,46,119
America,Saint Vincent And The Grenadines,110210,2020-05-21,1,0,18,0,0.16332456219943745,0,47,119
America,Saint Vincent And The Grenadines,110210,2020-05-22,0,0,18,0,0.16332456219943745,0,48,119
America,Saint Vincent And The Grenadines,110210,2020-05-23,0,0,18,0,0.16332456219943745,0,49,119
America,Saint Vincent And The Grenadines,110210,2020-05-24,0,0,18,0,0.16332456219943745,0,50,119
America,Saint Vincent And The Grenadines,110210,2020-05-25,0,0,18,0,0.16332456219943745,0,51,119
America,Saint Vincent And The Grenadines,110210,2020-05-26,0,0,18,0,0.16332456219943745,0,52,119
America,Saint Vincent And The Grenadines,110210,2020-05-27,0,0,18,0,0.16332456219943745,0,53,119
Africa,Sao Tome And Principe,211028,2020-04-23,3,0,7,0,0.033170953617529426,0,0,120
Africa,Sao Tome And Principe,211028,2020-04-24,1,0,8,0,0.03790966127717649,0,1,120
Africa,Sao Tome And Principe,211028,2020-04-25,0,0,8,0,0.03790966127717649,0,2,120
Africa,Sao Tome And Principe,211028,2020-04-26,0,0,8,0,0.03790966127717649,0,3,120
Africa,Sao Tome And Principe,211028,2020-04-27,0,0,8,0,0.03790966127717649,0,4,120
Africa,Sao Tome And Principe,211028,2020-04-28,0,0,8,0,0.03790966127717649,0,5,120
Africa,Sao Tome And Principe,211028,2020-04-29,3,0,11,0,0.05212578425611767,0,6,120
Africa,Sao Tome And Principe,211028,2020-04-30,3,0,14,0,0.06634190723505885,0,7,120
Africa,Sao Tome And Principe,211028,2020-05-01,2,1,16,1,0.07581932255435297,0.0625,8,120
Africa,Sao Tome And Principe,211028,2020-05-02,2,0,18,1,0.0852967378736471,0.05555555555555555,9,120
Africa,Sao Tome And Principe,211028,2020-05-03,0,0,18,1,0.0852967378736471,0.05555555555555555,10,120
Africa,Sao Tome And Principe,211028,2020-05-04,0,0,18,1,0.0852967378736471,0.05555555555555555,11,120
Africa,Sao Tome And Principe,211028,2020-05-05,156,2,174,3,0.8245351327785886,0.017241379310344827,12,120
Africa,Sao Tome And Principe,211028,2020-05-06,0,0,174,3,0.8245351327785886,0.017241379310344827,13,120
Africa,Sao Tome And Principe,211028,2020-05-07,0,0,174,3,0.8245351327785886,0.017241379310344827,14,120
Africa,Sao Tome And Principe,211028,2020-05-08,13,1,187,4,0.8861383323540004,0.0213903743315508,15,120
Africa,Sao Tome And Principe,211028,2020-05-09,21,1,208,5,0.9856511932065887,0.02403846153846154,16,120
Africa,Sao Tome And Principe,211028,2020-05-10,0,0,208,5,0.9856511932065887,0.02403846153846154,17,120
Africa,Sao Tome And Principe,211028,2020-05-11,0,0,208,5,0.9856511932065887,0.02403846153846154,18,120
Africa,Sao Tome And Principe,211028,2020-05-12,4,0,212,5,1.004606023845177,0.02358490566037736,19,120
Africa,Sao Tome And Principe,211028,2020-05-13,8,1,220,6,1.0425156851223536,0.02727272727272727,20,120
Africa,Sao Tome And Principe,211028,2020-05-14,15,1,235,7,1.1135963000170592,0.029787234042553193,21,120
Africa,Sao Tome And Principe,211028,2020-05-15,0,0,235,7,1.1135963000170592,0.029787234042553193,22,120
Africa,Sao Tome And Principe,211028,2020-05-16,0,0,235,7,1.1135963000170592,0.029787234042553193,23,120
Africa,Sao Tome And Principe,211028,2020-05-17,0,0,235,7,1.1135963000170592,0.029787234042553193,24,120
Africa,Sao Tome And Principe,211028,2020-05-18,0,0,235,7,1.1135963000170592,0.029787234042553193,25,120
Africa,Sao Tome And Principe,211028,2020-05-19,11,0,246,7,1.165722084273177,0.028455284552845527,26,120
Africa,Sao Tome And Principe,211028,2020-05-20,5,1,251,8,1.1894156225714123,0.03187250996015936,27,120
Africa,Sao Tome And Principe,211028,2020-05-21,0,0,251,8,1.1894156225714123,0.03187250996015936,28,120
Africa,Sao Tome And Principe,211028,2020-05-22,0,0,251,8,1.1894156225714123,0.03187250996015936,29,120
Africa,Sao Tome And Principe,211028,2020-05-23,0,0,251,8,1.1894156225714123,0.03187250996015936,30,120
Africa,Sao Tome And Principe,211028,2020-05-24,40,0,291,8,1.3789639289572948,0.027491408934707903,31,120
Africa,Sao Tome And Principe,211028,2020-05-25,8,1,299,9,1.4168735902344713,0.030100334448160536,32,120
Africa,Sao Tome And Principe,211028,2020-05-26,0,2,299,11,1.4168735902344713,0.03678929765886288,33,120
Africa,Sao Tome And Principe,211028,2020-05-27,142,1,441,12,2.0897700779043538,0.027210884353741496,34,120
Asia,Saudi Arabia,33699947,2020-03-25,205,1,767,1,0.022759679711068983,0.001303780964797914,0,121
Asia,Saudi Arabia,33699947,2020-03-26,133,1,900,2,0.026706273454970123,0.0022222222222222222,1,121
Asia,Saudi Arabia,33699947,2020-03-27,112,1,1012,3,0.030029720818255293,0.0029644268774703555,2,121
Asia,Saudi Arabia,33699947,2020-03-28,92,0,1104,3,0.03275969543809669,0.002717391304347826,3,121
Asia,Saudi Arabia,33699947,2020-03-29,99,1,1203,4,0.035697385518143394,0.0033250207813798837,4,121
Asia,Saudi Arabia,33699947,2020-03-30,26,4,1229,8,0.03646890008462031,0.006509357200976403,5,121
Asia,Saudi Arabia,33699947,2020-03-31,224,0,1453,8,0.043115794811190655,0.0055058499655884375,6,121
Asia,Saudi Arabia,33699947,2020-04-01,110,2,1563,10,0.046379894900131446,0.006397952655150352,7,121
Asia,Saudi Arabia,33699947,2020-04-02,157,6,1720,16,0.05103865593616512,0.009302325581395349,8,121
Asia,Saudi Arabia,33699947,2020-04-03,165,5,1885,21,0.055934806069576314,0.011140583554376658,9,121
Asia,Saudi Arabia,33699947,2020-04-04,0,0,1885,21,0.055934806069576314,0.011140583554376658,10,121
Asia,Saudi Arabia,33699947,2020-04-05,294,8,2179,29,0.06465885539819988,0.01330885727397889,11,121
Asia,Saudi Arabia,33699947,2020-04-06,206,5,2385,34,0.07077162465567081,0.014255765199161425,12,121
Asia,Saudi Arabia,33699947,2020-04-07,138,4,2523,38,0.07486658658543291,0.015061434799841459,13,121
Asia,Saudi Arabia,33699947,2020-04-08,272,3,2795,41,0.08293781589626832,0.014669051878354204,14,121
Asia,Saudi Arabia,33699947,2020-04-09,137,0,2932,41,0.08700310418885822,0.01398362892223738,15,121
Asia,Saudi Arabia,33699947,2020-04-10,355,3,3287,44,0.09753724538498532,0.013386066321874049,16,121
Asia,Saudi Arabia,33699947,2020-04-11,364,3,3651,47,0.10833844931566212,0.012873185428649686,17,121
Asia,Saudi Arabia,33699947,2020-04-12,382,5,4033,52,0.11967377871543834,0.012893627572526656,18,121
Asia,Saudi Arabia,33699947,2020-04-13,429,7,4462,59,0.1324037690623074,0.013222770058269833,19,121
Asia,Saudi Arabia,33699947,2020-04-14,472,6,4934,65,0.14640972580758063,0.0131738954195379,20,121
Asia,Saudi Arabia,33699947,2020-04-15,435,8,5369,73,0.15931775797748288,0.013596572918606817,21,121
Asia,Saudi Arabia,33699947,2020-04-16,493,6,5862,79,0.17394686110337207,0.013476629136813374,22,121
Asia,Saudi Arabia,33699947,2020-04-17,518,4,6380,83,0.18931780515856597,0.013009404388714733,23,121
Asia,Saudi Arabia,33699947,2020-04-18,762,4,7142,87,0.211929116683774,0.012181461775413049,24,121
Asia,Saudi Arabia,33699947,2020-04-19,1132,5,8274,92,0.245519673962692,0.011119168479574571,25,121
Asia,Saudi Arabia,33699947,2020-04-20,1088,5,9362,97,0.2778045912060337,0.010361033967101047,26,121
Asia,Saudi Arabia,33699947,2020-04-21,1122,6,10484,103,0.3110984121132297,0.009824494467760396,27,121
Asia,Saudi Arabia,33699947,2020-04-22,1147,6,11631,109,0.34513407394973056,0.009371507179090362,28,121
Asia,Saudi Arabia,33699947,2020-04-23,1141,5,12772,114,0.3789916939631982,0.008925775133103664,29,121
Asia,Saudi Arabia,33699947,2020-04-24,1158,7,13930,121,0.4133537658085931,0.008686288585786073,30,121
Asia,Saudi Arabia,33699947,2020-04-25,1172,6,15102,127,0.44813126857439867,0.008409482187789696,31,121
Asia,Saudi Arabia,33699947,2020-04-26,1197,9,16299,136,0.48365061226950895,0.008344070188355113,32,121
Asia,Saudi Arabia,33699947,2020-04-27,1223,3,17522,139,0.5199414705310961,0.007932884373929916,33,121
Asia,Saudi Arabia,33699947,2020-04-28,1289,5,18811,144,0.5581907888460477,0.007655095422890862,34,121
Asia,Saudi Arabia,33699947,2020-04-29,1266,8,20077,152,0.5957576135060391,0.007570852218957015,35,121
Asia,Saudi Arabia,33699947,2020-04-30,1325,5,21402,157,0.6350751827591895,0.0073357630128025415,36,121
Asia,Saudi Arabia,33699947,2020-05-01,1351,5,22753,162,0.6751642665788169,0.0071199402276622865,37,121
Asia,Saudi Arabia,33699947,2020-05-02,1344,7,24097,169,0.7150456349382389,0.007013321160310412,38,121
Asia,Saudi Arabia,33699947,2020-05-03,1362,7,25459,176,0.7554611287667604,0.006913075925998664,39,121
Asia,Saudi Arabia,33699947,2020-05-04,1552,8,27011,184,0.8015146136579977,0.006812039539446892,40,121
Asia,Saudi Arabia,33699947,2020-05-05,1645,7,28656,191,0.8503277468062487,0.006665270798436628,41,121
Asia,Saudi Arabia,33699947,2020-05-06,1595,9,30251,200,0.8976571980958902,0.006611351690853195,42,121
Asia,Saudi Arabia,33699947,2020-05-07,1687,9,31938,209,0.947716624005373,0.006543928862170455,43,121
Asia,Saudi Arabia,33699947,2020-05-08,1793,10,33731,219,1.000921455455108,0.006492543950668525,44,121
Asia,Saudi Arabia,33699947,2020-05-09,1701,10,35432,229,1.0513963122850014,0.006463084217656356,45,121
Asia,Saudi Arabia,33699947,2020-05-10,1704,10,37136,239,1.1019601900264115,0.006435803532959931,46,121
Asia,Saudi Arabia,33699947,2020-05-11,1912,7,39048,246,1.158696184299637,0.006299938537185003,47,121
Asia,Saudi Arabia,33699947,2020-05-12,1966,9,41014,255,1.2170345549801607,0.006217389184181011,48,121
Asia,Saudi Arabia,33699947,2020-05-13,1911,9,42925,264,1.2737408756162139,0.006150262085032033,49,121
Asia,Saudi Arabia,33699947,2020-05-14,1905,9,44830,273,1.330269154429234,0.006089672094579523,50,121
Asia,Saudi Arabia,33699947,2020-05-15,2039,10,46869,283,1.3907737006233274,0.006038106210928332,51,121
Asia,Saudi Arabia,33699947,2020-05-16,2307,9,49176,292,1.4592307815795675,0.005937855864649422,52,121
Asia,Saudi Arabia,33699947,2020-05-17,2840,10,52016,302,1.5435039111485842,0.005805905875115349,53,121
Asia,Saudi Arabia,33699947,2020-05-18,2736,10,54752,312,1.6246909824516933,0.0056984219754529514,54,121
Asia,Saudi Arabia,33699947,2020-05-19,2593,8,57345,320,1.7016347236391796,0.005580259830848374,55,121
Asia,Saudi Arabia,33699947,2020-05-20,2509,9,59854,329,1.7760858793042018,0.005496708657733819,56,121
Asia,Saudi Arabia,33699947,2020-05-21,2691,10,62545,339,1.8559376369345626,0.005420097529778559,57,121
Asia,Saudi Arabia,33699947,2020-05-22,2532,12,65077,351,1.9310712862545452,0.0053936106458503,58,121
Asia,Saudi Arabia,33699947,2020-05-23,2642,13,67719,364,2.0094690356634684,0.0053751532066332935,59,121
Asia,Saudi Arabia,33699947,2020-05-24,2442,15,70161,379,2.081932057637954,0.0054018614329898375,60,121
Asia,Saudi Arabia,33699947,2020-05-25,2399,11,72560,390,2.1531191132140357,0.0053748621830209484,61,121
Asia,Saudi Arabia,33699947,2020-05-26,2235,9,74795,399,2.219439692293878,0.0053345811885821244,62,121
Asia,Saudi Arabia,33699947,2020-05-27,1931,12,76726,411,2.276739485673375,0.005356723926700206,63,121
Africa,Senegal,15854360,2020-04-17,21,0,335,2,0.021129834316869302,0.005970149253731343,0,122
Africa,Senegal,15854360,2020-04-18,7,1,342,3,0.021571353242893436,0.008771929824561403,1,122
Africa,Senegal,15854360,2020-04-19,8,0,350,3,0.022075946301206736,0.008571428571428572,2,122
Africa,Senegal,15854360,2020-04-20,17,1,367,4,0.02314820655012249,0.010899182561307902,3,122
Africa,Senegal,15854360,2020-04-21,10,1,377,5,0.02377894787301411,0.013262599469496022,4,122
Africa,Senegal,15854360,2020-04-22,35,0,412,5,0.025986542503134782,0.012135922330097087,5,122
Africa,Senegal,15854360,2020-04-23,30,1,442,6,0.02787876647180965,0.013574660633484163,6,122
Africa,Senegal,15854360,2020-04-24,37,0,479,6,0.030212509366508645,0.012526096033402923,7,122
Africa,Senegal,15854360,2020-04-25,66,1,545,7,0.03437540209759334,0.012844036697247707,8,122
Africa,Senegal,15854360,2020-04-26,69,0,614,7,0.03872751722554552,0.011400651465798045,9,122
Africa,Senegal,15854360,2020-04-27,57,2,671,9,0.042322742766027766,0.013412816691505217,10,122
Africa,Senegal,15854360,2020-04-28,64,0,735,9,0.046359487232534136,0.012244897959183673,11,122
Africa,Senegal,15854360,2020-04-29,88,0,823,9,0.05191001087398041,0.010935601458080195,12,122
Africa,Senegal,15854360,2020-04-30,59,0,882,9,0.05563138467904097,0.01020408163265306,13,122
Africa,Senegal,15854360,2020-05-01,51,0,933,9,0.05884816542578824,0.00964630225080386,14,122
Africa,Senegal,15854360,2020-05-02,91,0,1024,9,0.06458791146410199,0.0087890625,15,122
Africa,Senegal,15854360,2020-05-03,91,0,1115,9,0.07032765750241574,0.008071748878923767,16,122
Africa,Senegal,15854360,2020-05-04,67,0,1182,9,0.07455362436578959,0.007614213197969543,17,122
Africa,Senegal,15854360,2020-05-05,89,1,1271,10,0.08016722213952503,0.007867820613690008,18,122
Africa,Senegal,15854360,2020-05-06,58,1,1329,11,0.08382552181229644,0.008276899924755455,19,122
Africa,Senegal,15854360,2020-05-07,104,1,1433,12,0.09038523157036928,0.00837404047452896,20,122
Africa,Senegal,15854360,2020-05-08,59,1,1492,13,0.09410660537542985,0.00871313672922252,21,122
Africa,Senegal,15854360,2020-05-09,59,1,1551,14,0.09782797918049042,0.009026434558349452,22,122
Africa,Senegal,15854360,2020-05-10,83,3,1634,17,0.10306313216049087,0.01040391676866585,23,122
Africa,Senegal,15854360,2020-05-11,75,2,1709,19,0.10779369208217802,0.011117612638970159,24,122
Africa,Senegal,15854360,2020-05-12,177,0,1886,19,0.11895781349735972,0.01007423117709438,25,122
Africa,Senegal,15854360,2020-05-13,109,0,1995,19,0.12583289391687838,0.009523809523809525,26,122
Africa,Senegal,15854360,2020-05-14,110,3,2105,22,0.1327710484686862,0.010451306413301662,27,122
Africa,Senegal,15854360,2020-05-15,84,1,2189,23,0.13806927558097584,0.010507080858839652,28,122
Africa,Senegal,15854360,2020-05-16,121,2,2310,25,0.14570124558796443,0.010822510822510822,29,122
Africa,Senegal,15854360,2020-05-17,119,0,2429,25,0.15320706733037473,0.01029230135858378,30,122
Africa,Senegal,15854360,2020-05-18,51,1,2480,26,0.156423848077122,0.010483870967741936,31,122
Africa,Senegal,15854360,2020-05-19,64,0,2544,26,0.16046059254362838,0.010220125786163521,32,122
Africa,Senegal,15854360,2020-05-20,73,4,2617,30,0.16506500420073722,0.01146350783339702,33,122
Africa,Senegal,15854360,2020-05-21,97,0,2714,30,0.17118319503278595,0.01105379513633014,34,122
Africa,Senegal,15854360,2020-05-22,98,3,2812,33,0.1773644599971238,0.011735419630156473,35,122
Africa,Senegal,15854360,2020-05-23,97,0,2909,33,0.18348265082917253,0.011344104503265727,36,122
Africa,Senegal,15854360,2020-05-24,67,2,2976,35,0.1877086176925464,0.011760752688172043,37,122
Africa,Senegal,15854360,2020-05-25,71,0,3047,35,0.19218688108507692,0.011486708237610764,38,122
Africa,Senegal,15854360,2020-05-26,83,1,3130,36,0.19742203406507736,0.011501597444089457,39,122
Africa,Senegal,15854360,2020-05-27,31,1,3161,37,0.1993773321660414,0.01170515659601392,40,122
Europe,Serbia,6982084,2020-03-22,14,0,149,1,0.021340333344600268,0.006711409395973154,0,123
Europe,Serbia,6982084,2020-03-23,39,0,188,1,0.026926058179764092,0.005319148936170213,1,123
Europe,Serbia,6982084,2020-03-24,34,0,222,1,0.03179566444631718,0.0045045045045045045,2,123
Europe,Serbia,6982084,2020-03-25,27,0,249,1,0.03566270471681521,0.004016064257028112,3,123
Europe,Serbia,6982084,2020-03-26,54,1,303,2,0.04339678525781128,0.006600660066006601,4,123
Europe,Serbia,6982084,2020-03-27,81,1,384,3,0.05499790606930538,0.0078125,5,123
Europe,Serbia,6982084,2020-03-28,73,3,457,6,0.06545323717102229,0.01312910284463895,6,123
Europe,Serbia,6982084,2020-03-29,202,4,659,10,0.09438442734289647,0.015174506828528073,7,123
Europe,Serbia,6982084,2020-03-30,82,3,741,13,0.10612877186811273,0.017543859649122806,8,123
Europe,Serbia,6982084,2020-03-31,0,0,741,13,0.10612877186811273,0.017543859649122806,9,123
Europe,Serbia,6982084,2020-04-01,159,10,900,23,0.12890134234993447,0.025555555555555557,10,123
Europe,Serbia,6982084,2020-04-02,160,0,1060,23,0.1518171365454784,0.02169811320754717,11,123
Europe,Serbia,6982084,2020-04-03,111,8,1171,31,0.167714968768637,0.026473099914602904,12,123
Europe,Serbia,6982084,2020-04-04,305,8,1476,39,0.21139820145389257,0.026422764227642278,13,123
Europe,Serbia,6982084,2020-04-05,148,5,1624,44,0.23259531108477066,0.027093596059113302,14,123
Europe,Serbia,6982084,2020-04-06,284,7,1908,51,0.2732708457818611,0.026729559748427674,15,123
Europe,Serbia,6982084,2020-04-07,292,7,2200,58,0.31509217018872876,0.026363636363636363,16,123
Europe,Serbia,6982084,2020-04-08,247,3,2447,61,0.3504684274780997,0.024928483857785042,17,123
Europe,Serbia,6982084,2020-04-09,219,4,2666,65,0.38183442078325036,0.024381095273818456,18,123
Europe,Serbia,6982084,2020-04-10,201,1,2867,66,0.41062238724140243,0.023020579002441578,19,123
Europe,Serbia,6982084,2020-04-11,238,5,3105,71,0.44470963110727396,0.022866344605475042,20,123
Europe,Serbia,6982084,2020-04-12,275,3,3380,74,0.48409615238086506,0.021893491124260357,21,123
Europe,Serbia,6982084,2020-04-13,250,6,3630,80,0.5199020808114024,0.02203856749311295,22,123
Europe,Serbia,6982084,2020-04-14,424,5,4054,85,0.5806289354295938,0.02096694622594968,23,123
Europe,Serbia,6982084,2020-04-15,411,9,4465,94,0.6394938817693971,0.021052631578947368,24,123
Europe,Serbia,6982084,2020-04-16,408,5,4873,99,0.6979291569680341,0.020316027088036117,25,123
Europe,Serbia,6982084,2020-04-17,445,4,5318,103,0.7616637095743907,0.01936818352764197,26,123
Europe,Serbia,6982084,2020-04-18,372,7,5690,110,0.8149429310790303,0.019332161687170474,27,123
Europe,Serbia,6982084,2020-04-19,304,7,5994,117,0.8584829400505637,0.01951951951951952,28,123
Europe,Serbia,6982084,2020-04-20,324,5,6318,122,0.9048874232965401,0.019309908198797087,29,123
Europe,Serbia,6982084,2020-04-21,312,3,6630,125,0.9495732219778507,0.01885369532428356,30,123
Europe,Serbia,6982084,2020-04-22,260,0,6890,125,0.9868113875456095,0.018142235123367198,31,123
Europe,Serbia,6982084,2020-04-23,224,9,7114,134,1.018893499419371,0.018836097835254428,32,123
Europe,Serbia,6982084,2020-04-24,162,5,7276,139,1.0420957410423592,0.01910390324354041,33,123
Europe,Serbia,6982084,2020-04-25,207,5,7483,144,1.0717430497828444,0.01924361886943739,34,123
Europe,Serbia,6982084,2020-04-26,296,7,7779,151,1.1141372690446005,0.01941123537729785,35,123
Europe,Serbia,6982084,2020-04-27,263,5,8042,156,1.151805105753526,0.019398159661775678,36,123
Europe,Serbia,6982084,2020-04-28,233,6,8275,162,1.1851762310507865,0.019577039274924473,37,123
Europe,Serbia,6982084,2020-04-29,222,6,8497,168,1.2169718954971036,0.019771684123808402,38,123
Europe,Serbia,6982084,2020-04-30,227,5,8724,173,1.2494836785120318,0.019830353049060064,39,123
Europe,Serbia,6982084,2020-05-01,285,6,9009,179,1.2903024369228442,0.019869019869019868,40,123
Europe,Serbia,6982084,2020-05-02,196,6,9205,185,1.3183742848123854,0.020097772949483977,41,123
Europe,Serbia,6982084,2020-05-03,157,4,9362,189,1.340860407866763,0.02018799401837214,42,123
Europe,Serbia,6982084,2020-05-04,102,4,9464,193,1.3554692266664221,0.020393068469991546,43,123
Europe,Serbia,6982084,2020-05-05,93,4,9557,197,1.3687890320425822,0.020613163126504134,44,123
Europe,Serbia,6982084,2020-05-06,120,3,9677,200,1.3859758776892401,0.02066756226103131,45,123
Europe,Serbia,6982084,2020-05-07,114,3,9791,203,1.4023033810535652,0.020733326524359105,46,123
Europe,Serbia,6982084,2020-05-08,57,3,9848,206,1.4104671327357277,0.02091795288383428,47,123
Europe,Serbia,6982084,2020-05-09,95,3,9943,209,1.424073385539332,0.021019812933722216,48,123
Europe,Serbia,6982084,2020-05-10,89,4,10032,213,1.436820296060603,0.021232057416267942,49,123
Europe,Serbia,6982084,2020-05-11,82,2,10114,215,1.4485646405858192,0.021257662645837453,50,123
Europe,Serbia,6982084,2020-05-12,62,3,10176,218,1.4574445108365928,0.021422955974842766,51,123
Europe,Serbia,6982084,2020-05-13,67,2,10243,220,1.4670404996559767,0.021478082592990336,52,123
Europe,Serbia,6982084,2020-05-14,52,2,10295,222,1.4744881327695283,0.02156386595434677,53,123
Europe,Serbia,6982084,2020-05-15,79,2,10374,224,1.4858028061535782,0.021592442645074223,54,123
Europe,Serbia,6982084,2020-05-16,64,1,10438,225,1.4949691238317957,0.021555853611803028,55,123
Europe,Serbia,6982084,2020-05-17,58,3,10496,228,1.5032760992276806,0.021722560975609755,56,123
Europe,Serbia,6982084,2020-05-18,114,2,10610,230,1.5196036025920054,0.021677662582469368,57,123
Europe,Serbia,6982084,2020-05-19,89,1,10699,231,1.5323505131132766,0.021590802878773716,58,123
Europe,Serbia,6982084,2020-05-20,34,3,10733,234,1.5372201193798298,0.02180191931426442,59,123
Europe,Serbia,6982084,2020-05-21,100,1,10833,235,1.5515424907520448,0.021692975168466723,60,123
Europe,Serbia,6982084,2020-05-22,86,2,10919,237,1.5638597301321497,0.02170528436670025,61,123
Europe,Serbia,6982084,2020-05-23,105,0,11024,237,1.5788982200729753,0.02149854862119013,62,123
Europe,Serbia,6982084,2020-05-24,68,1,11092,238,1.5886374326060815,0.02145690587811035,63,123
Europe,Serbia,6982084,2020-05-25,67,0,11159,238,1.5982334214254657,0.021328075992472443,64,123
Europe,Serbia,6982084,2020-05-26,34,1,11193,239,1.6031030276920186,0.02135263110872867,65,123
Europe,Serbia,6982084,2020-05-27,34,0,11227,239,1.6079726339585716,0.021287966509307917,66,123
Africa,Sierra Leone,7650154,2020-05-03,19,1,155,8,0.020261030039395285,0.05161290322580645,0,124
Africa,Sierra Leone,7650154,2020-05-04,2,0,157,8,0.020522462685064902,0.050955414012738856,1,124
Africa,Sierra Leone,7650154,2020-05-05,21,1,178,9,0.023267505464595876,0.05056179775280899,2,124
Africa,Sierra Leone,7650154,2020-05-06,21,2,199,11,0.026012548244126847,0.05527638190954774,3,124
Africa,Sierra Leone,7650154,2020-05-07,26,3,225,14,0.029411172637831866,0.06222222222222222,4,124
Africa,Sierra Leone,7650154,2020-05-08,6,2,231,16,0.030195470574840715,0.06926406926406926,5,124
Africa,Sierra Leone,7650154,2020-05-09,26,1,257,17,0.033594094968545735,0.06614785992217899,6,124
Africa,Sierra Leone,7650154,2020-05-10,34,1,291,18,0.03803844994492921,0.061855670103092786,7,124
Africa,Sierra Leone,7650154,2020-05-11,16,0,307,18,0.040129911110286146,0.05863192182410423,8,124
Africa,Sierra Leone,7650154,2020-05-12,31,1,338,19,0.0441821171181652,0.05621301775147929,9,124
Africa,Sierra Leone,7650154,2020-05-13,0,1,338,20,0.0441821171181652,0.05917159763313609,10,124
Africa,Sierra Leone,7650154,2020-05-14,49,1,387,21,0.05058721693707081,0.05426356589147287,11,124
Africa,Sierra Leone,7650154,2020-05-15,21,5,408,26,0.053332259716601785,0.06372549019607843,12,124
Africa,Sierra Leone,7650154,2020-05-16,39,1,447,27,0.0584301963071593,0.06040268456375839,13,124
Africa,Sierra Leone,7650154,2020-05-17,15,2,462,29,0.06039094114968143,0.06277056277056277,14,124
Africa,Sierra Leone,7650154,2020-05-18,43,3,505,32,0.06601174303157818,0.06336633663366337,15,124
Africa,Sierra Leone,7650154,2020-05-19,14,1,519,33,0.0678417715512655,0.06358381502890173,16,124
Africa,Sierra Leone,7650154,2020-05-20,15,0,534,33,0.06980251639378762,0.06179775280898876,17,124
Africa,Sierra Leone,7650154,2020-05-21,36,1,570,34,0.07450830401584073,0.05964912280701754,18,124
Africa,Sierra Leone,7650154,2020-05-22,15,1,585,35,0.07646904885836285,0.05982905982905983,19,124
Africa,Sierra Leone,7650154,2020-05-23,21,3,606,38,0.07921409163789382,0.0627062706270627,20,124
Africa,Sierra Leone,7650154,2020-05-24,15,1,621,39,0.08117483648041594,0.06280193236714976,21,124
Africa,Sierra Leone,7650154,2020-05-25,86,1,707,40,0.09241644024420946,0.056577086280056574,22,124
Africa,Sierra Leone,7650154,2020-05-26,28,2,735,42,0.0960764972835841,0.05714285714285714,23,124
Africa,Sierra Leone,7650154,2020-05-27,19,2,754,44,0.09856010741744545,0.058355437665782495,24,124
Asia,Singapore,5638676,2020-03-06,5,0,117,0,0.020749551845149466,0,0,125
Asia,Singapore,5638676,2020-03-07,13,0,130,0,0.023055057605721626,0,1,125
Asia,Singapore,5638676,2020-03-08,8,0,138,0,0.024473830381458343,0,2,125
Asia,Singapore,5638676,2020-03-09,12,0,150,0,0.026601989545063414,0,3,125
Asia,Singapore,5638676,2020-03-10,10,0,160,0,0.028375455514734308,0,4,125
Asia,Singapore,5638676,2020-03-11,6,0,166,0,0.029439535096536847,0,5,125
Asia,Singapore,5638676,2020-03-12,12,0,178,0,0.03156769426014192,0,6,125
Asia,Singapore,5638676,2020-03-13,9,0,187,0,0.03316381363284572,0,7,125
Asia,Singapore,5638676,2020-03-14,13,0,200,0,0.03546931939341789,0,8,125
Asia,Singapore,5638676,2020-03-15,14,0,214,0,0.03795217175095714,0,9,125
Asia,Singapore,5638676,2020-03-16,12,0,226,0,0.040080330914562215,0,10,125
Asia,Singapore,5638676,2020-03-17,17,0,243,0,0.04309522306300274,0,11,125
Asia,Singapore,5638676,2020-03-18,23,0,266,0,0.04717419479324579,0,12,125
Asia,Singapore,5638676,2020-03-19,47,0,313,0,0.05550948485069899,0,13,125
Asia,Singapore,5638676,2020-03-20,32,0,345,0,0.06118457595364586,0,14,125
Asia,Singapore,5638676,2020-03-21,40,0,385,0,0.06827843983232944,0,15,125
Asia,Singapore,5638676,2020-03-22,47,2,432,2,0.07661372988978264,0.004629629629629629,16,125
Asia,Singapore,5638676,2020-03-23,23,0,455,2,0.08069270162002569,0.004395604395604396,17,125
Asia,Singapore,5638676,2020-03-24,54,0,509,2,0.09026941785624853,0.003929273084479371,18,125
Asia,Singapore,5638676,2020-03-25,49,0,558,2,0.0989594011076359,0.0035842293906810036,19,125
Asia,Singapore,5638676,2020-03-26,10,0,568,2,0.1007328670773068,0.0035211267605633804,20,125
Asia,Singapore,5638676,2020-03-27,26,0,594,2,0.10534387859845112,0.003367003367003367,21,125
Asia,Singapore,5638676,2020-03-28,138,0,732,2,0.12981770897990946,0.00273224043715847,22,125
Asia,Singapore,5638676,2020-03-29,71,1,803,3,0.14240931736457282,0.0037359900373599006,23,125
Asia,Singapore,5638676,2020-03-30,41,0,844,3,0.14968052784022348,0.0035545023696682463,24,125
Asia,Singapore,5638676,2020-03-31,0,0,844,3,0.14968052784022348,0.0035545023696682463,25,125
Asia,Singapore,5638676,2020-04-01,35,0,879,3,0.15588765873407162,0.0034129692832764505,26,125
Asia,Singapore,5638676,2020-04-02,121,1,1000,4,0.17734659696708943,0.004,27,125
Asia,Singapore,5638676,2020-04-03,49,1,1049,5,0.18603658021847683,0.004766444232602479,28,125
Asia,Singapore,5638676,2020-04-04,65,0,1114,5,0.19756410902133761,0.004488330341113106,29,125
Asia,Singapore,5638676,2020-04-05,75,1,1189,6,0.21086510379386936,0.005046257359125316,30,125
Asia,Singapore,5638676,2020-04-06,120,0,1309,6,0.23214669542992009,0.004583651642475172,31,125
Asia,Singapore,5638676,2020-04-07,66,0,1375,6,0.24385157082974798,0.004363636363636364,32,125
Asia,Singapore,5638676,2020-04-08,106,0,1481,6,0.26265031010825945,0.004051316677920324,33,125
Asia,Singapore,5638676,2020-04-09,142,0,1623,6,0.2878335268775861,0.0036968576709796672,34,125
Asia,Singapore,5638676,2020-04-10,286,0,1909,6,0.33855465361017373,0.003143006809848088,35,125
Asia,Singapore,5638676,2020-04-11,0,0,1909,6,0.33855465361017373,0.003143006809848088,36,125
Asia,Singapore,5638676,2020-04-12,390,2,2299,8,0.4077198264273386,0.0034797738147020443,37,125
Asia,Singapore,5638676,2020-04-13,233,0,2532,8,0.4490415835206704,0.00315955766192733,38,125
Asia,Singapore,5638676,2020-04-14,386,1,2918,9,0.517497369949967,0.003084304318026045,39,125
Asia,Singapore,5638676,2020-04-15,334,1,3252,10,0.5767311333369749,0.003075030750307503,40,125
Asia,Singapore,5638676,2020-04-16,447,0,3699,10,0.6560050621812638,0.002703433360367667,41,125
Asia,Singapore,5638676,2020-04-17,728,0,4427,10,0.785113384773305,0.00225886604924328,42,125
Asia,Singapore,5638676,2020-04-18,623,1,5050,11,0.8956003146838016,0.0021782178217821784,43,125
Asia,Singapore,5638676,2020-04-19,942,0,5992,11,1.0626608090268,0.001835781041388518,44,125
Asia,Singapore,5638676,2020-04-20,596,0,6588,11,1.168359380819185,0.0016697024893746206,45,125
Asia,Singapore,5638676,2020-04-21,1426,0,8014,11,1.4212556280942548,0.0013725979535812328,46,125
Asia,Singapore,5638676,2020-04-22,1111,0,9125,11,1.6182876973246911,0.0012054794520547946,47,125
Asia,Singapore,5638676,2020-04-23,1016,1,10141,12,1.798471839843254,0.0011833152549058279,48,125
Asia,Singapore,5638676,2020-04-24,1037,0,11178,12,1.9823802608981258,0.0010735373054213634,49,125
Asia,Singapore,5638676,2020-04-25,897,0,12075,12,2.1414601583776047,9.937888198757764e-4,50,125
Asia,Singapore,5638676,2020-04-26,618,0,12693,12,2.251060355303266,9.454029780193808e-4,51,125
Asia,Singapore,5638676,2020-04-27,931,0,13624,12,2.416170037079626,8.807985907222549e-4,52,125
Asia,Singapore,5638676,2020-04-28,799,2,14423,14,2.557869968056331,9.706718435831658e-4,53,125
Asia,Singapore,5638676,2020-04-29,528,0,14951,14,2.651508971254954,9.363922145675874e-4,54,125
Asia,Singapore,5638676,2020-04-30,690,0,15641,14,2.773878123162246,8.950834345630075e-4,55,125
Asia,Singapore,5638676,2020-05-01,528,1,16169,15,2.867517126360869,9.277011565341084e-4,56,125
Asia,Singapore,5638676,2020-05-02,932,1,17101,16,3.0328041547341966,9.356178001286475e-4,57,125
Asia,Singapore,5638676,2020-05-03,447,1,17548,17,3.112078083578486,9.687713699566902e-4,58,125
Asia,Singapore,5638676,2020-05-04,657,1,18205,18,3.2285947977858633,9.887393573194177e-4,59,125
Asia,Singapore,5638676,2020-05-05,573,0,18778,18,3.3302143978480054,9.58568537650442e-4,60,125
Asia,Singapore,5638676,2020-05-06,632,0,19410,18,3.4422974471312062,9.273570324574962e-4,61,125
Asia,Singapore,5638676,2020-05-07,788,2,20198,20,3.5820465655412725,9.901970492127933e-4,62,125
Asia,Singapore,5638676,2020-05-08,741,0,20939,20,3.713460393893886,9.551554515497397e-4,63,125
Asia,Singapore,5638676,2020-05-09,768,0,21707,20,3.8496625803646105,9.213617727000506e-4,64,125
Asia,Singapore,5638676,2020-05-10,753,0,22460,20,3.9832045678808288,8.904719501335708e-4,65,125
Asia,Singapore,5638676,2020-05-11,876,0,23336,20,4.138560186823999,8.570449091532396e-4,66,125
Asia,Singapore,5638676,2020-05-12,451,1,23787,21,4.218543502056156,8.828351620633119e-4,67,125
Asia,Singapore,5638676,2020-05-13,884,0,24671,21,4.375317893775064,8.512018158972072e-4,68,125
Asia,Singapore,5638676,2020-05-14,675,0,25346,21,4.495026846727849,8.285331018701176e-4,69,125
Asia,Singapore,5638676,2020-05-15,752,0,26098,21,4.628391487647099,8.046593608705648e-4,70,125
Asia,Singapore,5638676,2020-05-16,793,0,26891,21,4.769027339042002,7.809304228180433e-4,71,125
Asia,Singapore,5638676,2020-05-17,465,1,27356,22,4.851493506631699,8.042111419798217e-4,72,125
Asia,Singapore,5638676,2020-05-18,682,0,28038,22,4.972443885763253,7.846494043797703e-4,73,125
Asia,Singapore,5638676,2020-05-19,305,0,28343,22,5.026534597838215,7.762057650919098e-4,74,125
Asia,Singapore,5638676,2020-05-20,451,0,28794,22,5.106517913070373,7.640480655692158e-4,75,125
Asia,Singapore,5638676,2020-05-21,570,0,29364,22,5.207605473341614,7.492167279662172e-4,76,125
Asia,Singapore,5638676,2020-05-22,448,1,29812,23,5.28705674878287,7.715014088286596e-4,77,125
Asia,Singapore,5638676,2020-05-23,614,0,30426,23,5.395947559320663,7.559324262144219e-4,78,125
Asia,Singapore,5638676,2020-05-24,642,0,31068,23,5.509804074573535,7.403115746105317e-4,79,125
Asia,Singapore,5638676,2020-05-25,548,0,31616,23,5.6069900097115,7.274797570850203e-4,80,125
Asia,Singapore,5638676,2020-05-26,344,0,31960,23,5.667997239068178,7.196495619524406e-4,81,125
Asia,Singapore,5638676,2020-05-27,383,0,32343,23,5.735920985706574,7.111276010264972e-4,82,125
Europe,Slovakia,5447011,2020-03-20,16,0,123,0,0.02258119177655415,0,0,126
Europe,Slovakia,5447011,2020-03-21,14,0,137,0,0.025151408726731047,0,1,126
Europe,Slovakia,5447011,2020-03-22,41,0,178,0,0.032678472652249095,0,2,126
Europe,Slovakia,5447011,2020-03-23,7,0,185,0,0.03396358112733754,0,3,126
Europe,Slovakia,5447011,2020-03-24,6,0,191,0,0.035065102677413355,0,4,126
Europe,Slovakia,5447011,2020-03-25,13,0,204,0,0.037451732702577616,0,5,126
Europe,Slovakia,5447011,2020-03-26,12,0,216,0,0.03965477580272924,0,6,126
Europe,Slovakia,5447011,2020-03-27,10,0,226,0,0.041490645052855595,0,7,126
Europe,Slovakia,5447011,2020-03-28,69,0,295,0,0.05415814287872744,0,8,126
Europe,Slovakia,5447011,2020-03-29,0,0,295,0,0.05415814287872744,0,9,126
Europe,Slovakia,5447011,2020-03-30,41,0,336,0,0.06168520680424548,0,10,126
Europe,Slovakia,5447011,2020-03-31,0,0,336,0,0.06168520680424548,0,11,126
Europe,Slovakia,5447011,2020-04-01,27,0,363,0,0.06664205377958664,0,12,126
Europe,Slovakia,5447011,2020-04-02,37,0,400,0,0.07343477000505415,0,13,126
Europe,Slovakia,5447011,2020-04-03,26,0,426,0,0.07820803005538267,0,14,126
Europe,Slovakia,5447011,2020-04-04,24,0,450,0,0.0826141162556859,0,15,126
Europe,Slovakia,5447011,2020-04-05,21,0,471,0,0.08646944168095126,0,16,126
Europe,Slovakia,5447011,2020-04-06,14,0,485,0,0.08903965863112816,0,17,126
Europe,Slovakia,5447011,2020-04-07,49,2,534,2,0.09803541795674729,0.003745318352059925,18,126
Europe,Slovakia,5447011,2020-04-08,47,0,581,2,0.10666400343234116,0.0034423407917383822,19,126
Europe,Slovakia,5447011,2020-04-09,101,0,682,2,0.12520628285861732,0.002932551319648094,20,126
Europe,Slovakia,5447011,2020-04-10,19,0,701,2,0.1286944344338574,0.0028530670470756064,21,126
Europe,Slovakia,5447011,2020-04-11,14,0,715,2,0.1312646513840343,0.002797202797202797,22,126
Europe,Slovakia,5447011,2020-04-12,13,0,728,2,0.13365128140919855,0.0027472527472527475,23,126
Europe,Slovakia,5447011,2020-04-13,14,0,742,2,0.13622149835937544,0.0026954177897574125,24,126
Europe,Slovakia,5447011,2020-04-14,27,0,769,2,0.1411783453347166,0.002600780234070221,25,126
Europe,Slovakia,5447011,2020-04-15,66,0,835,2,0.15329508238555054,0.0023952095808383233,26,126
Europe,Slovakia,5447011,2020-04-16,28,4,863,6,0.1584355162859043,0.006952491309385863,27,126
Europe,Slovakia,5447011,2020-04-17,114,2,977,8,0.17936442573734476,0.008188331627430911,28,126
Europe,Slovakia,5447011,2020-04-18,72,1,1049,9,0.1925826843382545,0.008579599618684462,29,126
Europe,Slovakia,5447011,2020-04-19,40,2,1089,11,0.1999261613387599,0.010101010101010102,30,126
Europe,Slovakia,5447011,2020-04-20,72,1,1161,12,0.21314441993966968,0.0103359173126615,31,126
Europe,Slovakia,5447011,2020-04-21,12,1,1173,13,0.21534746303982127,0.011082693947144074,32,126
Europe,Slovakia,5447011,2020-04-22,26,1,1199,14,0.2201207230901498,0.011676396997497914,33,126
Europe,Slovakia,5447011,2020-04-23,45,0,1244,14,0.22838213471571842,0.011254019292604502,34,126
Europe,Slovakia,5447011,2020-04-24,81,1,1325,15,0.24325267564174186,0.011320754716981131,35,126
Europe,Slovakia,5447011,2020-04-25,35,2,1360,17,0.2496782180171841,0.0125,36,126
Europe,Slovakia,5447011,2020-04-26,13,0,1373,17,0.25206484804234836,0.012381646030589949,37,126
Europe,Slovakia,5447011,2020-04-27,6,1,1379,18,0.25316636959242417,0.01305293691080493,38,126
Europe,Slovakia,5447011,2020-04-28,2,0,1381,18,0.25353354344244944,0.013034033309196235,39,126
Europe,Slovakia,5447011,2020-04-29,3,2,1384,20,0.25408430421748734,0.014450867052023121,40,126
Europe,Slovakia,5447011,2020-04-30,7,2,1391,22,0.2553694126925758,0.015815959741193385,41,126
Europe,Slovakia,5447011,2020-05-01,5,1,1396,23,0.25628734731763897,0.0164756446991404,42,126
Europe,Slovakia,5447011,2020-05-02,7,0,1403,23,0.2575724557927274,0.01639344262295082,43,126
Europe,Slovakia,5447011,2020-05-03,4,1,1407,24,0.25830680349277796,0.017057569296375266,44,126
Europe,Slovakia,5447011,2020-05-04,1,0,1408,24,0.2584903904177906,0.017045454545454544,45,126
Europe,Slovakia,5447011,2020-05-05,5,1,1413,25,0.25940832504285377,0.017692852087756547,46,126
Europe,Slovakia,5447011,2020-05-06,8,0,1421,25,0.26087702044295485,0.017593244194229415,47,126
Europe,Slovakia,5447011,2020-05-07,8,0,1429,25,0.26234571584305594,0.01749475157452764,48,126
Europe,Slovakia,5447011,2020-05-08,16,1,1445,26,0.26528310664325816,0.017993079584775088,49,126
Europe,Slovakia,5447011,2020-05-09,10,0,1455,26,0.26711897589338446,0.017869415807560136,50,126
Europe,Slovakia,5447011,2020-05-10,0,0,1455,26,0.26711897589338446,0.017869415807560136,51,126
Europe,Slovakia,5447011,2020-05-11,2,0,1457,26,0.26748614974340973,0.017844886753603295,52,126
Europe,Slovakia,5447011,2020-05-12,0,0,1457,26,0.26748614974340973,0.017844886753603295,53,126
Europe,Slovakia,5447011,2020-05-13,8,1,1465,27,0.2689548451435108,0.018430034129692834,54,126
Europe,Slovakia,5447011,2020-05-14,4,0,1469,27,0.26968919284356135,0.018379850238257316,55,126
Europe,Slovakia,5447011,2020-05-15,8,0,1477,27,0.27115788824366244,0.01828029790115098,56,126
Europe,Slovakia,5447011,2020-05-16,3,0,1480,27,0.27170864901870034,0.018243243243243244,57,126
Europe,Slovakia,5447011,2020-05-17,13,1,1493,28,0.2740952790438646,0.018754186202277295,58,126
Europe,Slovakia,5447011,2020-05-18,1,0,1494,28,0.27427886596887724,0.018741633199464525,59,126
Europe,Slovakia,5447011,2020-05-19,1,0,1495,28,0.2744624528938899,0.018729096989966554,60,126
Europe,Slovakia,5447011,2020-05-20,0,0,1495,28,0.2744624528938899,0.018729096989966554,61,126
Europe,Slovakia,5447011,2020-05-21,1,0,1496,28,0.2746460398189025,0.01871657754010695,62,126
Europe,Slovakia,5447011,2020-05-22,6,0,1502,28,0.2757475613689783,0.018641810918774968,63,126
Europe,Slovakia,5447011,2020-05-23,1,0,1503,28,0.27593114829399096,0.018629407850964737,64,126
Europe,Slovakia,5447011,2020-05-24,1,0,1504,28,0.2761147352190036,0.018617021276595744,65,126
Europe,Slovakia,5447011,2020-05-25,5,0,1509,28,0.27703266984406677,0.01855533465871438,66,126
Europe,Slovakia,5447011,2020-05-26,2,0,1511,28,0.27739984369409204,0.018530774321641297,67,126
Europe,Slovakia,5447011,2020-05-27,2,0,1513,28,0.2777670175441173,0.018506278916060808,68,126
Europe,Slovenia,2067372,2020-03-12,26,0,57,0,0.02757123536547849,0,0,127
Europe,Slovenia,2067372,2020-03-13,39,0,96,0,0.04643576482606904,0,1,127
Europe,Slovenia,2067372,2020-03-14,45,0,141,0,0.06820252958828889,0,2,127
Europe,Slovenia,2067372,2020-03-15,40,0,181,0,0.08755076493248434,0,3,127
Europe,Slovenia,2067372,2020-03-16,38,0,219,0,0.10593158850947,0,4,127
Europe,Slovenia,2067372,2020-03-17,34,0,253,0,0.1223775885520361,0,5,127
Europe,Slovenia,2067372,2020-03-18,22,1,275,1,0.13301911799134358,0.0036363636363636364,6,127
Europe,Slovenia,2067372,2020-03-19,11,0,286,1,0.13833988271099734,0.0034965034965034965,7,127
Europe,Slovenia,2067372,2020-03-20,33,0,319,1,0.1543021768699586,0.003134796238244514,8,127
Europe,Slovenia,2067372,2020-03-21,22,0,341,1,0.16494370630926605,0.002932551319648094,9,127
Europe,Slovenia,2067372,2020-03-22,42,0,383,1,0.18525935342067126,0.0026109660574412533,10,127
Europe,Slovenia,2067372,2020-03-23,31,0,414,1,0.20025423581242272,0.0024154589371980675,11,127
Europe,Slovenia,2067372,2020-03-24,28,0,442,1,0.21379800055335954,0.0022624434389140274,12,127
Europe,Slovenia,2067372,2020-03-25,38,2,480,3,0.23217882413034518,0.00625,13,127
Europe,Slovenia,2067372,2020-03-26,48,1,528,4,0.2553967065433797,0.007575757575757576,14,127
Europe,Slovenia,2067372,2020-03-27,49,1,577,5,0.27909829484001913,0.008665511265164644,15,127
Europe,Slovenia,2067372,2020-03-28,55,4,632,9,0.3057021184382879,0.014240506329113924,16,127
Europe,Slovenia,2067372,2020-03-29,59,0,691,9,0.3342407655709761,0.013024602026049204,17,127
Europe,Slovenia,2067372,2020-03-30,39,2,730,11,0.3531052950315667,0.015068493150684932,18,127
Europe,Slovenia,2067372,2020-03-31,33,0,763,11,0.3690675891905279,0.014416775884665793,19,127
Europe,Slovenia,2067372,2020-04-01,51,2,814,13,0.39373658925437705,0.01597051597051597,20,127
Europe,Slovenia,2067372,2020-04-02,27,2,841,15,0.40679664811170896,0.0178359096313912,21,127
Europe,Slovenia,2067372,2020-04-03,56,1,897,16,0.43388417759358255,0.017837235228539576,22,127
Europe,Slovenia,2067372,2020-04-04,37,4,934,20,0.4517812952869633,0.021413276231263382,23,127
Europe,Slovenia,2067372,2020-04-05,43,2,977,22,0.47258064828197344,0.022517911975435005,24,127
Europe,Slovenia,2067372,2020-04-06,20,6,997,28,0.4822547659540712,0.028084252758274825,25,127
Europe,Slovenia,2067372,2020-04-07,24,2,1021,30,0.4938637071605884,0.029382957884427033,26,127
Europe,Slovenia,2067372,2020-04-08,34,6,1055,36,0.5103097072031546,0.034123222748815164,27,127
Europe,Slovenia,2067372,2020-04-09,36,4,1091,40,0.5277231190129303,0.03666361136571952,28,127
Europe,Slovenia,2067372,2020-04-10,33,3,1124,43,0.5436854131718917,0.03825622775800712,29,127
Europe,Slovenia,2067372,2020-04-11,36,2,1160,45,0.5610988249816675,0.03879310344827586,30,127
Europe,Slovenia,2067372,2020-04-12,28,5,1188,50,0.5746425897226044,0.04208754208754209,31,127
Europe,Slovenia,2067372,2020-04-13,17,3,1205,53,0.5828655897438875,0.04398340248962656,32,127
Europe,Slovenia,2067372,2020-04-14,7,2,1212,55,0.5862515309291216,0.04537953795379538,33,127
Europe,Slovenia,2067372,2020-04-15,8,1,1220,56,0.5901211779979606,0.04590163934426229,34,127
Europe,Slovenia,2067372,2020-04-16,28,5,1248,61,0.6036649427388976,0.04887820512820513,35,127
Europe,Slovenia,2067372,2020-04-17,20,0,1268,61,0.6133390604109952,0.04810725552050473,36,127
Europe,Slovenia,2067372,2020-04-18,36,5,1304,66,0.6307524722207711,0.05061349693251534,37,127
Europe,Slovenia,2067372,2020-04-19,13,4,1317,70,0.6370406487076347,0.05315110098709187,38,127
Europe,Slovenia,2067372,2020-04-20,13,4,1330,74,0.6433288251944981,0.055639097744360905,39,127
Europe,Slovenia,2067372,2020-04-21,5,0,1335,74,0.6457473546125225,0.05543071161048689,40,127
Europe,Slovenia,2067372,2020-04-22,5,3,1340,77,0.648165884030547,0.057462686567164176,41,127
Europe,Slovenia,2067372,2020-04-23,13,2,1353,79,0.6544540605174105,0.058388765705838876,42,127
Europe,Slovenia,2067372,2020-04-24,13,0,1366,79,0.660742237004274,0.057833089311859445,43,127
Europe,Slovenia,2067372,2020-04-25,7,1,1373,80,0.6641281781895082,0.05826656955571741,44,127
Europe,Slovenia,2067372,2020-04-26,15,1,1388,81,0.6713837664435816,0.058357348703170026,45,127
Europe,Slovenia,2067372,2020-04-27,19,1,1407,82,0.6805741782320743,0.05828002842928216,46,127
Europe,Slovenia,2067372,2020-04-28,0,1,1407,83,0.6805741782320743,0.058990760483297794,47,127
Europe,Slovenia,2067372,2020-04-29,1,3,1408,86,0.6810578841156792,0.061079545454545456,48,127
Europe,Slovenia,2067372,2020-04-30,10,3,1418,89,0.6858949429517281,0.06276445698166432,49,127
Europe,Slovenia,2067372,2020-05-01,11,2,1429,91,0.6912157076713819,0.06368089573128062,50,127
Europe,Slovenia,2067372,2020-05-02,5,2,1434,93,0.6936342370894063,0.06485355648535565,51,127
Europe,Slovenia,2067372,2020-05-03,5,1,1439,94,0.6960527665074308,0.06532314107018763,52,127
Europe,Slovenia,2067372,2020-05-04,0,2,1439,96,0.6960527665074308,0.06671299513551077,53,127
Europe,Slovenia,2067372,2020-05-05,6,1,1445,97,0.69895500180906,0.0671280276816609,54,127
Europe,Slovenia,2067372,2020-05-06,3,1,1448,98,0.7004061194598747,0.06767955801104972,55,127
Europe,Slovenia,2067372,2020-05-07,1,1,1449,99,0.7008898253434795,0.06832298136645963,56,127
Europe,Slovenia,2067372,2020-05-08,1,0,1450,99,0.7013735312270843,0.06827586206896552,57,127
Europe,Slovenia,2067372,2020-05-09,4,1,1454,100,0.703308354761504,0.0687757909215956,58,127
Europe,Slovenia,2067372,2020-05-10,3,1,1457,101,0.7047594724123187,0.06932052161976665,59,127
Europe,Slovenia,2067372,2020-05-11,3,1,1460,102,0.7062105900631334,0.06986301369863014,60,127
Europe,Slovenia,2067372,2020-05-12,1,0,1461,102,0.7066942959467382,0.06981519507186858,61,127
Europe,Slovenia,2067372,2020-05-13,2,0,1463,102,0.707661707713948,0.06971975393028025,62,127
Europe,Slovenia,2067372,2020-05-14,1,1,1464,103,0.7081454135975529,0.0703551912568306,63,127
Europe,Slovenia,2067372,2020-05-15,1,0,1465,103,0.7086291194811577,0.07030716723549488,64,127
Europe,Slovenia,2067372,2020-05-16,0,0,1465,103,0.7086291194811577,0.07030716723549488,65,127
Europe,Slovenia,2067372,2020-05-17,1,0,1466,103,0.7091128253647626,0.07025920873124147,66,127
Europe,Slovenia,2067372,2020-05-18,0,1,1466,104,0.7091128253647626,0.07094133697135062,67,127
Europe,Slovenia,2067372,2020-05-19,1,0,1467,104,0.7095965312483675,0.070892978868439,68,127
Europe,Slovenia,2067372,2020-05-20,1,0,1468,104,0.7100802371319723,0.07084468664850137,69,127
Europe,Slovenia,2067372,2020-05-21,0,2,1468,106,0.7100802371319723,0.07220708446866485,70,127
Europe,Slovenia,2067372,2020-05-22,0,0,1468,106,0.7100802371319723,0.07220708446866485,71,127
Europe,Slovenia,2067372,2020-05-23,0,0,1468,106,0.7100802371319723,0.07220708446866485,72,127
Europe,Slovenia,2067372,2020-05-24,0,0,1468,106,0.7100802371319723,0.07220708446866485,73,127
Europe,Slovenia,2067372,2020-05-25,1,0,1469,106,0.7105639430155773,0.07215793056501021,74,127
Europe,Slovenia,2067372,2020-05-26,0,0,1469,106,0.7105639430155773,0.07215793056501021,75,127
Europe,Slovenia,2067372,2020-05-27,0,0,1469,106,0.7105639430155773,0.07215793056501021,76,127
Africa,Somalia,15008154,2020-04-24,42,0,328,14,0.02185478640477703,0.042682926829268296,0,128
Africa,Somalia,15008154,2020-04-25,0,2,328,16,0.02185478640477703,0.04878048780487805,1,128
Africa,Somalia,15008154,2020-04-26,62,2,390,18,0.025985874078850738,0.046153846153846156,2,128
Africa,Somalia,15008154,2020-04-27,46,5,436,23,0.029050874611228003,0.052752293577981654,3,128
Africa,Somalia,15008154,2020-04-28,44,3,480,26,0.03198261425089321,0.05416666666666667,4,128
Africa,Somalia,15008154,2020-04-29,48,2,528,28,0.035180875675982534,0.05303030303030303,5,128
Africa,Somalia,15008154,2020-04-30,54,0,582,28,0.038778919779208026,0.048109965635738834,6,128
Africa,Somalia,15008154,2020-05-01,19,0,601,28,0.040044898259972546,0.04658901830282862,7,128
Africa,Somalia,15008154,2020-05-02,0,0,601,28,0.040044898259972546,0.04658901830282862,8,128
Africa,Somalia,15008154,2020-05-03,70,3,671,31,0.04470902950489447,0.046199701937406856,9,128
Africa,Somalia,15008154,2020-05-04,51,1,722,32,0.048107182269051876,0.0443213296398892,10,128
Africa,Somalia,15008154,2020-05-05,34,3,756,35,0.05037261744515681,0.046296296296296294,11,128
Africa,Somalia,15008154,2020-05-06,79,3,835,38,0.05563642270728299,0.045508982035928146,12,128
Africa,Somalia,15008154,2020-05-07,38,1,873,39,0.05816837966881203,0.044673539518900345,13,128
Africa,Somalia,15008154,2020-05-08,55,5,928,44,0.061833054218393545,0.047413793103448273,14,128
Africa,Somalia,15008154,2020-05-09,0,0,928,44,0.061833054218393545,0.047413793103448273,15,128
Africa,Somalia,15008154,2020-05-10,69,4,997,48,0.06643055501695945,0.048144433299899696,16,128
Africa,Somalia,15008154,2020-05-11,57,3,1054,51,0.07022849045925302,0.04838709677419355,17,128
Africa,Somalia,15008154,2020-05-12,35,1,1089,52,0.07256055608171398,0.047750229568411386,18,128
Africa,Somalia,15008154,2020-05-13,81,0,1170,52,0.07795762223655221,0.044444444444444446,19,128
Africa,Somalia,15008154,2020-05-14,49,0,1219,52,0.08122251410799756,0.04265791632485644,20,128
Africa,Somalia,15008154,2020-05-15,65,1,1284,53,0.08555349312113936,0.04127725856697819,21,128
Africa,Somalia,15008154,2020-05-16,0,0,1284,53,0.08555349312113936,0.04127725856697819,22,128
Africa,Somalia,15008154,2020-05-17,73,2,1357,55,0.09041751570512936,0.040530582166543844,23,128
Africa,Somalia,15008154,2020-05-18,64,1,1421,56,0.09468186427191513,0.03940886699507389,24,128
Africa,Somalia,15008154,2020-05-19,34,1,1455,57,0.09694729944802005,0.03917525773195876,25,128
Africa,Somalia,15008154,2020-05-20,47,2,1502,59,0.10007893042675335,0.039280958721704395,26,128
Africa,Somalia,15008154,2020-05-21,71,2,1573,61,0.1048096921180313,0.03877940241576605,27,128
Africa,Somalia,15008154,2020-05-22,21,0,1594,61,0.10620893149150788,0.038268506900878296,28,128
Africa,Somalia,15008154,2020-05-23,0,0,1594,61,0.10620893149150788,0.038268506900878296,29,128
Africa,Somalia,15008154,2020-05-24,0,0,1594,61,0.10620893149150788,0.038268506900878296,30,128
Africa,Somalia,15008154,2020-05-25,0,0,1594,61,0.10620893149150788,0.038268506900878296,31,128
Africa,Somalia,15008154,2020-05-26,95,5,1689,66,0.1125388238953305,0.03907637655417407,32,128
Africa,Somalia,15008154,2020-05-27,22,1,1711,67,0.1140046937151631,0.03915838690824079,33,128
Africa,South Africa,57779622,2020-03-28,243,0,1170,2,0.02024935365620772,0.0017094017094017094,0,129
Africa,South Africa,57779622,2020-03-29,17,0,1187,2,0.020543575034118428,0.0016849199663016006,1,129
Africa,South Africa,57779622,2020-03-30,93,0,1280,2,0.022153139042688785,0.0015625,2,129
Africa,South Africa,57779622,2020-03-31,46,1,1326,3,0.022949267477035417,0.0022624434389140274,3,129
Africa,South Africa,57779622,2020-04-01,27,2,1353,5,0.02341656025371713,0.003695491500369549,4,129
Africa,South Africa,57779622,2020-04-02,27,0,1380,5,0.02388385303039885,0.0036231884057971015,5,129
Africa,South Africa,57779622,2020-04-03,82,0,1462,5,0.0253030385003211,0.003419972640218878,6,129
Africa,South Africa,57779622,2020-04-04,43,2,1505,7,0.026047245515036427,0.004651162790697674,7,129
Africa,South Africa,57779622,2020-04-05,80,2,1585,9,0.027431816705204476,0.0056782334384858045,8,129
Africa,South Africa,57779622,2020-04-06,70,2,1655,11,0.028643316496601515,0.006646525679758308,9,129
Africa,South Africa,57779622,2020-04-07,31,1,1686,12,0.029179837832791634,0.0071174377224199285,10,129
Africa,South Africa,57779622,2020-04-08,63,1,1749,13,0.030270187645048977,0.007432818753573471,11,129
Africa,South Africa,57779622,2020-04-09,96,5,1845,18,0.031931673073250635,0.00975609756097561,12,129
Africa,South Africa,57779622,2020-04-10,89,0,1934,18,0.03347200852231259,0.009307135470527405,13,129
Africa,South Africa,57779622,2020-04-11,69,6,2003,24,0.03466620117383253,0.011982026959560658,14,129
Africa,South Africa,57779622,2020-04-12,25,1,2028,25,0.03509887967076005,0.01232741617357002,15,129
Africa,South Africa,57779622,2020-04-13,145,0,2173,25,0.03760841495293964,0.01150483202945237,16,129
Africa,South Africa,57779622,2020-04-14,99,2,2272,27,0.0393218218007726,0.011883802816901408,17,129
Africa,South Africa,57779622,2020-04-15,143,0,2415,27,0.041796742803197985,0.011180124223602485,18,129
Africa,South Africa,57779622,2020-04-16,91,7,2506,34,0.04337169253201414,0.013567438148443736,19,129
Africa,South Africa,57779622,2020-04-17,99,14,2605,48,0.0450850993798471,0.018426103646833013,20,129
Africa,South Africa,57779622,2020-04-18,178,2,2783,50,0.04816577027797101,0.017966223499820338,21,129
Africa,South Africa,57779622,2020-04-19,251,2,3034,52,0.05250986238712327,0.017139090309822018,22,129
Africa,South Africa,57779622,2020-04-20,124,2,3158,54,0.054655947731883744,0.017099430018999367,23,129
Africa,South Africa,57779622,2020-04-21,142,4,3300,58,0.05711356159443203,0.017575757575757574,24,129
Africa,South Africa,57779622,2020-04-22,165,0,3465,58,0.059969239674153636,0.01673881673881674,25,129
Africa,South Africa,57779622,2020-04-23,170,7,3635,65,0.06291145345326074,0.017881705639614855,26,129
Africa,South Africa,57779622,2020-04-24,318,10,3953,75,0.06841512393417873,0.018972931950417403,27,129
Africa,South Africa,57779622,2020-04-25,267,4,4220,79,0.07303613028136459,0.01872037914691943,28,129
Africa,South Africa,57779622,2020-04-26,141,7,4361,86,0.07547643700403579,0.019720247649621648,29,129
Africa,South Africa,57779622,2020-04-27,185,1,4546,87,0.0786782578812994,0.01913770347558293,30,129
Africa,South Africa,57779622,2020-04-28,247,3,4793,90,0.08295312143094326,0.018777383684539954,31,129
Africa,South Africa,57779622,2020-04-29,203,3,4996,93,0.08646647082599467,0.018614891913530825,32,129
Africa,South Africa,57779622,2020-04-30,354,10,5350,103,0.09259319834248829,0.01925233644859813,33,129
Africa,South Africa,57779622,2020-05-01,297,0,5647,103,0.09773341888598717,0.0182397733309722,34,129
Africa,South Africa,57779622,2020-05-02,304,13,5951,116,0.10299478940862576,0.01949252226516552,35,129
Africa,South Africa,57779622,2020-05-03,385,7,6336,123,0.1096580382613095,0.019412878787878788,36,129
Africa,South Africa,57779622,2020-05-04,447,8,6783,131,0.11739432978637347,0.01931298835323603,37,129
Africa,South Africa,57779622,2020-05-05,437,7,7220,138,0.12495754991266643,0.019113573407202215,38,129
Africa,South Africa,57779622,2020-05-06,352,10,7572,148,0.13104966314940586,0.01954569466455362,39,129
Africa,South Africa,57779622,2020-05-07,236,5,7808,153,0.13513414816040162,0.0195952868852459,40,129
Africa,South Africa,57779622,2020-05-08,424,8,8232,161,0.14247237546829228,0.0195578231292517,41,129
Africa,South Africa,57779622,2020-05-09,663,17,8895,178,0.15394700920680995,0.02001124227093873,42,129
Africa,South Africa,57779622,2020-05-10,525,8,9420,186,0.1630332576422878,0.019745222929936305,43,129
Africa,South Africa,57779622,2020-05-11,595,8,10015,194,0.17333100586916267,0.019370943584623067,44,129
Africa,South Africa,57779622,2020-05-12,637,12,10652,206,0.18435565397087575,0.019339091250469394,45,129
Africa,South Africa,57779622,2020-05-13,698,0,11350,206,0.19643603760509198,0.018149779735682818,46,129
Africa,South Africa,57779622,2020-05-14,724,13,12074,219,0.20896640687611281,0.01813814808679808,47,129
Africa,South Africa,57779622,2020-05-15,665,19,12739,238,0.22047565489438475,0.0186827851479708,48,129
Africa,South Africa,57779622,2020-05-16,785,9,13524,247,0.23406175969790874,0.01826382727003845,49,129
Africa,South Africa,57779622,2020-05-17,831,14,14355,261,0.24844399293577932,0.01818181818181818,50,129
Africa,South Africa,57779622,2020-05-18,1160,3,15515,264,0.26852027519321603,0.017015791169835644,51,129
Africa,South Africa,57779622,2020-05-19,918,22,16433,286,0.2844082296003944,0.017404004138014968,52,129
Africa,South Africa,57779622,2020-05-20,767,26,17200,312,0.29768280588613055,0.01813953488372093,53,129
Africa,South Africa,57779622,2020-05-21,803,27,18003,339,0.3115804392074424,0.018830194967505414,54,129
Africa,South Africa,57779622,2020-05-22,1134,30,19137,369,0.33120673582807447,0.01928201912525474,55,129
Africa,South Africa,57779622,2020-05-23,988,28,20125,397,0.3483061900266499,0.019726708074534163,56,129
Africa,South Africa,57779622,2020-05-24,1218,10,21343,407,0.3693862863969584,0.019069484139999062,57,129
Africa,South Africa,57779622,2020-05-25,1240,22,22583,429,0.39084713984456315,0.018996590355577204,58,129
Africa,South Africa,57779622,2020-05-26,1032,52,23615,481,0.408708108197731,0.02036840990895617,59,129
Africa,South Africa,57779622,2020-05-27,649,43,24264,524,0.4199404419779693,0.021595779756017144,60,129
Africa,South Sudan,10975920,2020-05-15,28,1,231,1,0.02104607176437146,0.004329004329004329,0,130
Africa,South Sudan,10975920,2020-05-16,5,3,236,4,0.02150161444325396,0.01694915254237288,1,130
Africa,South Sudan,10975920,2020-05-17,0,0,236,4,0.02150161444325396,0.01694915254237288,2,130
Africa,South Sudan,10975920,2020-05-18,46,0,282,4,0.025692607088972953,0.014184397163120567,3,130
Africa,South Sudan,10975920,2020-05-19,0,0,282,4,0.025692607088972953,0.014184397163120567,4,130
Africa,South Sudan,10975920,2020-05-20,3,2,285,6,0.02596593269630245,0.021052631578947368,5,130
Africa,South Sudan,10975920,2020-05-21,0,0,285,6,0.02596593269630245,0.021052631578947368,6,130
Africa,South Sudan,10975920,2020-05-22,54,0,339,6,0.030885793628233443,0.017699115044247787,7,130
Africa,South Sudan,10975920,2020-05-23,0,0,339,6,0.030885793628233443,0.017699115044247787,8,130
Africa,South Sudan,10975920,2020-05-24,224,0,563,6,0.0512941056421694,0.010657193605683837,9,130
Africa,South Sudan,10975920,2020-05-25,0,0,563,6,0.0512941056421694,0.010657193605683837,10,130
Africa,South Sudan,10975920,2020-05-26,92,2,655,8,0.05967609093360739,0.012213740458015267,11,130
Africa,South Sudan,10975920,2020-05-27,151,0,806,8,0.07343347983585886,0.009925558312655087,12,130
Europe,Spain,46723749,2020-03-08,330,0,1094,5,0.02341421703981844,0.004570383912248629,0,131
Europe,Spain,46723749,2020-03-09,433,0,1527,5,0.03268145285173927,0.0032743942370661427,1,131
Europe,Spain,46723749,2020-03-10,772,23,2299,28,0.049204099611099276,0.012179208351457155,2,131
Europe,Spain,46723749,2020-03-11,975,7,3274,35,0.07007143198205264,0.010690287110568112,3,131
Europe,Spain,46723749,2020-03-12,1153,12,4427,47,0.09474839016021595,0.010616670431443416,4,131
Europe,Spain,46723749,2020-03-13,1531,37,5958,84,0.12751545258065658,0.014098690835850957,5,131
Europe,Spain,46723749,2020-03-14,1683,37,7641,121,0.1635356786117484,0.0158356236094752,6,131
Europe,Spain,46723749,2020-03-15,2144,15,9785,136,0.20942240743567045,0.013898824731732243,7,131
Europe,Spain,46723749,2020-03-16,1706,152,11491,288,0.24593488848679498,0.025063092855278045,8,131
Europe,Spain,46723749,2020-03-17,2503,21,13994,309,0.299505076101663,0.022080891810776045,9,131
Europe,Spain,46723749,2020-03-18,3694,182,17688,491,0.37856551279735706,0.027758932609678877,10,131
Europe,Spain,46723749,2020-03-19,4047,107,21735,598,0.4651809939309451,0.027513227513227514,11,131
Europe,Spain,46723749,2020-03-20,4569,169,26304,767,0.5629685237800589,0.029159063260340633,12,131
Europe,Spain,46723749,2020-03-21,5446,235,31750,1002,0.6795259515669431,0.03155905511811024,13,131
Europe,Spain,46723749,2020-03-22,4866,324,36616,1326,0.7836699918921317,0.03621367708105746,14,131
Europe,Spain,46723749,2020-03-23,4646,394,41262,1720,0.8831055059387465,0.04168484319713053,15,131
Europe,Spain,46723749,2020-03-24,7691,462,48953,2182,1.0477113041592618,0.04457336629011501,16,131
Europe,Spain,46723749,2020-03-25,8553,514,57506,2696,1.2307659644349174,0.04688206448022815,17,131
Europe,Spain,46723749,2020-03-26,8954,738,66460,3434,1.422402983972883,0.05167017755040626,18,131
Europe,Spain,46723749,2020-03-27,9181,655,75641,4089,1.6188983465346498,0.0540579844264354,19,131
Europe,Spain,46723749,2020-03-28,8244,769,83885,4858,1.7953396676281264,0.05791261846575669,20,131
Europe,Spain,46723749,2020-03-29,6424,832,90309,5690,1.93282863496249,0.06300590195883024,21,131
Europe,Spain,46723749,2020-03-30,5813,838,96122,6528,2.0572407406777224,0.0679136930151266,22,131
Europe,Spain,46723749,2020-03-31,8145,812,104267,7340,2.231563224945841,0.07039619438556782,23,131
Europe,Spain,46723749,2020-04-01,7413,849,111680,8189,2.3902191581416123,0.07332557306590258,24,131
Europe,Spain,46723749,2020-04-02,7583,864,119263,9053,2.5525134980071913,0.07590786748614407,25,131
Europe,Spain,46723749,2020-04-03,7272,950,126535,10003,2.7081516939062404,0.07905322638005295,26,131
Europe,Spain,46723749,2020-04-04,6663,932,133198,10935,2.8507558329705094,0.08209582726467364,27,131
Europe,Spain,46723749,2020-04-05,5533,809,138731,11744,2.9691752688766475,0.08465303356856074,28,131
Europe,Spain,46723749,2020-04-06,3667,674,142398,12418,3.0476578409836077,0.08720628098709252,29,131
Europe,Spain,46723749,2020-04-07,5209,637,147607,13055,3.159142901824937,0.08844431497151219,30,131
Europe,Spain,46723749,2020-04-08,5583,743,153190,13798,3.2786324573398424,0.09007115346954762,31,131
Europe,Spain,46723749,2020-04-09,5745,757,158935,14555,3.401589200387152,0.09157831818038821,32,131
Europe,Spain,46723749,2020-04-10,4537,683,163472,15238,3.498691853686655,0.09321474013898405,33,131
Europe,Spain,46723749,2020-04-11,4550,605,168022,15843,3.5960727380844375,0.09429122376831606,34,131
Europe,Spain,46723749,2020-04-12,3899,510,171921,16353,3.6795206651760757,0.09511926989722023,35,131
Europe,Spain,46723749,2020-04-13,3030,619,174951,16972,3.744369913467346,0.0970100199484427,36,131
Europe,Spain,46723749,2020-04-14,3116,517,178067,17489,3.8110597674856956,0.09821584010512897,37,131
Europe,Spain,46723749,2020-04-15,4424,787,182491,18276,3.9057439504693856,0.10014740452953844,38,131
Europe,Spain,46723749,2020-04-16,3820,617,186311,18893,3.987501088579172,0.10140571410169018,39,131
Europe,Spain,46723749,2020-04-17,3818,585,190129,19478,4.069215421904608,0.10244623387279163,40,131
Europe,Spain,46723749,2020-04-18,3836,565,193965,20043,4.1513149982892,0.10333307555486815,41,131
Europe,Spain,46723749,2020-04-20,2218,399,195470,20852,4.183525598513081,0.10667621629917634,43,131
Europe,Spain,46723749,2020-04-21,2951,430,198421,21282,4.246684057822501,0.107256792375807,44,131
Europe,Spain,46723749,2020-04-22,2312,435,200733,21717,4.296166388531879,0.10818848918712917,45,131
Europe,Spain,46723749,2020-04-23,2916,440,203649,22157,4.358575764115161,0.10879994500341274,46,131
Europe,Spain,46723749,2020-04-24,2114,367,205763,22524,4.403820421173823,0.10946574457020941,47,131
Europe,Spain,46723749,2020-04-25,2506,378,208269,22902,4.4574548159652165,0.10996355674632327,48,131
Europe,Spain,46723749,2020-04-26,1641,288,209910,23190,4.492576141524945,0.11047591825067886,49,131
Europe,Spain,46723749,2020-04-27,1660,0,211570,23190,4.5281041125360035,0.10960911282317909,50,131
Europe,Spain,46723749,2020-04-28,1525,632,213095,23822,4.560742760603392,0.11179051596705694,51,131
Europe,Spain,46723749,2020-04-29,847,453,213942,24275,4.578870586775903,0.1134653317254209,52,131
Europe,Spain,46723749,2020-04-30,1241,268,215183,24543,4.605430955465495,0.11405640780173155,53,131
Europe,Spain,46723749,2020-05-01,1387,281,216570,24824,4.635116073412688,0.11462344738421758,54,131
Europe,Spain,46723749,2020-05-02,1234,276,217804,25100,4.6615266253570535,0.11524122605645443,55,131
Europe,Spain,46723749,2020-05-03,935,164,218739,25264,4.681537862040994,0.11549837934707574,56,131
Europe,Spain,46723749,2020-05-04,466,164,219205,25428,4.6915113767947005,0.1160010036267421,57,131
Europe,Spain,46723749,2020-05-05,1039,185,220244,25613,4.713748462264875,0.11629374693521731,58,131
Europe,Spain,46723749,2020-05-06,880,244,221124,25857,4.732582567379171,0.11693438975416508,59,131
Europe,Spain,46723749,2020-05-07,921,213,222045,26070,4.7522941705726565,0.11740863338512464,60,131
Europe,Spain,46723749,2020-05-08,1173,181,223218,26251,4.777399176594327,0.11760252309401571,61,131
Europe,Spain,46723749,2020-05-09,743,227,223961,26478,4.793301153980602,0.11822594112367778,62,131
Europe,Spain,46723749,2020-05-10,3416,143,227377,26621,4.866411725651553,0.11707868429964333,63,131
Europe,Spain,46723749,2020-05-11,393,123,227770,26744,4.87482286577646,0.11741669227729727,64,131
Europe,Spain,46723749,2020-05-12,482,176,228252,26920,4.885138818804973,0.11793982089970734,65,131
Europe,Spain,46723749,2020-05-13,439,184,228691,27104,4.894534468969945,0.11851800027110818,66,131
Europe,Spain,46723749,2020-05-14,849,217,229540,27321,4.912705099926806,0.11902500653480874,67,131
Europe,Spain,46723749,2020-05-15,643,138,230183,27459,4.926466838095548,0.11929204154954971,68,131
Europe,Spain,46723749,2020-05-16,515,104,230698,27563,4.937489070065846,0.11947654509358556,69,131
Europe,Spain,46723749,2020-05-17,652,87,231350,27650,4.951443429764166,0.11951588502269289,70,131
Europe,Spain,46723749,2020-05-18,256,59,231606,27709,4.956922442161051,0.11963852404514563,71,131
Europe,Spain,46723749,2020-05-19,431,69,232037,27778,4.966146873188621,0.11971366635493477,72,131
Europe,Spain,46723749,2020-05-20,518,110,232555,27888,4.977233312335446,0.11992001892025542,73,131
Europe,Spain,46723749,2020-05-21,482,52,233037,27940,4.987549265363959,0.11989512395027399,74,131
Europe,Spain,46723749,2020-05-22,1787,688,234824,28628,5.025795340181285,0.12191258133751234,75,131
Europe,Spain,46723749,2020-05-23,466,50,235290,28678,5.035768854934992,0.12188363296357686,76,131
Europe,Spain,46723749,2020-05-24,482,74,235772,28752,5.046084807963505,0.12194832295607622,77,131
Europe,Spain,46723749,2020-05-26,859,283,236259,27117,5.0565077729528936,0.11477657993981182,79,131
Asia,Sri Lanka,21670000,2020-04-26,42,0,462,7,0.02131979695431472,0.015151515151515152,0,132
Asia,Sri Lanka,21670000,2020-04-27,61,0,523,7,0.024134748500230733,0.01338432122370937,1,132
Asia,Sri Lanka,21670000,2020-04-28,65,0,588,7,0.02713428703276419,0.011904761904761904,2,132
Asia,Sri Lanka,21670000,2020-04-29,31,0,619,7,0.02856483617904938,0.011308562197092083,3,132
Asia,Sri Lanka,21670000,2020-04-30,30,0,649,7,0.029949238578680204,0.01078582434514638,4,132
Asia,Sri Lanka,21670000,2020-05-01,16,0,665,7,0.030687586525149975,0.010526315789473684,5,132
Asia,Sri Lanka,21670000,2020-05-02,25,0,690,7,0.031841255191509,0.010144927536231883,6,132
Asia,Sri Lanka,21670000,2020-05-03,15,0,705,7,0.03253345639132441,0.009929078014184398,7,132
Asia,Sri Lanka,21670000,2020-05-04,13,0,718,7,0.0331333640978311,0.009749303621169917,8,132
Asia,Sri Lanka,21670000,2020-05-05,37,1,755,8,0.03484079372404246,0.010596026490066225,9,132
Asia,Sri Lanka,21670000,2020-05-06,16,1,771,9,0.03557914167051223,0.011673151750972763,10,132
Asia,Sri Lanka,21670000,2020-05-07,26,0,797,9,0.03677895708352561,0.011292346298619825,11,132
Asia,Sri Lanka,21670000,2020-05-08,27,0,824,9,0.03802491924319335,0.010922330097087379,12,132
Asia,Sri Lanka,21670000,2020-05-09,11,0,835,9,0.03853253345639133,0.010778443113772455,13,132
Asia,Sri Lanka,21670000,2020-05-10,12,0,847,9,0.03908629441624365,0.010625737898465172,14,132
Asia,Sri Lanka,21670000,2020-05-11,16,0,863,9,0.03982464236271343,0.010428736964078795,15,132
Asia,Sri Lanka,21670000,2020-05-12,6,0,869,9,0.04010152284263959,0.010356731875719217,16,132
Asia,Sri Lanka,21670000,2020-05-13,20,0,889,9,0.04102445777572681,0.010123734533183352,17,132
Asia,Sri Lanka,21670000,2020-05-14,26,0,915,9,0.04222427318874019,0.009836065573770493,18,132
Asia,Sri Lanka,21670000,2020-05-15,10,0,925,9,0.042685740655283806,0.00972972972972973,19,132
Asia,Sri Lanka,21670000,2020-05-16,10,0,935,9,0.04314720812182741,0.009625668449197862,20,132
Asia,Sri Lanka,21670000,2020-05-17,25,0,960,9,0.044300876788186436,0.009375,21,132
Asia,Sri Lanka,21670000,2020-05-18,21,0,981,9,0.045269958467928015,0.009174311926605505,22,132
Asia,Sri Lanka,21670000,2020-05-19,11,0,992,9,0.045777572681125984,0.009072580645161291,23,132
Asia,Sri Lanka,21670000,2020-05-20,35,0,1027,9,0.047392708814028614,0.008763388510223954,24,132
Asia,Sri Lanka,21670000,2020-05-21,1,0,1028,9,0.047438855560682974,0.008754863813229572,25,132
Asia,Sri Lanka,21670000,2020-05-22,27,0,1055,9,0.048684817720350715,0.008530805687203791,26,132
Asia,Sri Lanka,21670000,2020-05-23,13,0,1068,9,0.04928472542685741,0.008426966292134831,27,132
Asia,Sri Lanka,21670000,2020-05-24,21,0,1089,9,0.050253807106598984,0.008264462809917356,28,132
Asia,Sri Lanka,21670000,2020-05-25,52,0,1141,9,0.05265343793262575,0.007887817703768623,29,132
Asia,Sri Lanka,21670000,2020-05-26,41,1,1182,10,0.05454545454545454,0.008460236886632826,30,132
Asia,Sri Lanka,21670000,2020-05-27,137,0,1319,10,0.06086755883710199,0.0075815011372251705,31,132
Africa,Sudan,41801533,2020-05-07,74,4,852,49,0.02038202761606853,0.057511737089201875,0,133
Africa,Sudan,41801533,2020-05-08,78,3,930,52,0.02224798789077903,0.05591397849462366,1,133
Africa,Sudan,41801533,2020-05-09,181,7,1111,59,0.026577972630812366,0.05310531053105311,2,133
Africa,Sudan,41801533,2020-05-10,53,5,1164,64,0.02784586871491053,0.054982817869415807,3,133
Africa,Sudan,41801533,2020-05-11,199,6,1363,70,0.03260645967218475,0.05135730007336757,4,133
Africa,Sudan,41801533,2020-05-12,163,4,1526,74,0.0365058381949772,0.04849279161205767,5,133
Africa,Sudan,41801533,2020-05-13,135,6,1661,80,0.03973538482428384,0.048163756773028296,6,133
Africa,Sudan,41801533,2020-05-14,157,10,1818,90,0.04349122794132933,0.04950495049504951,7,133
Africa,Sudan,41801533,2020-05-15,146,1,1964,91,0.04698392281450539,0.04633401221995927,8,133
Africa,Sudan,41801533,2020-05-16,0,0,1964,91,0.04698392281450539,0.04633401221995927,9,133
Africa,Sudan,41801533,2020-05-17,0,0,1964,91,0.04698392281450539,0.04633401221995927,10,133
Africa,Sudan,41801533,2020-05-18,325,6,2289,97,0.05475875729246581,0.04237658366098733,11,133
Africa,Sudan,41801533,2020-05-19,302,8,2591,105,0.061983372715062865,0.04052489386337321,12,133
Africa,Sudan,41801533,2020-05-20,0,0,2591,105,0.061983372715062865,0.04052489386337321,13,133
Africa,Sudan,41801533,2020-05-21,137,6,2728,111,0.0652607644796185,0.0406891495601173,14,133
Africa,Sudan,41801533,2020-05-22,410,10,3138,121,0.07506901720566085,0.03855959209687699,15,133
Africa,Sudan,41801533,2020-05-23,240,16,3378,137,0.08081043343553931,0.040556542332741266,16,133
Africa,Sudan,41801533,2020-05-24,250,9,3628,146,0.08679107534166271,0.0402425578831312,17,133
Africa,Sudan,41801533,2020-05-25,6,0,3634,146,0.08693461074740967,0.040176114474408366,18,133
Africa,Sudan,41801533,2020-05-26,192,19,3826,165,0.09152774373131244,0.04312598013591218,19,133
Africa,Sudan,41801533,2020-05-27,150,5,3976,170,0.09511612887498648,0.04275653923541248,20,133
Europe,Sweden,10183175,2020-03-10,45,0,248,0,0.024353897482857753,0,0,134
Europe,Sweden,10183175,2020-03-11,78,0,326,0,0.03201359104601463,0,1,134
Europe,Sweden,10183175,2020-03-12,136,1,462,1,0.04536895418177533,0.0021645021645021645,2,134
Europe,Sweden,10183175,2020-03-13,158,0,620,1,0.06088474370714438,0.0016129032258064516,3,134
Europe,Sweden,10183175,2020-03-14,155,0,775,1,0.07610592963393048,0.0012903225806451613,4,134
Europe,Sweden,10183175,2020-03-15,149,0,924,1,0.09073790836355065,0.0010822510822510823,5,134
Europe,Sweden,10183175,2020-03-16,108,2,1032,3,0.1013436379125371,0.0029069767441860465,6,134
Europe,Sweden,10183175,2020-03-17,89,4,1121,7,0.11008354467049815,0.006244424620874219,7,134
Europe,Sweden,10183175,2020-03-18,46,1,1167,8,0.11460079984877015,0.006855184233076264,8,134
Europe,Sweden,10183175,2020-03-19,134,2,1301,10,0.12775976058547556,0.007686395080707148,9,134
Europe,Sweden,10183175,2020-03-20,122,0,1423,10,0.1397403069278491,0.007027406886858749,10,134
Europe,Sweden,10183175,2020-03-21,200,6,1623,16,0.15938054683337954,0.009858287122612447,11,134
Europe,Sweden,10183175,2020-03-22,123,4,1746,20,0.1714592943752808,0.011454753722794959,12,134
Europe,Sweden,10183175,2020-03-23,160,1,1906,21,0.18717148629970515,0.011017838405036727,13,134
Europe,Sweden,10183175,2020-03-24,110,4,2016,25,0.1979736182477469,0.01240079365079365,14,134
Europe,Sweden,10183175,2020-03-25,256,11,2272,36,0.22311312532682587,0.01584507042253521,15,134
Europe,Sweden,10183175,2020-03-26,238,6,2510,42,0.2464850108144071,0.016733067729083666,16,134
Europe,Sweden,10183175,2020-03-27,296,24,2806,66,0.27555256587459215,0.023521026372059873,17,134
Europe,Sweden,10183175,2020-03-28,240,26,3046,92,0.2991208537612287,0.030203545633617858,18,134
Europe,Sweden,10183175,2020-03-29,401,10,3447,102,0.33849953477181727,0.02959094865100087,19,134
Europe,Sweden,10183175,2020-03-30,253,8,3700,110,0.3633444382523133,0.02972972972972973,20,134
Europe,Sweden,10183175,2020-03-31,328,36,4028,146,0.3955544316973832,0.03624627606752731,21,134
Europe,Sweden,10183175,2020-04-01,407,34,4435,180,0.4355223199051376,0.040586245772266064,22,134
Europe,Sweden,10183175,2020-04-02,512,59,4947,239,0.48580133406329556,0.04831210834849404,23,134
Europe,Sweden,10183175,2020-04-03,519,43,5466,282,0.5367677566181471,0.05159165751920966,24,134
Europe,Sweden,10183175,2020-04-04,612,51,6078,333,0.5968668907290703,0.05478775913129319,25,134
Europe,Sweden,10183175,2020-04-05,365,40,6443,373,0.6327103285566633,0.05789228620207978,26,134
Europe,Sweden,10183175,2020-04-06,387,28,6830,401,0.6707141927738648,0.05871156661786237,27,134
Europe,Sweden,10183175,2020-04-07,376,76,7206,477,0.7076378437962619,0.06619483763530391,28,134
Europe,Sweden,10183175,2020-04-08,487,114,7693,591,0.7554618279662286,0.076823085922267,29,134
Europe,Sweden,10183175,2020-04-09,726,96,8419,687,0.8267558988233041,0.08160114027794275,30,134
Europe,Sweden,10183175,2020-04-10,722,106,9141,793,0.897657164882269,0.08675199649928891,31,134
Europe,Sweden,10183175,2020-04-11,544,77,9685,870,0.9510786174253119,0.08982963345379452,32,134
Europe,Sweden,10183175,2020-04-12,466,17,10151,887,0.9968403764051977,0.08738055364003547,33,134
Europe,Sweden,10183175,2020-04-13,332,12,10483,899,1.0294431746483783,0.0857578937327101,34,134
Europe,Sweden,10183175,2020-04-14,465,20,10948,919,1.0751067324287364,0.08394227256119839,35,134
Europe,Sweden,10183175,2020-04-15,497,114,11445,1033,1.1239127285939798,0.09025775447793796,36,134
Europe,Sweden,10183175,2020-04-16,482,170,11927,1203,1.1712457067663082,0.10086358681982058,37,134
Europe,Sweden,10183175,2020-04-17,613,130,12540,1333,1.231443042076759,0.10629984051036682,38,134
Europe,Sweden,10183175,2020-04-18,676,67,13216,1400,1.2978270529574518,0.1059322033898305,39,134
Europe,Sweden,10183175,2020-04-19,606,111,13822,1511,1.3573369798712092,0.10931847778903198,40,134
Europe,Sweden,10183175,2020-04-20,563,29,14385,1540,1.4126242552052775,0.1070559610705596,41,134
Europe,Sweden,10183175,2020-04-21,392,40,14777,1580,1.451119125420117,0.10692292075522772,42,134
Europe,Sweden,10183175,2020-04-22,545,185,15322,1765,1.5046387791626874,0.11519383892442239,43,134
Europe,Sweden,10183175,2020-04-23,682,172,16004,1937,1.5716119972405462,0.12103224193951512,44,134
Europe,Sweden,10183175,2020-04-24,751,84,16755,2021,1.645361098085813,0.12062071023575052,45,134
Europe,Sweden,10183175,2020-04-25,812,131,17567,2152,1.725100472102267,0.12250241930893152,46,134
Europe,Sweden,10183175,2020-04-26,610,40,18177,2192,1.7850032038141348,0.12059195686857017,47,134
Europe,Sweden,10183175,2020-04-27,463,2,18640,2194,1.8304703591954377,0.11770386266094421,48,134
Europe,Sweden,10183175,2020-04-28,286,80,18926,2274,1.8585559022603462,0.12015217161576668,49,134
Europe,Sweden,10183175,2020-04-29,695,81,19621,2355,1.9268057359320643,0.12002446358493452,50,134
Europe,Sweden,10183175,2020-04-30,681,107,20302,2462,1.9936807528103955,0.1212688405083243,51,134
Europe,Sweden,10183175,2020-05-01,790,124,21092,2586,2.071259700437241,0.12260572728996776,52,134
Europe,Sweden,10183175,2020-05-02,428,67,21520,2653,2.113289813835076,0.12328066914498141,53,134
Europe,Sweden,10183175,2020-05-03,562,16,22082,2669,2.1684788879696164,0.12086767502943574,54,134
Europe,Sweden,10183175,2020-05-04,235,10,22317,2679,2.191556169858615,0.12004301653448043,55,134
Europe,Sweden,10183175,2020-05-05,404,90,22721,2769,2.2312294544677864,0.1218696360195414,56,134
Europe,Sweden,10183175,2020-05-06,495,85,23216,2854,2.279839048233974,0.12293246037215713,57,134
Europe,Sweden,10183175,2020-05-07,702,87,23918,2941,2.348776290302386,0.12296178610251693,58,134
Europe,Sweden,10183175,2020-05-08,705,99,24623,3040,2.418008135969381,0.12346180400438614,59,134
Europe,Sweden,10183175,2020-05-09,642,135,25265,3175,2.481053306066134,0.12566792004749652,60,134
Europe,Sweden,10183175,2020-05-10,656,45,25921,3220,2.5454732929562733,0.12422360248447205,61,134
Europe,Sweden,10183175,2020-05-11,401,5,26322,3225,2.584851973966862,0.12252108502393436,62,134
Europe,Sweden,10183175,2020-05-12,348,31,26670,3256,2.619025991402485,0.12208473940757406,63,134
Europe,Sweden,10183175,2020-05-13,602,57,27272,3313,2.6781431135181317,0.12147990613083015,64,134
Europe,Sweden,10183175,2020-05-14,637,147,27909,3460,2.7406972776172465,0.12397434519330681,65,134
Europe,Sweden,10183175,2020-05-15,673,69,28582,3529,2.8067866848993557,0.12346931635294942,66,134
Europe,Sweden,10183175,2020-05-16,625,117,29207,3646,2.8681624346041388,0.12483308795836615,67,134
Europe,Sweden,10183175,2020-05-17,470,28,29677,3674,2.9143169983821355,0.12379957542878323,68,134
Europe,Sweden,10183175,2020-05-18,466,5,30143,3679,2.9600787573620213,0.1220515542580367,69,134
Europe,Sweden,10183175,2020-05-19,234,19,30377,3698,2.983057838051492,0.12173684037265035,70,134
Europe,Sweden,10183175,2020-05-20,422,45,30799,3743,3.024498744252161,0.121529919802591,71,134
Europe,Sweden,10183175,2020-05-21,724,88,31523,3831,3.095596412710181,0.12153031120134505,72,134
Europe,Sweden,10183175,2020-05-22,649,40,32172,3871,3.1593289912036275,0.12032201914708442,73,134
Europe,Sweden,10183175,2020-05-23,637,54,32809,3925,3.2218831553027423,0.11963180834527111,74,134
Europe,Sweden,10183175,2020-05-24,379,67,33188,3992,3.259101409923722,0.12028444015909365,75,134
Europe,Sweden,10183175,2020-05-25,271,6,33459,3998,3.285713934995716,0.11948952449266266,76,134
Europe,Sweden,10183175,2020-05-26,384,31,33843,4029,3.3234231956143345,0.1190497296338977,77,134
Europe,Sweden,10183175,2020-05-27,597,96,34440,4125,3.382049311732343,0.11977351916376307,78,134
Europe,Switzerland,8516543,2020-03-07,122,0,209,1,0.024540473757955546,0.004784688995215311,0,135
Europe,Switzerland,8516543,2020-03-08,55,0,264,1,0.030998493167943852,0.003787878787878788,1,135
Europe,Switzerland,8516543,2020-03-09,68,1,332,2,0.03898295352938393,0.006024096385542169,2,135
Europe,Switzerland,8516543,2020-03-10,42,0,374,2,0.043914531987920453,0.0053475935828877,3,135
Europe,Switzerland,8516543,2020-03-11,116,1,490,3,0.05753508201625942,0.006122448979591836,4,135
Europe,Switzerland,8516543,2020-03-12,152,1,642,4,0.07538269929477254,0.006230529595015576,5,135
Europe,Switzerland,8516543,2020-03-13,212,0,854,4,0.10027542865690926,0.00468384074941452,6,135
Europe,Switzerland,8516543,2020-03-14,267,3,1121,7,0.1316261774290343,0.006244424620874219,7,135
Europe,Switzerland,8516543,2020-03-15,238,4,1359,11,0.15957178869407457,0.008094186902133923,8,135
Europe,Switzerland,8516543,2020-03-16,841,2,2200,13,0.25832077639953205,0.005909090909090909,9,135
Europe,Switzerland,8516543,2020-03-17,0,1,2200,14,0.25832077639953205,0.006363636363636364,10,135
Europe,Switzerland,8516543,2020-03-18,450,5,2650,19,0.31115911702670906,0.007169811320754717,11,135
Europe,Switzerland,8516543,2020-03-19,360,2,3010,21,0.3534297895284507,0.0069767441860465115,12,135
Europe,Switzerland,8516543,2020-03-20,878,12,3888,33,0.4565232630188094,0.008487654320987654,13,135
Europe,Switzerland,8516543,2020-03-21,952,10,4840,43,0.5683057080789705,0.008884297520661158,14,135
Europe,Switzerland,8516543,2020-03-22,1237,13,6077,56,0.7135524355363437,0.009215073226921179,15,135
Europe,Switzerland,8516543,2020-03-23,894,4,6971,60,0.8185246055823354,0.008607086501219337,16,135
Europe,Switzerland,8516543,2020-03-24,1044,6,8015,66,0.9411095558373861,0.008234560199625702,17,135
Europe,Switzerland,8516543,2020-03-25,774,20,8789,86,1.0319915017161305,0.009784958470815792,18,135
Europe,Switzerland,8516543,2020-03-26,925,17,9714,103,1.1406036463386613,0.010603253036854025,19,135
Europe,Switzerland,8516543,2020-03-27,1000,58,10714,161,1.258022181065721,0.015027067388463692,20,135
Europe,Switzerland,8516543,2020-03-28,1390,36,12104,197,1.4212339443363347,0.01627561136814276,21,135
Europe,Switzerland,8516543,2020-03-29,1048,38,13152,235,1.5442885687302936,0.017868004866180048,22,135
Europe,Switzerland,8516543,2020-03-30,1122,22,14274,257,1.6760321646940548,0.01800476390640325,23,135
Europe,Switzerland,8516543,2020-03-31,1138,38,15412,295,1.8096544572134492,0.019140929146119905,24,135
Europe,Switzerland,8516543,2020-04-01,696,78,16108,373,1.8913777573834831,0.02315619567916563,25,135
Europe,Switzerland,8516543,2020-04-02,962,5,17070,378,2.004334387790915,0.022144112478031636,26,135
Europe,Switzerland,8516543,2020-04-03,1124,54,18194,432,2.13631282082413,0.023744091458722656,27,135
Europe,Switzerland,8516543,2020-04-04,1033,52,19227,484,2.257606167197183,0.02517293389504343,28,135
Europe,Switzerland,8516543,2020-04-05,974,56,20201,540,2.3719718200213395,0.026731349933171625,29,135
Europe,Switzerland,8516543,2020-04-06,821,19,21022,559,2.4683724370322557,0.026591190181714394,30,135
Europe,Switzerland,8516543,2020-04-07,552,25,21574,584,2.533187468201593,0.027069620839899878,31,135
Europe,Switzerland,8516543,2020-04-08,590,57,22164,641,2.6024644036905586,0.028920772423750227,32,135
Europe,Switzerland,8516543,2020-04-09,546,64,22710,705,2.6665749236515333,0.031043593130779392,33,135
Europe,Switzerland,8516543,2020-04-10,785,51,23495,756,2.7587484734122754,0.03217705894871249,34,135
Europe,Switzerland,8516543,2020-04-11,733,49,24228,805,2.8448162593672106,0.03322601948159155,35,135
Europe,Switzerland,8516543,2020-04-12,592,26,24820,831,2.91432803192563,0.03348106365834005,36,135
Europe,Switzerland,8516543,2020-04-13,400,27,25220,858,2.961295445816454,0.03402061855670103,37,135
Europe,Switzerland,8516543,2020-04-14,279,0,25499,858,2.994055217005304,0.033648378367779126,38,135
Europe,Switzerland,8516543,2020-04-15,254,42,25753,900,3.023879524825977,0.03494738477070632,39,135
Europe,Switzerland,8516543,2020-04-16,583,73,26336,973,3.092334530571853,0.03694562575941677,40,135
Europe,Switzerland,8516543,2020-04-17,315,43,26651,1016,3.129321369010877,0.03812239690818356,41,135
Europe,Switzerland,8516543,2020-04-18,346,42,26997,1058,3.1699481820264395,0.03918953957847168,42,135
Europe,Switzerland,8516543,2020-04-19,325,52,27322,1110,3.2081092058127343,0.040626601273698854,43,135
Europe,Switzerland,8516543,2020-04-20,336,24,27658,1134,3.247561833481026,0.041000795429893704,44,135
Europe,Switzerland,8516543,2020-04-21,168,7,27826,1141,3.2672881473151723,0.041004815640048875,45,135
Europe,Switzerland,8516543,2020-04-22,155,45,27981,1186,3.285488020197867,0.04238590472106072,46,135
Europe,Switzerland,8516543,2020-04-23,205,30,28186,1216,3.309558819816914,0.04314198538281416,47,135
Europe,Switzerland,8516543,2020-04-24,228,51,28414,1267,3.3363302457346835,0.04459069472795101,48,135
Europe,Switzerland,8516543,2020-04-25,181,41,28595,1308,3.3575830005202816,0.04574226263332751,49,135
Europe,Switzerland,8516543,2020-04-26,216,20,28811,1328,3.3829454040213265,0.04609350595258755,50,135
Europe,Switzerland,8516543,2020-04-27,167,8,28978,1336,3.402554299320746,0.04610394092069846,51,135
Europe,Switzerland,8516543,2020-04-28,103,16,29081,1352,3.4146484083976327,0.0464908359409924,52,135
Europe,Switzerland,8516543,2020-04-29,100,27,29181,1379,3.426390261870339,0.047256776669750866,53,135
Europe,Switzerland,8516543,2020-04-30,143,28,29324,1407,3.4431811123363083,0.047981175828672756,54,135
Europe,Switzerland,8516543,2020-05-01,179,15,29503,1422,3.4641990300524523,0.04819848828932651,55,135
Europe,Switzerland,8516543,2020-05-02,119,12,29622,1434,3.478171835684972,0.04840996556613328,56,135
Europe,Switzerland,8516543,2020-05-03,112,32,29734,1466,3.4913227115744028,0.0493038272684469,57,135
Europe,Switzerland,8516543,2020-05-04,88,6,29822,1472,3.501655542630384,0.04935953323050097,58,135
Europe,Switzerland,8516543,2020-05-05,76,4,29898,1476,3.510579351269641,0.049367850692354005,59,135
Europe,Switzerland,8516543,2020-05-06,28,6,29926,1482,3.5138670702419983,0.04952215464813206,60,135
Europe,Switzerland,8516543,2020-05-07,51,22,29977,1504,3.5198554155130783,0.05017179837875705,61,135
Europe,Switzerland,8516543,2020-05-08,66,13,30043,1517,3.5276050388050644,0.050494291515494456,62,135
Europe,Switzerland,8516543,2020-05-09,81,8,30124,1525,3.537115940117956,0.05062408710662595,63,135
Europe,Switzerland,8516543,2020-05-10,44,6,30168,1531,3.542282355645947,0.05074913815963935,64,135
Europe,Switzerland,8516543,2020-05-11,54,6,30222,1537,3.548622956521208,0.05085699159552644,65,135
Europe,Switzerland,8516543,2020-05-12,39,5,30261,1542,3.5532022793755638,0.05095667691087538,66,135
Europe,Switzerland,8516543,2020-05-13,36,18,30297,1560,3.557429346625738,0.051490246559065256,67,135
Europe,Switzerland,8516543,2020-05-14,33,3,30330,1563,3.5613041582717306,0.05153313550939664,68,135
Europe,Switzerland,8516543,2020-05-15,50,25,30380,1588,3.5671750850080834,0.05227123107307439,69,135
Europe,Switzerland,8516543,2020-05-16,51,6,30431,1594,3.5731634302791635,0.052380795898918864,70,135
Europe,Switzerland,8516543,2020-05-17,58,7,30489,1601,3.579973705293333,0.052510741578930105,71,135
Europe,Switzerland,8516543,2020-05-18,15,1,30504,1602,3.581734983314239,0.052517702596380805,72,135
Europe,Switzerland,8516543,2020-05-19,10,0,30514,1602,3.5829091686615095,0.0525004915776365,73,135
Europe,Switzerland,8516543,2020-05-20,21,11,30535,1613,3.585374957890778,0.05282462747666612,74,135
Europe,Switzerland,8516543,2020-05-21,40,16,30575,1629,3.5900716992798603,0.05327882256745707,75,135
Europe,Switzerland,8516543,2020-05-22,36,8,30611,1637,3.5942987665300343,0.053477508085328807,76,135
Europe,Switzerland,8516543,2020-05-23,13,0,30624,1637,3.5958252074814863,0.05345480668756531,77,135
Europe,Switzerland,8516543,2020-05-24,18,4,30642,1641,3.5979387411065735,0.05355394556491091,78,135
Europe,Switzerland,8516543,2020-05-25,11,0,30653,1641,3.5992303449885714,0.053534727432877696,79,135
Europe,Switzerland,8516543,2020-05-26,10,0,30663,1641,3.6004045303358416,0.05351726836904412,80,135
Europe,Switzerland,8516543,2020-05-27,15,6,30678,1647,3.6021658083567476,0.05368668100919226,81,135
Asia,Tajikistan,9100837,2020-05-05,154,1,230,3,0.02527240076929188,0.013043478260869565,0,136
Asia,Tajikistan,9100837,2020-05-06,63,2,293,5,0.032194840980010964,0.017064846416382253,1,136
Asia,Tajikistan,9100837,2020-05-07,86,3,379,8,0.041644521267659225,0.021108179419525065,2,136
Asia,Tajikistan,9100837,2020-05-08,82,4,461,12,0.0506546815419285,0.026030368763557483,3,136
Asia,Tajikistan,9100837,2020-05-09,61,0,522,12,0.05735736174595809,0.022988505747126436,4,136
Asia,Tajikistan,9100837,2020-05-10,90,8,612,20,0.06724656204698536,0.032679738562091505,5,136
Asia,Tajikistan,9100837,2020-05-11,0,0,612,20,0.06724656204698536,0.032679738562091505,6,136
Asia,Tajikistan,9100837,2020-05-12,49,1,661,21,0.07263068221087797,0.03177004538577912,7,136
Asia,Tajikistan,9100837,2020-05-13,68,2,729,23,0.08010252243832078,0.03155006858710562,8,136
Asia,Tajikistan,9100837,2020-05-14,72,0,801,23,0.08801388267914259,0.02871410736579276,9,136
Asia,Tajikistan,9100837,2020-05-15,106,6,907,29,0.0996611630336858,0.03197353914002205,10,136
Asia,Tajikistan,9100837,2020-05-16,211,4,1118,33,0.12284584373942747,0.029516994633273702,11,136
Asia,Tajikistan,9100837,2020-05-17,204,3,1322,36,0.14526136442175594,0.02723146747352496,12,136
Asia,Tajikistan,9100837,2020-05-18,202,3,1524,39,0.16745712509739488,0.025590551181102362,13,136
Asia,Tajikistan,9100837,2020-05-19,205,2,1729,41,0.1899825257830681,0.02371312897628687,14,136
Asia,Tajikistan,9100837,2020-05-20,0,0,1729,41,0.1899825257830681,0.02371312897628687,15,136
Asia,Tajikistan,9100837,2020-05-21,207,3,1936,44,0.21272768647543078,0.022727272727272728,16,136
Asia,Tajikistan,9100837,2020-05-22,204,0,2140,44,0.23514320715775924,0.020560747663551402,17,136
Asia,Tajikistan,9100837,2020-05-23,210,0,2350,44,0.25821800786015614,0.01872340425531915,18,136
Asia,Tajikistan,9100837,2020-05-24,201,0,2551,44,0.2803038885324504,0.01724813798510388,19,136
Asia,Tajikistan,9100837,2020-05-25,187,0,2738,44,0.3008514491579181,0.016070124178232285,20,136
Asia,Tajikistan,9100837,2020-05-26,362,2,3100,46,0.3406280103687166,0.014838709677419355,21,136
Asia,Tajikistan,9100837,2020-05-27,0,0,3100,46,0.3406280103687166,0.014838709677419355,22,136
Asia,Thailand,69428524,2020-03-31,263,3,1651,10,0.023779851635618816,0.0060569351907934586,0,137
Asia,Thailand,69428524,2020-04-01,0,0,1651,10,0.023779851635618816,0.0060569351907934586,1,137
Asia,Thailand,69428524,2020-04-02,120,2,1771,12,0.025508247878062336,0.006775832862789385,2,137
Asia,Thailand,69428524,2020-04-03,104,3,1875,15,0.02700619128818006,0.008,3,137
Asia,Thailand,69428524,2020-04-04,103,4,1978,19,0.028489731396277414,0.009605662285136502,4,137
Asia,Thailand,69428524,2020-04-05,191,4,2169,23,0.031240762082166692,0.010603964960811434,5,137
Asia,Thailand,69428524,2020-04-06,51,3,2220,26,0.031975330485205185,0.011711711711711712,6,137
Asia,Thailand,69428524,2020-04-07,38,0,2258,26,0.032522655961978966,0.011514614703277236,7,137
Asia,Thailand,69428524,2020-04-08,111,4,2369,30,0.03412142248623923,0.01266357112705783,8,137
Asia,Thailand,69428524,2020-04-09,54,2,2423,32,0.034899200795338814,0.013206768468840282,9,137
Asia,Thailand,69428524,2020-04-10,50,1,2473,33,0.03561936589635695,0.01334411645774363,10,137
Asia,Thailand,69428524,2020-04-11,45,2,2518,35,0.03626751448727327,0.013899920571882446,11,137
Asia,Thailand,69428524,2020-04-12,33,3,2551,38,0.036742823453945236,0.014896119168953352,12,137
Asia,Thailand,69428524,2020-04-13,28,2,2579,40,0.0371461159105154,0.015509887553315239,13,137
Asia,Thailand,69428524,2020-04-14,34,1,2613,41,0.03763582817920773,0.015690776884806735,14,137
Asia,Thailand,69428524,2020-04-15,30,2,2643,43,0.03806792723981861,0.016269390843738175,15,137
Asia,Thailand,69428524,2020-04-16,29,3,2672,46,0.03848562299840913,0.01721556886227545,16,137
Asia,Thailand,69428524,2020-04-17,28,1,2700,47,0.03888891545497928,0.017407407407407406,17,137
Asia,Thailand,69428524,2020-04-18,0,0,2700,47,0.03888891545497928,0.017407407407407406,18,137
Asia,Thailand,69428524,2020-04-19,33,0,2733,47,0.03936422442165125,0.017197219173069888,19,137
Asia,Thailand,69428524,2020-04-20,32,0,2765,47,0.03982513008630286,0.016998191681735986,20,137
Asia,Thailand,69428524,2020-04-21,27,0,2792,47,0.04021401924085265,0.01683381088825215,21,137
Asia,Thailand,69428524,2020-04-22,19,1,2811,48,0.04048768197923954,0.017075773745997867,22,137
Asia,Thailand,69428524,2020-04-23,28,2,2839,50,0.0408909744358097,0.017611835153222965,23,137
Asia,Thailand,69428524,2020-04-24,0,0,2839,50,0.0408909744358097,0.017611835153222965,24,137
Asia,Thailand,69428524,2020-04-25,15,0,2854,50,0.04110702396611513,0.01751927119831815,25,137
Asia,Thailand,69428524,2020-04-26,68,1,2922,51,0.042086448503499796,0.017453798767967144,26,137
Asia,Thailand,69428524,2020-04-27,0,0,2922,51,0.042086448503499796,0.017453798767967144,27,137
Asia,Thailand,69428524,2020-04-28,16,3,2938,54,0.0423169013358256,0.018379850238257316,28,137
Asia,Thailand,69428524,2020-04-29,0,0,2938,54,0.0423169013358256,0.018379850238257316,29,137
Asia,Thailand,69428524,2020-04-30,16,0,2954,54,0.042547354168151405,0.01828029790115098,30,137
Asia,Thailand,69428524,2020-05-01,6,0,2960,54,0.042633773980273584,0.018243243243243244,31,137
Asia,Thailand,69428524,2020-05-02,0,0,2960,54,0.042633773980273584,0.018243243243243244,32,137
Asia,Thailand,69428524,2020-05-03,6,0,2966,54,0.04272019379239576,0.01820633850303439,33,137
Asia,Thailand,69428524,2020-05-04,3,0,2969,54,0.042763403698456846,0.018187942068036377,34,137
Asia,Thailand,69428524,2020-05-05,18,0,2987,54,0.04302266313482338,0.018078339471041177,35,137
Asia,Thailand,69428524,2020-05-06,1,0,2988,54,0.04303706643684374,0.018072289156626505,36,137
Asia,Thailand,69428524,2020-05-07,1,1,2989,55,0.043051469738864104,0.01840080294412847,37,137
Asia,Thailand,69428524,2020-05-08,3,0,2992,55,0.043094679644925186,0.01838235294117647,38,137
Asia,Thailand,69428524,2020-05-09,8,0,3000,55,0.043209906061088085,0.018333333333333333,39,137
Asia,Thailand,69428524,2020-05-10,4,1,3004,56,0.043267519269169545,0.018641810918774968,40,137
Asia,Thailand,69428524,2020-05-11,11,0,3015,56,0.04342595559139353,0.01857379767827529,41,137
Asia,Thailand,69428524,2020-05-12,0,0,3015,56,0.04342595559139353,0.01857379767827529,42,137
Asia,Thailand,69428524,2020-05-13,2,0,3017,56,0.04345476219543426,0.018561484918793503,43,137
Asia,Thailand,69428524,2020-05-14,0,0,3017,56,0.04345476219543426,0.018561484918793503,44,137
Asia,Thailand,69428524,2020-05-15,1,0,3018,56,0.04346916549745462,0.01855533465871438,45,137
Asia,Thailand,69428524,2020-05-16,7,0,3025,56,0.04356998861159716,0.018512396694214877,46,137
Asia,Thailand,69428524,2020-05-17,3,0,3028,56,0.04361319851765825,0.018494055482166448,47,137
Asia,Thailand,69428524,2020-05-18,0,0,3028,56,0.04361319851765825,0.018494055482166448,48,137
Asia,Thailand,69428524,2020-05-19,3,0,3031,56,0.04365640842371933,0.018475750577367205,49,137
Asia,Thailand,69428524,2020-05-20,3,0,3034,56,0.04369961832978042,0.01845748187211602,50,137
Asia,Thailand,69428524,2020-05-21,0,0,3034,56,0.04369961832978042,0.01845748187211602,51,137
Asia,Thailand,69428524,2020-05-22,3,0,3037,56,0.04374282823584151,0.018439249259137307,52,137
Asia,Thailand,69428524,2020-05-23,3,0,3040,56,0.0437860381419026,0.018421052631578946,53,137
Asia,Thailand,69428524,2020-05-24,0,0,3040,56,0.0437860381419026,0.018421052631578946,54,137
Asia,Thailand,69428524,2020-05-25,2,1,3042,57,0.04381484474594333,0.01873767258382643,55,137
Asia,Thailand,69428524,2020-05-26,0,0,3042,57,0.04381484474594333,0.01873767258382643,56,137
Asia,Thailand,69428524,2020-05-27,3,0,3045,57,0.04385805465200441,0.0187192118226601,57,137
Africa,Togo,7889094,2020-05-11,21,1,174,11,0.022055764578289977,0.06321839080459771,0,138
Africa,Togo,7889094,2020-05-12,7,0,181,11,0.022943065452129232,0.06077348066298342,1,138
Africa,Togo,7889094,2020-05-13,18,0,199,11,0.02522469627057302,0.05527638190954774,2,138
Africa,Togo,7889094,2020-05-14,20,0,219,11,0.027759841624399456,0.0502283105022831,3,138
Africa,Togo,7889094,2020-05-15,19,0,238,11,0.03016822971053457,0.046218487394957986,4,138
Africa,Togo,7889094,2020-05-16,25,0,263,11,0.03333716140281762,0.04182509505703422,5,138
Africa,Togo,7889094,2020-05-17,35,0,298,11,0.037773665772013874,0.03691275167785235,6,138
Africa,Togo,7889094,2020-05-18,3,0,301,11,0.03815393757508784,0.036544850498338874,7,138
Africa,Togo,7889094,2020-05-19,29,1,330,12,0.04182989833813617,0.03636363636363636,8,138
Africa,Togo,7889094,2020-05-20,8,0,338,12,0.04284395647966674,0.03550295857988166,9,138
Africa,Togo,7889094,2020-05-21,2,0,340,12,0.043097471015049384,0.03529411764705882,10,138
Africa,Togo,7889094,2020-05-22,14,0,354,12,0.044872072762727894,0.03389830508474576,11,138
Africa,Togo,7889094,2020-05-23,9,0,363,12,0.04601288817194978,0.03305785123966942,12,138
Africa,Togo,7889094,2020-05-24,10,0,373,12,0.047280460848863,0.032171581769437,13,138
Africa,Togo,7889094,2020-05-25,8,0,381,12,0.04829451899039357,0.031496062992125984,14,138
Africa,Togo,7889094,2020-05-26,5,1,386,13,0.04892830532885019,0.03367875647668394,15,138
Africa,Togo,7889094,2020-05-27,5,0,391,13,0.049562091667306796,0.03324808184143223,16,138
America,Trinidad And Tobago,1389858,2020-03-22,40,0,49,0,0.03525540019196206,0,0,139
America,Trinidad And Tobago,1389858,2020-03-23,1,0,50,0,0.03597489815506332,0,1,139
America,Trinidad And Tobago,1389858,2020-03-24,1,0,51,0,0.036694396118164586,0,2,139
America,Trinidad And Tobago,1389858,2020-03-25,6,0,57,0,0.04101138389677219,0,3,139
America,Trinidad And Tobago,1389858,2020-03-26,3,1,60,1,0.04316987778607599,0.016666666666666666,4,139
America,Trinidad And Tobago,1389858,2020-03-27,5,0,65,1,0.04676736760158232,0.015384615384615385,5,139
America,Trinidad And Tobago,1389858,2020-03-28,1,1,66,2,0.04748686556468359,0.030303030303030304,6,139
America,Trinidad And Tobago,1389858,2020-03-29,8,0,74,2,0.053242849269493714,0.02702702702702703,7,139
America,Trinidad And Tobago,1389858,2020-03-30,4,1,78,3,0.05612084112189879,0.038461538461538464,8,139
America,Trinidad And Tobago,1389858,2020-03-31,7,0,85,3,0.06115732686360764,0.03529411764705882,9,139
America,Trinidad And Tobago,1389858,2020-04-01,2,0,87,3,0.06259632278981017,0.034482758620689655,10,139
America,Trinidad And Tobago,1389858,2020-04-02,2,2,89,5,0.06403531871601272,0.056179775280898875,11,139
America,Trinidad And Tobago,1389858,2020-04-03,8,1,97,6,0.06979130242082285,0.061855670103092786,12,139
America,Trinidad And Tobago,1389858,2020-04-04,3,0,100,6,0.07194979631012664,0.06,13,139
America,Trinidad And Tobago,1389858,2020-04-05,3,0,103,6,0.07410829019943045,0.05825242718446602,14,139
America,Trinidad And Tobago,1389858,2020-04-06,1,1,104,7,0.0748277881625317,0.0673076923076923,15,139
America,Trinidad And Tobago,1389858,2020-04-07,1,1,105,8,0.07554728612563298,0.0761904761904762,16,139
America,Trinidad And Tobago,1389858,2020-04-08,2,0,107,8,0.07698628205183551,0.07476635514018691,17,139
America,Trinidad And Tobago,1389858,2020-04-09,0,0,107,8,0.07698628205183551,0.07476635514018691,18,139
America,Trinidad And Tobago,1389858,2020-04-10,2,0,109,8,0.07842527797803804,0.07339449541284404,19,139
America,Trinidad And Tobago,1389858,2020-04-11,0,0,109,8,0.07842527797803804,0.07339449541284404,20,139
America,Trinidad And Tobago,1389858,2020-04-12,3,0,112,8,0.08058377186734185,0.07142857142857142,21,139
America,Trinidad And Tobago,1389858,2020-04-13,1,0,113,8,0.08130326983044311,0.07079646017699115,22,139
America,Trinidad And Tobago,1389858,2020-04-14,0,0,113,8,0.08130326983044311,0.07079646017699115,23,139
America,Trinidad And Tobago,1389858,2020-04-15,0,0,113,8,0.08130326983044311,0.07079646017699115,24,139
America,Trinidad And Tobago,1389858,2020-04-16,1,0,114,8,0.08202276779354438,0.07017543859649122,25,139
America,Trinidad And Tobago,1389858,2020-04-17,0,0,114,8,0.08202276779354438,0.07017543859649122,26,139
America,Trinidad And Tobago,1389858,2020-04-18,0,0,114,8,0.08202276779354438,0.07017543859649122,27,139
America,Trinidad And Tobago,1389858,2020-04-19,0,0,114,8,0.08202276779354438,0.07017543859649122,28,139
America,Trinidad And Tobago,1389858,2020-04-20,0,0,114,8,0.08202276779354438,0.07017543859649122,29,139
America,Trinidad And Tobago,1389858,2020-04-21,0,0,114,8,0.08202276779354438,0.07017543859649122,30,139
America,Trinidad And Tobago,1389858,2020-04-22,1,0,115,8,0.08274226575664564,0.06956521739130435,31,139
America,Trinidad And Tobago,1389858,2020-04-23,0,0,115,8,0.08274226575664564,0.06956521739130435,32,139
America,Trinidad And Tobago,1389858,2020-04-24,0,0,115,8,0.08274226575664564,0.06956521739130435,33,139
America,Trinidad And Tobago,1389858,2020-04-25,0,0,115,8,0.08274226575664564,0.06956521739130435,34,139
America,Trinidad And Tobago,1389858,2020-04-26,0,0,115,8,0.08274226575664564,0.06956521739130435,35,139
America,Trinidad And Tobago,1389858,2020-04-27,1,0,116,8,0.08346176371974691,0.06896551724137931,36,139
America,Trinidad And Tobago,1389858,2020-04-28,0,0,116,8,0.08346176371974691,0.06896551724137931,37,139
America,Trinidad And Tobago,1389858,2020-04-29,0,0,116,8,0.08346176371974691,0.06896551724137931,38,139
America,Trinidad And Tobago,1389858,2020-04-30,0,0,116,8,0.08346176371974691,0.06896551724137931,39,139
America,Trinidad And Tobago,1389858,2020-05-01,0,0,116,8,0.08346176371974691,0.06896551724137931,40,139
America,Trinidad And Tobago,1389858,2020-05-02,0,0,116,8,0.08346176371974691,0.06896551724137931,41,139
America,Trinidad And Tobago,1389858,2020-05-03,0,0,116,8,0.08346176371974691,0.06896551724137931,42,139
America,Trinidad And Tobago,1389858,2020-05-04,0,0,116,8,0.08346176371974691,0.06896551724137931,43,139
America,Trinidad And Tobago,1389858,2020-05-05,0,0,116,8,0.08346176371974691,0.06896551724137931,44,139
America,Trinidad And Tobago,1389858,2020-05-06,0,0,116,8,0.08346176371974691,0.06896551724137931,45,139
America,Trinidad And Tobago,1389858,2020-05-07,0,0,116,8,0.08346176371974691,0.06896551724137931,46,139
America,Trinidad And Tobago,1389858,2020-05-08,0,0,116,8,0.08346176371974691,0.06896551724137931,47,139
America,Trinidad And Tobago,1389858,2020-05-09,0,0,116,8,0.08346176371974691,0.06896551724137931,48,139
America,Trinidad And Tobago,1389858,2020-05-10,0,0,116,8,0.08346176371974691,0.06896551724137931,49,139
America,Trinidad And Tobago,1389858,2020-05-11,0,0,116,8,0.08346176371974691,0.06896551724137931,50,139
America,Trinidad And Tobago,1389858,2020-05-12,0,0,116,8,0.08346176371974691,0.06896551724137931,51,139
America,Trinidad And Tobago,1389858,2020-05-13,0,0,116,8,0.08346176371974691,0.06896551724137931,52,139
America,Trinidad And Tobago,1389858,2020-05-14,0,0,116,8,0.08346176371974691,0.06896551724137931,53,139
America,Trinidad And Tobago,1389858,2020-05-15,0,0,116,8,0.08346176371974691,0.06896551724137931,54,139
America,Trinidad And Tobago,1389858,2020-05-16,0,0,116,8,0.08346176371974691,0.06896551724137931,55,139
America,Trinidad And Tobago,1389858,2020-05-17,0,0,116,8,0.08346176371974691,0.06896551724137931,56,139
America,Trinidad And Tobago,1389858,2020-05-18,0,0,116,8,0.08346176371974691,0.06896551724137931,57,139
America,Trinidad And Tobago,1389858,2020-05-19,0,0,116,8,0.08346176371974691,0.06896551724137931,58,139
America,Trinidad And Tobago,1389858,2020-05-20,0,0,116,8,0.08346176371974691,0.06896551724137931,59,139
America,Trinidad And Tobago,1389858,2020-05-21,0,0,116,8,0.08346176371974691,0.06896551724137931,60,139
America,Trinidad And Tobago,1389858,2020-05-22,0,0,116,8,0.08346176371974691,0.06896551724137931,61,139
America,Trinidad And Tobago,1389858,2020-05-23,0,0,116,8,0.08346176371974691,0.06896551724137931,62,139
America,Trinidad And Tobago,1389858,2020-05-24,0,0,116,8,0.08346176371974691,0.06896551724137931,63,139
America,Trinidad And Tobago,1389858,2020-05-25,0,0,116,8,0.08346176371974691,0.06896551724137931,64,139
America,Trinidad And Tobago,1389858,2020-05-26,0,0,116,8,0.08346176371974691,0.06896551724137931,65,139
America,Trinidad And Tobago,1389858,2020-05-27,0,0,116,8,0.08346176371974691,0.06896551724137931,66,139
Africa,Tunisia,11565204,2020-03-30,51,2,278,8,0.024037621817998196,0.02877697841726619,0,140
Africa,Tunisia,11565204,2020-03-31,34,0,312,8,0.026977474846098692,0.02564102564102564,1,140
Africa,Tunisia,11565204,2020-04-01,50,1,362,9,0.031300788122717076,0.024861878453038673,2,140
Africa,Tunisia,11565204,2020-04-02,32,1,394,10,0.03406770861975284,0.025380710659898477,3,140
Africa,Tunisia,11565204,2020-04-03,61,3,455,13,0.039342150817227264,0.02857142857142857,4,140
Africa,Tunisia,11565204,2020-04-04,0,0,455,13,0.039342150817227264,0.02857142857142857,5,140
Africa,Tunisia,11565204,2020-04-05,40,5,495,18,0.04280080143852197,0.03636363636363636,6,140
Africa,Tunisia,11565204,2020-04-06,58,1,553,19,0.04781584483939929,0.034358047016274866,7,140
Africa,Tunisia,11565204,2020-04-07,21,3,574,22,0.04963163641557901,0.03832752613240418,8,140
Africa,Tunisia,11565204,2020-04-08,22,0,596,22,0.051533894257291095,0.03691275167785235,9,140
Africa,Tunisia,11565204,2020-04-09,27,1,623,23,0.05386848342666502,0.03691813804173355,10,140
Africa,Tunisia,11565204,2020-04-10,20,2,643,25,0.05559780873731237,0.038880248833592534,11,140
Africa,Tunisia,11565204,2020-04-11,28,0,671,25,0.058018864172218666,0.037257824143070044,12,140
Africa,Tunisia,11565204,2020-04-12,14,3,685,28,0.059229391889671815,0.040875912408759124,13,140
Africa,Tunisia,11565204,2020-04-13,22,3,707,31,0.061131649731383894,0.04384724186704385,14,140
Africa,Tunisia,11565204,2020-04-14,19,3,726,34,0.06277450877649889,0.046831955922865015,15,140
Africa,Tunisia,11565204,2020-04-15,21,0,747,34,0.0645903003526786,0.04551539491298527,16,140
Africa,Tunisia,11565204,2020-04-16,33,1,780,35,0.06744368711524673,0.04487179487179487,17,140
Africa,Tunisia,11565204,2020-04-17,42,2,822,37,0.07107527026760618,0.045012165450121655,18,140
Africa,Tunisia,11565204,2020-04-18,42,0,864,37,0.07470685341996561,0.04282407407407408,19,140
Africa,Tunisia,11565204,2020-04-19,2,0,866,37,0.07487978595103034,0.042725173210161664,20,140
Africa,Tunisia,11565204,2020-04-20,13,1,879,38,0.07600384740295113,0.04323094425483504,21,140
Africa,Tunisia,11565204,2020-04-21,5,0,884,38,0.07643617873061297,0.042986425339366516,22,140
Africa,Tunisia,11565204,2020-04-22,17,0,901,38,0.07790610524466321,0.042175360710321866,23,140
Africa,Tunisia,11565204,2020-04-23,0,0,901,38,0.07790610524466321,0.042175360710321866,24,140
Africa,Tunisia,11565204,2020-04-24,17,0,918,38,0.07937603175871347,0.04139433551198257,25,140
Africa,Tunisia,11565204,2020-04-25,4,0,922,38,0.07972189682084294,0.04121475054229935,26,140
Africa,Tunisia,11565204,2020-04-26,17,0,939,38,0.08119182333489318,0.04046858359957402,27,140
Africa,Tunisia,11565204,2020-04-27,10,0,949,38,0.08205648599021687,0.040042149631190724,28,140
Africa,Tunisia,11565204,2020-04-28,18,1,967,39,0.08361287876979948,0.04033092037228542,29,140
Africa,Tunisia,11565204,2020-04-29,8,1,975,40,0.08430460889405843,0.041025641025641026,30,140
Africa,Tunisia,11565204,2020-04-30,5,0,980,40,0.08473694022172026,0.04081632653061224,31,140
Africa,Tunisia,11565204,2020-05-01,14,0,994,40,0.0859474679391734,0.04024144869215292,32,140
Africa,Tunisia,11565204,2020-05-02,4,1,998,41,0.08629333300130287,0.041082164328657314,33,140
Africa,Tunisia,11565204,2020-05-03,11,1,1009,42,0.08724446192215893,0.04162537165510406,34,140
Africa,Tunisia,11565204,2020-05-04,4,0,1013,42,0.0875903269842884,0.04146100691016782,35,140
Africa,Tunisia,11565204,2020-05-05,5,1,1018,43,0.08802265831195023,0.04223968565815324,36,140
Africa,Tunisia,11565204,2020-05-06,4,0,1022,43,0.0883685233740797,0.04207436399217221,37,140
Africa,Tunisia,11565204,2020-05-07,3,0,1025,43,0.08862792217067679,0.041951219512195125,38,140
Africa,Tunisia,11565204,2020-05-08,1,1,1026,44,0.08871438843620916,0.042884990253411304,39,140
Africa,Tunisia,11565204,2020-05-09,4,1,1030,45,0.08906025349833863,0.043689320388349516,40,140
Africa,Tunisia,11565204,2020-05-10,2,0,1032,45,0.08923318602940336,0.0436046511627907,41,140
Africa,Tunisia,11565204,2020-05-11,0,0,1032,45,0.08923318602940336,0.0436046511627907,42,140
Africa,Tunisia,11565204,2020-05-12,0,0,1032,45,0.08923318602940336,0.0436046511627907,43,140
Africa,Tunisia,11565204,2020-05-13,0,0,1032,45,0.08923318602940336,0.0436046511627907,44,140
Africa,Tunisia,11565204,2020-05-14,0,0,1032,45,0.08923318602940336,0.0436046511627907,45,140
Africa,Tunisia,11565204,2020-05-15,0,0,1032,45,0.08923318602940336,0.0436046511627907,46,140
Africa,Tunisia,11565204,2020-05-16,3,0,1035,45,0.08949258482600046,0.043478260869565216,47,140
Africa,Tunisia,11565204,2020-05-17,0,0,1035,45,0.08949258482600046,0.043478260869565216,48,140
Africa,Tunisia,11565204,2020-05-18,2,0,1037,45,0.08966551735706521,0.04339440694310511,49,140
Africa,Tunisia,11565204,2020-05-19,6,1,1043,46,0.09018431495025941,0.04410354745925216,50,140
Africa,Tunisia,11565204,2020-05-20,1,1,1044,47,0.09027078121579178,0.045019157088122604,51,140
Africa,Tunisia,11565204,2020-05-21,1,0,1045,47,0.09035724748132415,0.044976076555023926,52,140
Africa,Tunisia,11565204,2020-05-22,1,0,1046,47,0.09044371374685652,0.044933078393881457,53,140
Africa,Tunisia,11565204,2020-05-23,2,0,1048,47,0.09061664627792125,0.04484732824427481,54,140
Africa,Tunisia,11565204,2020-05-24,0,1,1048,48,0.09061664627792125,0.04580152671755725,55,140
Africa,Tunisia,11565204,2020-05-25,3,0,1051,48,0.09087604507451835,0.04567078972407231,56,140
Africa,Tunisia,11565204,2020-05-26,0,0,1051,48,0.09087604507451835,0.04567078972407231,57,140
Africa,Tunisia,11565204,2020-05-27,0,0,1051,48,0.09087604507451835,0.04567078972407231,58,140
Asia,Turkey,82319724,2020-03-25,343,7,1872,44,0.022740601025338716,0.023504273504273504,0,141
Asia,Turkey,82319724,2020-03-26,561,15,2433,59,0.029555492678765543,0.02424989724619811,1,141
Asia,Turkey,82319724,2020-03-27,1196,16,3629,75,0.044084210000509716,0.020666850372003307,2,141
Asia,Turkey,82319724,2020-03-28,2069,17,5698,92,0.06921791914657051,0.016146016146016146,3,141
Asia,Turkey,82319724,2020-03-29,1704,16,7402,108,0.08991769700296856,0.01459065117535801,4,141
Asia,Turkey,82319724,2020-03-30,1815,23,9217,131,0.11196587588170241,0.014212867527395031,5,141
Asia,Turkey,82319724,2020-03-31,1610,37,10827,168,0.13152376458405035,0.015516763646439457,6,141
Asia,Turkey,82319724,2020-04-01,2704,46,13531,214,0.1643712993984285,0.015815534698100656,7,141
Asia,Turkey,82319724,2020-04-02,2148,63,15679,277,0.19046468134416972,0.017666943044837045,8,141
Asia,Turkey,82319724,2020-04-03,2456,79,18135,356,0.2202995724329688,0.019630548662806727,9,141
Asia,Turkey,82319724,2020-04-04,2786,69,20921,425,0.2541432233179013,0.020314516514506956,10,141
Asia,Turkey,82319724,2020-04-05,3013,76,23934,501,0.2907444150322953,0.020932564552519427,11,141
Asia,Turkey,82319724,2020-04-06,3135,73,27069,574,0.32882763309556284,0.02120506852857512,12,141
Asia,Turkey,82319724,2020-04-07,3148,75,30217,649,0.36706877199928417,0.021477975973789587,13,141
Asia,Turkey,82319724,2020-04-08,3892,76,34109,725,0.4143478420797427,0.021255387141223724,14,141
Asia,Turkey,82319724,2020-04-09,4117,87,38226,812,0.4643601574757466,0.021242086537958456,15,141
Asia,Turkey,82319724,2020-04-10,4056,96,42282,908,0.5136314596973138,0.02147485927817984,16,141
Asia,Turkey,82319724,2020-04-11,4747,98,47029,1006,0.5712968619768453,0.021391056582108912,17,141
Asia,Turkey,82319724,2020-04-12,5138,95,52167,1101,0.6337120372269469,0.02110529645177986,18,141
Asia,Turkey,82319724,2020-04-13,4789,97,56956,1198,0.6918876452987136,0.021033780462111105,19,141
Asia,Turkey,82319724,2020-04-14,4093,98,61049,1296,0.7416084145277261,0.02122884895739488,20,141
Asia,Turkey,82319724,2020-04-15,4062,107,65111,1403,0.7909526032910412,0.02154781834098693,21,141
Asia,Turkey,82319724,2020-04-16,4281,115,69392,1518,0.8429571508281539,0.021875720544154945,22,141
Asia,Turkey,82319724,2020-04-17,4801,125,74193,1643,0.9012785319834162,0.02214494628873344,23,141
Asia,Turkey,82319724,2020-04-18,4353,126,78546,1769,0.9541577180215035,0.022521834339113384,24,141
Asia,Turkey,82319724,2020-04-19,3783,121,82329,1890,1.0001126825935422,0.02295667383303575,25,141
Asia,Turkey,82319724,2020-04-20,3977,127,86306,2017,1.0484243120154288,0.023370333464649038,26,141
Asia,Turkey,82319724,2020-04-21,4674,123,90980,2140,1.105202928037028,0.02352165311057375,27,141
Asia,Turkey,82319724,2020-04-22,4611,119,95591,2259,1.1612162353702742,0.02363193187643188,28,141
Asia,Turkey,82319724,2020-04-23,3083,117,98674,2376,1.1986677700717268,0.02407929140401727,29,141
Asia,Turkey,82319724,2020-04-24,3116,115,101790,2491,1.2365201807527926,0.024471952058158955,30,141
Asia,Turkey,82319724,2020-04-25,3122,109,104912,2600,1.2744454779756065,0.024782675003812718,31,141
Asia,Turkey,82319724,2020-04-26,2861,106,107773,2706,1.3092002106323875,0.02510832954450558,32,141
Asia,Turkey,82319724,2020-04-27,2357,99,110130,2805,1.3378324737823464,0.025469899210024516,33,141
Asia,Turkey,82319724,2020-04-28,2131,95,112261,2900,1.3637193438598019,0.025832657824177586,34,141
Asia,Turkey,82319724,2020-04-29,2392,92,114653,2992,1.3927767785032903,0.026096133550801114,35,141
Asia,Turkey,82319724,2020-04-30,2936,89,117589,3081,1.42844259293192,0.026201430405905314,36,141
Asia,Turkey,82319724,2020-05-01,2615,93,120204,3174,1.4602089773770377,0.026405111310771688,37,141
Asia,Turkey,82319724,2020-05-02,2188,84,122392,3258,1.4867882696010983,0.026619386888031896,38,141
Asia,Turkey,82319724,2020-05-03,1983,78,124375,3336,1.5108772716487728,0.02682211055276382,39,141
Asia,Turkey,82319724,2020-05-04,1670,61,126045,3397,1.5311640257685994,0.026950692213098495,40,141
Asia,Turkey,82319724,2020-05-05,1614,64,127659,3461,1.5507705054987793,0.02711128866746567,41,141
Asia,Turkey,82319724,2020-05-06,1832,59,129491,3520,1.5730251962457988,0.027183356372257533,42,141
Asia,Turkey,82319724,2020-05-07,2253,64,131744,3584,1.600394092672128,0.02720427495749332,43,141
Asia,Turkey,82319724,2020-05-08,1977,57,133721,3641,1.6244102081780547,0.02722833361999985,44,141
Asia,Turkey,82319724,2020-05-09,1848,48,135569,3689,1.6468592630364018,0.027211235606960295,45,141
Asia,Turkey,82319724,2020-05-10,1546,50,137115,3739,1.665639695293439,0.027269080698683588,46,141
Asia,Turkey,82319724,2020-05-11,1542,47,138657,3786,1.6843715365226444,0.027304788074168633,47,141
Asia,Turkey,82319724,2020-05-12,1114,55,139771,3841,1.697904137773834,0.02748066480171137,48,141
Asia,Turkey,82319724,2020-05-13,1704,53,141475,3894,1.7186039156302322,0.027524297579077577,49,141
Asia,Turkey,82319724,2020-05-14,1639,58,143114,3952,1.7385140892843616,0.027614349399779196,50,141
Asia,Turkey,82319724,2020-05-15,1635,55,144749,4007,1.758375671910659,0.02768240195096339,51,141
Asia,Turkey,82319724,2020-05-16,1708,48,146457,4055,1.779124040794889,0.027687307537365917,52,141
Asia,Turkey,82319724,2020-05-17,1610,41,148067,4096,1.798681929497237,0.027663152491777372,53,141
Asia,Turkey,82319724,2020-05-18,1368,44,149435,4140,1.8153000610157537,0.027704353063204738,54,141
Asia,Turkey,82319724,2020-05-19,1158,31,150593,4171,1.8293671635730946,0.02769717051921404,55,141
Asia,Turkey,82319724,2020-05-20,1022,28,151615,4199,1.8417821711841502,0.027695148896876957,56,141
Asia,Turkey,82319724,2020-05-21,972,23,152587,4222,1.853589790947307,0.02766946070110822,57,141
Asia,Turkey,82319724,2020-05-22,961,27,153548,4249,1.8652637853839258,0.027672128585198113,58,141
Asia,Turkey,82319724,2020-05-23,952,27,154500,4276,1.8768284500079226,0.027676375404530745,59,141
Asia,Turkey,82319724,2020-05-24,1186,32,155686,4308,1.8912356897600873,0.027671081535912027,60,141
Asia,Turkey,82319724,2020-05-25,1141,32,156827,4340,1.9050962804491425,0.027673806168580665,61,141
Asia,Turkey,82319724,2020-05-26,987,29,157814,4369,1.9170861165666688,0.02768448933554691,62,141
Asia,Turkey,82319724,2020-05-27,948,28,158762,4397,1.9286021901628339,0.02769554427381867,63,141
Europe,Ukraine,44622516,2020-04-04,183,3,987,23,0.0221188782810902,0.02330293819655522,0,142
Europe,Ukraine,44622516,2020-04-05,109,5,1096,28,0.02456159128275062,0.025547445255474453,1,142
Europe,Ukraine,44622516,2020-04-06,155,4,1251,32,0.028035173991533782,0.025579536370903277,2,142
Europe,Ukraine,44622516,2020-04-07,68,6,1319,38,0.02955906834119349,0.02880970432145565,3,142
Europe,Ukraine,44622516,2020-04-08,143,7,1462,45,0.03276372851768376,0.030779753761969904,4,142
Europe,Ukraine,44622516,2020-04-09,206,7,1668,52,0.03738023198871171,0.03117505995203837,5,142
Europe,Ukraine,44622516,2020-04-10,224,5,1892,57,0.04240011925817899,0.030126849894291756,6,142
Europe,Ukraine,44622516,2020-04-11,311,12,2203,69,0.04936969488676972,0.031320926009986386,7,142
Europe,Ukraine,44622516,2020-04-12,308,4,2511,73,0.05627203988228723,0.029072082835523694,8,142
Europe,Ukraine,44622516,2020-04-13,266,10,2777,83,0.06223315601477963,0.02988836874324811,9,142
Europe,Ukraine,44622516,2020-04-14,325,10,3102,93,0.06951647459771206,0.029980657640232108,10,142
Europe,Ukraine,44622516,2020-04-15,270,5,3372,98,0.07556723157430208,0.029062870699881376,11,142
Europe,Ukraine,44622516,2020-04-16,789,18,4161,116,0.09324888807255961,0.027877913962989664,12,142
Europe,Ukraine,44622516,2020-04-17,301,9,4462,125,0.09999436159090626,0.028014343343792023,13,142
Europe,Ukraine,44622516,2020-04-18,644,8,5106,133,0.11442653749062469,0.026047786917352135,14,142
Europe,Ukraine,44622516,2020-04-19,343,8,5449,141,0.12211323987199646,0.02587630757937236,15,142
Europe,Ukraine,44622516,2020-04-20,261,10,5710,151,0.12796230494936683,0.026444833625218916,16,142
Europe,Ukraine,44622516,2020-04-21,415,10,6125,161,0.13726254252449593,0.026285714285714287,17,142
Europe,Ukraine,44622516,2020-04-22,467,13,6592,174,0.14772811107289424,0.026395631067961164,18,142
Europe,Ukraine,44622516,2020-04-23,578,13,7170,187,0.16068121304500174,0.02608089260808926,19,142
Europe,Ukraine,44622516,2020-04-24,477,6,7647,193,0.17137088370364414,0.025238655681966784,20,142
Europe,Ukraine,44622516,2020-04-25,478,8,8125,201,0.1820829645733109,0.02473846153846154,21,142
Europe,Ukraine,44622516,2020-04-26,492,8,8617,209,0.19310878839731943,0.024254380875014508,22,142
Europe,Ukraine,44622516,2020-04-27,392,11,9009,220,0.20189359111888716,0.02442002442002442,23,142
Europe,Ukraine,44622516,2020-04-28,0,0,9009,220,0.20189359111888716,0.02442002442002442,24,142
Europe,Ukraine,44622516,2020-04-29,401,19,9410,239,0.21088008573967457,0.025398512221041444,25,142
Europe,Ukraine,44622516,2020-04-30,456,11,9866,250,0.22109914196680439,0.02533954996959254,26,142
Europe,Ukraine,44622516,2020-05-01,540,0,10406,250,0.23320065591998443,0.02402460119162022,27,142
Europe,Ukraine,44622516,2020-05-02,455,29,10861,279,0.24339730193608983,0.02568824233495995,28,142
Europe,Ukraine,44622516,2020-05-03,550,0,11411,279,0.25572291799951397,0.02445009201647533,29,142
Europe,Ukraine,44622516,2020-05-04,502,9,11913,288,0.2669728439337665,0.024175270712666834,30,142
Europe,Ukraine,44622516,2020-05-05,418,15,12331,303,0.27634031214196886,0.024572216365258293,31,142
Europe,Ukraine,44622516,2020-05-06,366,13,12697,316,0.284542449376902,0.024887768764275026,32,142
Europe,Ukraine,44622516,2020-05-07,487,11,13184,327,0.2954562221457885,0.02480279126213592,33,142
Europe,Ukraine,44622516,2020-05-08,507,13,13691,340,0.30681819913516306,0.02483383244467168,34,142
Europe,Ukraine,44622516,2020-05-09,504,21,14195,361,0.3181129454914644,0.025431489961253963,35,142
Europe,Ukraine,44622516,2020-05-10,515,15,14710,376,0.3296542041690343,0.025560842963970088,36,142
Europe,Ukraine,44622516,2020-05-11,522,15,15232,391,0.341352334323775,0.025669642857142856,37,142
Europe,Ukraine,44622516,2020-05-12,416,17,15648,408,0.35067498210992853,0.02607361963190184,38,142
Europe,Ukraine,44622516,2020-05-13,375,17,16023,425,0.3590788112440813,0.02652437121637646,39,142
Europe,Ukraine,44622516,2020-05-14,402,14,16425,439,0.36808771607589313,0.026727549467275496,40,142
Europe,Ukraine,44622516,2020-05-15,422,17,16847,456,0.37754482512819315,0.027067133614293346,41,142
Europe,Ukraine,44622516,2020-05-16,483,27,17330,483,0.38836895705298197,0.027870744373918063,42,142
Europe,Ukraine,44622516,2020-05-17,528,14,17858,497,0.40020154847386913,0.02783066412812185,43,142
Europe,Ukraine,44622516,2020-05-18,433,17,18291,514,0.4099051698474376,0.028101251981848995,44,142
Europe,Ukraine,44622516,2020-05-19,325,21,18616,535,0.41718848843037004,0.02873871938117748,45,142
Europe,Ukraine,44622516,2020-05-20,260,13,18876,548,0.42301514329671597,0.02903157448611994,46,142
Europe,Ukraine,44622516,2020-05-21,354,16,19230,564,0.4309483579993562,0.029329173166926677,47,142
Europe,Ukraine,44622516,2020-05-22,476,15,19706,579,0.44161561844697417,0.029381914137826044,48,142
Europe,Ukraine,44622516,2020-05-23,442,9,20148,588,0.45152093171976226,0.029184038117927337,49,142
Europe,Ukraine,44622516,2020-05-24,432,17,20580,605,0.4612021428823063,0.029397473275024295,50,142
Europe,Ukraine,44622516,2020-05-25,406,12,20986,617,0.4703006885582158,0.029400552749452014,51,142
Europe,Ukraine,44622516,2020-05-26,259,6,21245,623,0.4761049332135373,0.029324546952224053,52,142
Europe,Ukraine,44622516,2020-05-27,339,21,21584,644,0.48370199475081144,0.02983691623424759,53,142
Asia,United Arab Emirates,9630959,2020-03-24,45,0,198,2,0.020558700332957498,0.010101010101010102,0,143
Asia,United Arab Emirates,9630959,2020-03-25,50,0,248,2,0.02575029132612858,0.008064516129032258,1,143
Asia,United Arab Emirates,9630959,2020-03-26,85,0,333,2,0.034575996014519425,0.006006006006006006,2,143
Asia,United Arab Emirates,9630959,2020-03-27,0,0,333,2,0.034575996014519425,0.006006006006006006,3,143
Asia,United Arab Emirates,9630959,2020-03-28,72,0,405,2,0.042051887044685786,0.0049382716049382715,4,143
Asia,United Arab Emirates,9630959,2020-03-29,63,0,468,2,0.048593291696081356,0.004273504273504274,5,143
Asia,United Arab Emirates,9630959,2020-03-30,0,0,468,2,0.048593291696081356,0.004273504273504274,6,143
Asia,United Arab Emirates,9630959,2020-03-31,143,3,611,5,0.06344124193655067,0.008183306055646482,7,143
Asia,United Arab Emirates,9630959,2020-04-01,53,1,664,6,0.06894432838931201,0.009036144578313253,8,143
Asia,United Arab Emirates,9630959,2020-04-02,0,0,664,6,0.06894432838931201,0.009036144578313253,9,143
Asia,United Arab Emirates,9630959,2020-04-03,360,2,1024,8,0.10632378354014382,0.0078125,10,143
Asia,United Arab Emirates,9630959,2020-04-04,0,0,1024,8,0.10632378354014382,0.0078125,11,143
Asia,United Arab Emirates,9630959,2020-04-05,481,2,1505,10,0.15626688889444965,0.006644518272425249,12,143
Asia,United Arab Emirates,9630959,2020-04-06,294,0,1799,10,0.18679344393429564,0.005558643690939411,13,143
Asia,United Arab Emirates,9630959,2020-04-07,277,1,2076,11,0.21555485803646346,0.0052986512524084775,14,143
Asia,United Arab Emirates,9630959,2020-04-08,283,1,2359,12,0.2449392630578118,0.005086901229334464,15,143
Asia,United Arab Emirates,9630959,2020-04-09,300,0,2659,12,0.2760888090168383,0.0045129748025573525,16,143
Asia,United Arab Emirates,9630959,2020-04-10,331,2,2990,14,0.3104571413916309,0.0046822742474916385,17,143
Asia,United Arab Emirates,9630959,2020-04-11,370,2,3360,16,0.34887491474109694,0.004761904761904762,18,143
Asia,United Arab Emirates,9630959,2020-04-12,376,4,3736,20,0.38791567900974344,0.0053533190578158455,19,143
Asia,United Arab Emirates,9630959,2020-04-13,387,2,4123,22,0.42809859329688765,0.0053359204462769825,20,143
Asia,United Arab Emirates,9630959,2020-04-14,398,3,4521,25,0.4694236576025295,0.005529750055297501,21,143
Asia,United Arab Emirates,9630959,2020-04-15,412,3,4933,28,0.5122023673862592,0.005676059193188729,22,143
Asia,United Arab Emirates,9630959,2020-04-16,432,5,5365,33,0.5570577135672574,0.006150978564771668,23,143
Asia,United Arab Emirates,9630959,2020-04-17,460,0,5825,33,0.6048203507044314,0.005665236051502146,24,143
Asia,United Arab Emirates,9630959,2020-04-18,0,2,5825,35,0.6048203507044314,0.006008583690987125,25,143
Asia,United Arab Emirates,9630959,2020-04-19,477,2,6302,37,0.6543481287792836,0.005871152015233259,26,143
Asia,United Arab Emirates,9630959,2020-04-20,479,4,6781,41,0.7040835704938625,0.006046305854593718,27,143
Asia,United Arab Emirates,9630959,2020-04-21,484,2,7265,43,0.7543381713077587,0.005918788713007571,28,143
Asia,United Arab Emirates,9630959,2020-04-22,490,3,7755,46,0.8052157630408352,0.005931656995486783,29,143
Asia,United Arab Emirates,9630959,2020-04-23,483,6,8238,52,0.855366532034868,0.006312211701869385,30,143
Asia,United Arab Emirates,9630959,2020-04-24,518,4,8756,56,0.9091514147241203,0.006395614435815441,31,143
Asia,United Arab Emirates,9630959,2020-04-25,525,8,9281,64,0.9636631201524168,0.0068958086413102035,32,143
Asia,United Arab Emirates,9630959,2020-04-26,532,0,9813,64,1.018901648319757,0.006521960664424743,33,143
Asia,United Arab Emirates,9630959,2020-04-27,536,12,10349,76,1.074555503766551,0.007343704705768673,34,143
Asia,United Arab Emirates,9630959,2020-04-28,490,6,10839,82,1.1254330954996279,0.007565273549220408,35,143
Asia,United Arab Emirates,9630959,2020-04-29,541,7,11380,89,1.181606110045739,0.007820738137082601,36,143
Asia,United Arab Emirates,9630959,2020-04-30,549,9,11929,98,1.2386097791507575,0.008215273702741218,37,143
Asia,United Arab Emirates,9630959,2020-05-01,552,7,12481,105,1.2959249437153662,0.008412787436904094,38,143
Asia,United Arab Emirates,9630959,2020-05-02,557,6,13038,111,1.353759267379292,0.008513575701794753,39,143
Asia,United Arab Emirates,9630959,2020-05-03,561,8,13599,119,1.4120089183226718,0.008750643429663946,40,143
Asia,United Arab Emirates,9630959,2020-05-04,564,7,14163,126,1.4705700647256414,0.008896420249947044,41,143
Asia,United Arab Emirates,9630959,2020-05-05,567,11,14730,137,1.5294427065882015,0.009300746775288526,42,143
Asia,United Arab Emirates,9630959,2020-05-06,462,9,15192,146,1.5774130073651025,0.009610321221695629,43,143
Asia,United Arab Emirates,9630959,2020-05-07,546,11,15738,157,1.6341051810105307,0.009975854619392554,44,143
Asia,United Arab Emirates,9630959,2020-05-08,502,8,16240,165,1.6862287545819685,0.010160098522167487,45,143
Asia,United Arab Emirates,9630959,2020-05-09,553,9,16793,174,1.7436477509664405,0.01036146013219794,46,143
Asia,United Arab Emirates,9630959,2020-05-10,624,11,17417,185,1.8084388065612158,0.010621806281219498,47,143
Asia,United Arab Emirates,9630959,2020-05-11,781,13,18198,198,1.8895314578745481,0.010880316518298714,48,143
Asia,United Arab Emirates,9630959,2020-05-12,680,3,18878,201,1.960137095381675,0.010647314334145567,49,143
Asia,United Arab Emirates,9630959,2020-05-13,783,2,19661,203,2.0414374103347344,0.010325008900869742,50,143
Asia,United Arab Emirates,9630959,2020-05-14,725,3,20386,206,2.1167154797357144,0.010104974001765918,51,143
Asia,United Arab Emirates,9630959,2020-05-15,698,2,21084,208,2.189190090000383,0.009865300701954089,52,143
Asia,United Arab Emirates,9630959,2020-05-16,747,2,21831,210,2.2667524594383592,0.009619348632678302,53,143
Asia,United Arab Emirates,9630959,2020-05-17,796,4,22627,214,2.3494025880496427,0.009457727493702214,54,143
Asia,United Arab Emirates,9630959,2020-05-18,731,6,23358,220,2.425303648369804,0.009418614607415018,55,143
Asia,United Arab Emirates,9630959,2020-05-19,832,4,24190,224,2.511691722496171,0.009260024803637867,56,143
Asia,United Arab Emirates,9630959,2020-05-20,873,3,25063,227,2.602336901236938,0.009057175916689942,57,143
Asia,United Arab Emirates,9630959,2020-05-21,941,6,26004,233,2.700042643728418,0.008960159975388403,58,143
Asia,United Arab Emirates,9630959,2020-05-22,894,4,26898,237,2.792868290686317,0.008811064019629711,59,143
Asia,United Arab Emirates,9630959,2020-05-23,994,4,27892,241,2.896077119630558,0.008640470385773698,60,143
Asia,United Arab Emirates,9630959,2020-05-24,812,3,28704,244,2.9803885573596562,0.008500557413600892,61,143
Asia,United Arab Emirates,9630959,2020-05-25,781,1,29485,245,3.0614812086729892,0.008309309818551805,62,143
Asia,United Arab Emirates,9630959,2020-05-26,822,3,30307,248,3.1468309646007215,0.008182928036427228,63,143
Asia,United Arab Emirates,9630959,2020-05-27,779,5,31086,253,3.227715952274327,0.00813871196036801,64,143
Europe,United Kingdom,66488991,2020-03-16,251,15,1391,43,0.020920756640749747,0.030913012221423435,0,144
Europe,United Kingdom,66488991,2020-03-17,152,22,1543,65,0.023206849386539795,0.04212572909915749,1,144
Europe,United Kingdom,66488991,2020-03-18,407,16,1950,81,0.029328163515069734,0.04153846153846154,2,144
Europe,United Kingdom,66488991,2020-03-19,680,34,2630,115,0.039555420535709436,0.043726235741444866,3,144
Europe,United Kingdom,66488991,2020-03-20,647,43,3277,158,0.04928635478917104,0.048214830637778455,4,144
Europe,United Kingdom,66488991,2020-03-21,706,36,3983,194,0.05990465399001167,0.04870700477027366,5,144
Europe,United Kingdom,66488991,2020-03-22,1035,56,5018,250,0.07547114077877946,0.04982064567556795,6,144
Europe,United Kingdom,66488991,2020-03-23,665,35,5683,285,0.08547279654161093,0.05014956888967095,7,144
Europe,United Kingdom,66488991,2020-03-24,967,74,6650,359,0.10001655762831474,0.05398496240601504,8,144
Europe,United Kingdom,66488991,2020-03-25,1427,149,8077,508,0.12147875728780423,0.06289463909867525,9,144
Europe,United Kingdom,66488991,2020-03-26,1452,186,9529,694,0.14331695904364078,0.07283030748242209,10,144
Europe,United Kingdom,66488991,2020-03-27,2129,183,11658,877,0.17533729756855537,0.07522731171727569,11,144
Europe,United Kingdom,66488991,2020-03-28,2885,284,14543,1161,0.2187279394870047,0.07983222168740975,12,144
Europe,United Kingdom,66488991,2020-03-29,2546,294,17089,1455,0.25701999297898803,0.0851424893206156,13,144
Europe,United Kingdom,66488991,2020-03-30,2433,214,19522,1669,0.2936125169954828,0.08549328962196497,14,144
Europe,United Kingdom,66488991,2020-03-31,2619,374,22141,2043,0.3330024966087995,0.09227225509236259,15,144
Europe,United Kingdom,66488991,2020-04-01,3009,382,25150,2425,0.3782581089251302,0.09642147117296222,16,144
Europe,United Kingdom,66488991,2020-04-02,4324,670,29474,3095,0.4432914315093156,0.10500780348781977,17,144
Europe,United Kingdom,66488991,2020-04-03,4244,652,33718,3747,0.5071215473851904,0.11112758763864998,18,144
Europe,United Kingdom,66488991,2020-04-04,4450,714,38168,4461,0.574049920534965,0.1168780129951792,19,144
Europe,United Kingdom,66488991,2020-04-05,3735,760,41903,5221,0.6302246337292139,0.12459728420399493,20,144
Europe,United Kingdom,66488991,2020-04-06,5903,644,47806,5865,0.7190062487186789,0.12268334518679663,21,144
Europe,United Kingdom,66488991,2020-04-07,3802,568,51608,6433,0.7761886475311379,0.12465121686560224,22,144
Europe,United Kingdom,66488991,2020-04-08,3634,1038,55242,7471,0.8308443122561447,0.13524130190796857,23,144
Europe,United Kingdom,66488991,2020-04-09,5491,1034,60733,8505,0.9134294126978104,0.14003918792089967,24,144
Europe,United Kingdom,66488991,2020-04-10,4344,1103,65077,9608,0.9787635369590735,0.1476404874225917,25,144
Europe,United Kingdom,66488991,2020-04-11,5195,1152,70272,10760,1.0568967725799898,0.15311930783242259,26,144
Europe,United Kingdom,66488991,2020-04-12,8719,839,78991,11599,1.1880312637019865,0.1468395133622818,27,144
Europe,United Kingdom,66488991,2020-04-13,5288,686,84279,12285,1.267563227121314,0.14576584914391486,28,144
Europe,United Kingdom,66488991,2020-04-14,4342,744,88621,13029,1.3328672712148693,0.14701932950429356,29,144
Europe,United Kingdom,66488991,2020-04-15,5252,1044,93873,14073,1.411857791615457,0.1499153111118213,30,144
Europe,United Kingdom,66488991,2020-04-16,4603,842,98476,14915,1.4810872975948755,0.15145822332344938,31,144
Europe,United Kingdom,66488991,2020-04-17,4617,1029,103093,15944,1.5505273647482485,0.15465647522140202,32,144
Europe,United Kingdom,66488991,2020-04-18,5599,935,108692,16879,1.6347367942461333,0.15529201781179847,33,144
Europe,United Kingdom,66488991,2020-04-19,5525,1115,114217,17994,1.7178332575388306,0.1575422222611345,34,144
Europe,United Kingdom,66488991,2020-04-20,5850,498,120067,18492,1.80581774808404,0.1540140088450615,35,144
Europe,United Kingdom,66488991,2020-04-21,4676,559,124743,19051,1.876145180184792,0.15272199642464906,36,144
Europe,United Kingdom,66488991,2020-04-22,4301,1172,129044,20223,1.9408325808403377,0.15671398902699854,37,144
Europe,United Kingdom,66488991,2020-04-23,4451,837,133495,21060,2.0077759940739663,0.1577587175549646,38,144
Europe,United Kingdom,66488991,2020-04-24,4583,727,138078,21787,2.0767046983763073,0.15778762728312984,39,144
Europe,United Kingdom,66488991,2020-04-25,5386,1005,143464,22792,2.1577105900133153,0.15886912396141192,40,144
Europe,United Kingdom,66488991,2020-04-26,4913,843,148377,23635,2.231602521987437,0.1592901864844282,41,144
Europe,United Kingdom,66488991,2020-04-27,4463,420,152840,24055,2.298726416227312,0.1573868097356713,42,144
Europe,United Kingdom,66488991,2020-04-28,4309,338,157149,24393,2.363534137553689,0.1552221140446328,43,144
Europe,United Kingdom,66488991,2020-04-29,3996,909,161145,25302,2.4236343126338014,0.15701386949641627,44,144
Europe,United Kingdom,66488991,2020-04-30,4076,795,165221,26097,2.484937694422224,0.15795207630991218,45,144
Europe,United Kingdom,66488991,2020-05-01,6032,674,171253,26771,2.5756594802288397,0.15632426877193392,46,144
Europe,United Kingdom,66488991,2020-05-02,6201,739,177454,27510,2.668923040206762,0.15502609126872316,47,144
Europe,United Kingdom,66488991,2020-05-03,4806,621,182260,28131,2.741205683208518,0.1543454405793921,48,144
Europe,United Kingdom,66488991,2020-05-04,4339,315,186599,28446,2.8064646070505117,0.15244454686252337,49,144
Europe,United Kingdom,66488991,2020-05-05,3985,288,190584,28734,2.866399341208231,0.15076816521848635,50,144
Europe,United Kingdom,66488991,2020-05-06,4406,693,194990,29427,2.9326659506684347,0.15091543156059284,51,144
Europe,United Kingdom,66488991,2020-05-07,6211,649,201201,30076,3.0260799114848953,0.1494823584375823,52,144
Europe,United Kingdom,66488991,2020-05-08,5514,539,206715,30615,3.1090109338552003,0.14810245990856977,53,144
Europe,United Kingdom,66488991,2020-05-09,4649,626,211364,31241,3.178932283691897,0.1478066274294582,54,144
Europe,United Kingdom,66488991,2020-05-10,3896,346,215260,31587,3.237528450386621,0.14673882746446157,55,144
Europe,United Kingdom,66488991,2020-05-11,3923,268,219183,31855,3.2965306993454,0.14533517654197634,56,144
Europe,United Kingdom,66488991,2020-05-12,3877,210,223060,32065,3.3548411044469004,0.14375056038733974,57,144
Europe,United Kingdom,66488991,2020-05-13,3403,627,226463,32692,3.4060225098016605,0.14435912268229248,58,144
Europe,United Kingdom,66488991,2020-05-14,3242,494,229705,33186,3.4547824616559453,0.14447225789599705,59,144
Europe,United Kingdom,66488991,2020-05-15,3446,428,233151,33614,3.506610590616422,0.14417266063624004,60,144
Europe,United Kingdom,66488991,2020-05-16,3560,384,236711,33998,3.560153289136242,0.14362661642255747,61,144
Europe,United Kingdom,66488991,2020-05-17,3450,468,240161,34466,3.6120415784321347,0.14351206065930772,62,144
Europe,United Kingdom,66488991,2020-05-18,3534,170,243695,34636,3.6651932347717535,0.14212848027247174,63,144
Europe,United Kingdom,66488991,2020-05-19,2711,160,246406,34796,3.7059669020996275,0.14121409381265065,64,144
Europe,United Kingdom,66488991,2020-05-20,2412,545,248818,35341,3.7422435843551907,0.14203554405227917,65,144
Europe,United Kingdom,66488991,2020-05-22,2615,338,250908,36042,3.773677359609804,0.14364627672294228,67,144
Europe,United Kingdom,66488991,2020-05-23,3287,351,254195,36393,3.823114115237513,0.14316961387910856,68,144
Europe,United Kingdom,66488991,2020-05-24,2959,282,257154,36675,3.8676177233611497,0.14261881985113978,69,144
Europe,United Kingdom,66488991,2020-05-25,2405,118,259559,36793,3.903789125029736,0.1417519716133904,70,144
Europe,United Kingdom,66488991,2020-05-26,1625,121,261184,36914,3.9282292612922944,0.1413333129135016,71,144
Europe,United Kingdom,66488991,2020-05-27,4043,134,265227,37048,3.9890363203135393,0.13968411964091138,72,144
America,United States,327167434,2020-03-19,2988,42,9415,150,0.028777314064822233,0.015932023366967606,0,145
America,United States,327167434,2020-03-20,4835,0,14250,150,0.04355567981133477,0.010526315789473684,1,145
America,United States,327167434,2020-03-21,5374,110,19624,260,0.0599815200433427,0.013249082755809213,2,145
America,United States,327167434,2020-03-22,7123,80,26747,340,0.08175324687114183,0.012711705985718025,3,145
America,United States,327167434,2020-03-23,8459,131,35206,471,0.10760850971493698,0.013378401408850764,4,145
America,United States,327167434,2020-03-24,11236,119,46442,590,0.14195178117880766,0.012704017914818483,5,145
America,United States,327167434,2020-03-25,8789,211,55231,801,0.1688157018708653,0.014502724918976662,6,145
America,United States,327167434,2020-03-26,13963,249,69194,1050,0.21149415500810512,0.015174726132323612,7,145
America,United States,327167434,2020-03-27,16797,246,85991,1296,0.26283483948466585,0.015071344675605586,8,145
America,United States,327167434,2020-03-28,18695,411,104686,1707,0.3199768348582029,0.0163059052786428,9,145
America,United States,327167434,2020-03-29,19979,484,124665,2191,0.38104342622316134,0.01757510127140737,10,145
America,United States,327167434,2020-03-30,18360,318,143025,2509,0.4371614810537653,0.01754238769445901,11,145
America,United States,327167434,2020-03-31,21595,661,164620,3170,0.5031674393362758,0.01925646944478192,12,145
America,United States,327167434,2020-04-01,24998,909,189618,4079,0.5795747996116264,0.021511670832937802,13,145
America,United States,327167434,2020-04-02,27103,1059,216721,5138,0.6624161743433181,0.023707900941763834,14,145
America,United States,327167434,2020-04-03,28819,915,245540,6053,0.7505025698859746,0.024651787896065813,15,145
America,United States,327167434,2020-04-04,32425,1104,277965,7157,0.8496108448250995,0.02574784595182847,16,145
America,United States,327167434,2020-04-05,34272,1344,312237,8501,0.9543645471755603,0.027226113497119175,17,145
America,United States,327167434,2020-04-06,25398,1146,337635,9647,1.0319945230245624,0.028572274793786188,18,145
America,United States,327167434,2020-04-07,30561,1342,368196,10989,1.1254054093904713,0.029845517061565036,19,145
America,United States,327167434,2020-04-08,30613,1906,398809,12895,1.218975235780955,0.03233377381152381,20,145
America,United States,327167434,2020-04-09,33323,1922,432132,14817,1.3208282826829274,0.0342881341812224,21,145
America,United States,327167434,2020-04-10,33901,1873,466033,16690,1.4244480090888263,0.035812914536095086,22,145
America,United States,327167434,2020-04-11,35527,2087,501560,18777,1.5330376678016187,0.03743719594864024,23,145
America,United States,327167434,2020-04-12,28391,1831,529951,20608,1.6198158646804681,0.038886614045449484,24,145
America,United States,327167434,2020-04-13,27620,1500,557571,22108,1.7042374700411045,0.03965055571398082,25,145
America,United States,327167434,2020-04-14,25023,1541,582594,23649,1.7807212437898083,0.0405925910668493,26,145
America,United States,327167434,2020-04-15,26922,2408,609516,26057,1.8630093849744227,0.04275031336338997,27,145
America,United States,327167434,2020-04-16,30148,4928,639664,30985,1.9551579207605363,0.04843949323394782,28,145
America,United States,327167434,2020-04-17,31667,2299,671331,33284,2.051949339187592,0.049579119689095244,29,145
America,United States,327167434,2020-04-18,30833,3770,702164,37054,2.1461916041435836,0.05277114748121522,30,145
America,United States,327167434,2020-04-19,32922,1856,735086,38910,2.2468189789329704,0.052932582038020044,31,145
America,United States,327167434,2020-04-20,24601,1772,759687,40682,2.322012893251472,0.053551001925793124,32,145
America,United States,327167434,2020-04-21,28065,1857,787752,42539,2.4077946584377954,0.054000497618539846,33,145
America,United States,327167434,2020-04-22,37289,2524,825041,45063,2.5217699387525228,0.05461910377787286,34,145
America,United States,327167434,2020-04-23,17588,1721,842629,46784,2.575528345525979,0.05552146911630148,35,145
America,United States,327167434,2020-04-24,26543,3179,869172,49963,2.6566580584545587,0.05748344401338285,36,145
America,United States,327167434,2020-04-25,21352,1054,890524,51017,2.721921277776076,0.05728874235843166,37,145
America,United States,327167434,2020-04-26,48529,2172,939053,53189,2.8702520557104103,0.056641105454111745,38,145
America,United States,327167434,2020-04-27,26857,1687,965910,54876,2.9523415218643065,0.05681274652917974,39,145
America,United States,327167434,2020-04-28,22541,1369,988451,56245,3.021238965978503,0.056902163081427405,40,145
America,United States,327167434,2020-04-29,24132,2110,1012583,58355,3.094999363536898,0.057629843677012155,41,145
America,United States,327167434,2020-04-30,27326,2611,1039909,60966,3.1785223464509,0.05862628364597287,42,145
America,United States,327167434,2020-05-01,29917,2040,1069826,63006,3.2699648217432302,0.058893689254140395,43,145
America,United States,327167434,2020-05-02,33955,2062,1103781,65068,3.373749601251572,0.058950099702749004,44,145
America,United States,327167434,2020-05-03,29288,1317,1133069,66385,3.463269513554335,0.05858866494450029,45,145
America,United States,327167434,2020-05-04,24972,1297,1158041,67682,3.5395974038173983,0.05844525366545744,46,145
America,United States,327167434,2020-05-05,22593,1252,1180634,68934,3.6086537879561695,0.05838727327859438,47,145
America,United States,327167434,2020-05-06,23841,2144,1204475,71078,3.681524732684733,0.05901160256543307,48,145
America,United States,327167434,2020-05-07,24128,2353,1228603,73431,3.7552729040873913,0.05976788270906062,49,145
America,United States,327167434,2020-05-08,28369,2239,1256972,75670,3.8419838571096903,0.06020022721269845,50,145
America,United States,327167434,2020-05-09,26957,1510,1283929,77180,3.9243789771569997,0.06011235823787764,51,145
America,United States,327167434,2020-05-10,25612,1614,1309541,78794,4.002663052337905,0.06016917377920966,52,145
America,United States,327167434,2020-05-11,20258,734,1329799,79528,4.064582418065485,0.05980452684954644,53,145
America,United States,327167434,2020-05-12,18117,1156,1347916,80684,4.119957733935095,0.05985832945079664,54,145
America,United States,327167434,2020-05-13,22048,1703,1369964,82387,4.187348304354766,0.0601380766209915,55,145
America,United States,327167434,2020-05-14,20782,1746,1390746,84133,4.25086929648383,0.0604948710979575,56,145
America,United States,327167434,2020-05-15,27143,1773,1417889,85906,4.333832932772887,0.06058725330403156,57,145
America,United States,327167434,2020-05-16,25508,1662,1443397,87568,4.411799127904644,0.06066799362891845,58,145
America,United States,327167434,2020-05-17,24487,1186,1467884,88754,4.486644596784655,0.06046390586722111,59,145
America,United States,327167434,2020-05-18,18873,808,1486757,89562,4.544330656088467,0.06023983744485481,60,145
America,United States,327167434,2020-05-19,21841,791,1508598,90353,4.611088522948772,0.05989203220473579,61,145
America,United States,327167434,2020-05-20,19970,1568,1528568,91921,4.672127605463324,0.06013536852792941,62,145
America,United States,327167434,2020-05-21,23285,1518,1551853,93439,4.743299114544512,0.06021124423511763,63,145
America,United States,327167434,2020-05-22,25434,1263,1577287,94702,4.821039125795142,0.060041070521724964,64,145
America,United States,327167434,2020-05-23,24147,1305,1601434,96007,4.894845371437549,0.05995064423510429,65,145
America,United States,327167434,2020-05-24,21236,1080,1622670,97087,4.959754032242708,0.05983163551430667,66,145
America,United States,327167434,2020-05-25,20568,633,1643238,97720,5.022620925039868,0.0594679529076129,67,145
America,United States,327167434,2020-05-26,19064,500,1662302,98220,5.080890783280099,0.05908673634514065,68,145
America,United States,327167434,2020-05-27,18910,696,1681212,98916,5.138689934524473,0.058836125366699736,69,145
America,Uruguay,3449299,2020-03-19,29,0,79,0,0.022903204390225376,0,0,146
America,Uruguay,3449299,2020-03-20,15,0,94,0,0.02725191408457197,0,1,146
America,Uruguay,3449299,2020-03-21,16,0,110,0,0.031890537758541664,0,2,146
America,Uruguay,3449299,2020-03-22,25,0,135,0,0.03913838724911931,0,3,146
America,Uruguay,3449299,2020-03-23,23,0,158,0,0.04580640878045075,0,4,146
America,Uruguay,3449299,2020-03-24,4,0,162,0,0.046966064698943176,0,5,146
America,Uruguay,3449299,2020-03-25,27,0,189,0,0.05479374214876704,0,6,146
America,Uruguay,3449299,2020-03-26,28,0,217,0,0.062911333578214,0,7,146
America,Uruguay,3449299,2020-03-27,21,0,238,0,0.06899952715029924,0,8,146
America,Uruguay,3449299,2020-03-28,0,0,238,0,0.06899952715029924,0,9,146
America,Uruguay,3449299,2020-03-29,21,0,259,0,0.07508772072238447,0,10,146
America,Uruguay,3449299,2020-03-30,36,1,295,1,0.08552462398881629,0.003389830508474576,11,146
America,Uruguay,3449299,2020-03-31,29,0,324,1,0.09393212939788635,0.0030864197530864196,12,146
America,Uruguay,3449299,2020-04-01,6,0,330,1,0.09567161327562498,0.0030303030303030303,13,146
America,Uruguay,3449299,2020-04-02,11,1,341,2,0.09886066705147915,0.005865102639296188,14,146
America,Uruguay,3449299,2020-04-03,18,2,359,4,0.10407911868469506,0.011142061281337047,15,146
America,Uruguay,3449299,2020-04-04,12,0,371,4,0.10755808644017234,0.01078167115902965,16,146
America,Uruguay,3449299,2020-04-05,19,1,390,5,0.11306645205301134,0.01282051282051282,17,146
America,Uruguay,3449299,2020-04-06,17,1,407,6,0.11799498970660416,0.014742014742014743,18,146
America,Uruguay,3449299,2020-04-07,4,0,411,6,0.11915464562509658,0.014598540145985401,19,146
America,Uruguay,3449299,2020-04-08,6,1,417,7,0.12089412950283521,0.016786570743405275,20,146
America,Uruguay,3449299,2020-04-09,9,0,426,7,0.12350335531944318,0.01643192488262911,21,146
America,Uruguay,3449299,2020-04-10,7,0,433,7,0.12553275317680493,0.016166281755196306,22,146
America,Uruguay,3449299,2020-04-11,13,0,446,7,0.1293016349119053,0.01569506726457399,23,146
America,Uruguay,3449299,2020-04-12,7,0,453,7,0.13133103276926703,0.01545253863134658,24,146
America,Uruguay,3449299,2020-04-13,12,1,465,8,0.1348100005247443,0.017204301075268817,25,146
America,Uruguay,3449299,2020-04-14,7,0,472,8,0.13683939838210604,0.01694915254237288,26,146
America,Uruguay,3449299,2020-04-15,11,0,483,8,0.1400284521579602,0.016563146997929608,27,146
America,Uruguay,3449299,2020-04-16,10,1,493,9,0.14292759195419127,0.018255578093306288,28,146
America,Uruguay,3449299,2020-04-17,9,0,502,9,0.14553681777079921,0.017928286852589643,29,146
America,Uruguay,3449299,2020-04-18,6,0,508,9,0.14727630164853786,0.017716535433070866,30,146
America,Uruguay,3449299,2020-04-19,9,0,517,9,0.14988552746514583,0.017408123791102514,31,146
America,Uruguay,3449299,2020-04-20,11,1,528,10,0.15307458124099996,0.01893939393939394,32,146
America,Uruguay,3449299,2020-04-21,7,0,535,10,0.15510397909836174,0.018691588785046728,33,146
America,Uruguay,3449299,2020-04-22,8,2,543,12,0.15742329093534657,0.022099447513812154,34,146
America,Uruguay,3449299,2020-04-23,6,0,549,12,0.15916277481308522,0.02185792349726776,35,146
America,Uruguay,3449299,2020-04-24,8,0,557,12,0.16148208665007005,0.02154398563734291,36,146
America,Uruguay,3449299,2020-04-25,6,0,563,12,0.1632215705278087,0.021314387211367674,37,146
America,Uruguay,3449299,2020-04-26,33,2,596,14,0.1727887318553712,0.02348993288590604,38,146
America,Uruguay,3449299,2020-04-27,10,1,606,15,0.17568787165160224,0.024752475247524754,39,146
America,Uruguay,3449299,2020-04-28,14,0,620,15,0.17974666736632575,0.024193548387096774,40,146
America,Uruguay,3449299,2020-04-29,5,0,625,15,0.18119623726444128,0.024,41,146
America,Uruguay,3449299,2020-04-30,5,0,630,15,0.1826458071625568,0.023809523809523808,42,146
America,Uruguay,3449299,2020-05-01,13,2,643,17,0.1864146888976572,0.026438569206842923,43,146
America,Uruguay,3449299,2020-05-02,5,0,648,17,0.1878642587957727,0.026234567901234566,44,146
America,Uruguay,3449299,2020-05-03,4,0,652,17,0.18902391471426513,0.02607361963190184,45,146
America,Uruguay,3449299,2020-05-04,3,0,655,17,0.18989365665313446,0.025954198473282442,46,146
America,Uruguay,3449299,2020-05-05,2,0,657,17,0.19047348461238067,0.0258751902587519,47,146
America,Uruguay,3449299,2020-05-06,13,0,670,17,0.19424236634748104,0.025373134328358207,48,146
America,Uruguay,3449299,2020-05-07,3,0,673,17,0.19511210828635034,0.02526002971768202,49,146
America,Uruguay,3449299,2020-05-08,11,0,684,17,0.19830116206220452,0.024853801169590642,50,146
America,Uruguay,3449299,2020-05-09,10,1,694,18,0.20120030185843557,0.025936599423631124,51,146
America,Uruguay,3449299,2020-05-10,8,0,702,18,0.20351961369542043,0.02564102564102564,52,146
America,Uruguay,3449299,2020-05-11,5,1,707,19,0.20496918359353597,0.026874115983026876,53,146
America,Uruguay,3449299,2020-05-12,4,0,711,19,0.2061288395120284,0.026722925457102673,54,146
America,Uruguay,3449299,2020-05-13,6,0,717,19,0.20786832338976702,0.026499302649930265,55,146
America,Uruguay,3449299,2020-05-14,2,0,719,19,0.20844815134901323,0.02642559109874826,56,146
America,Uruguay,3449299,2020-05-15,5,0,724,19,0.20989772124712877,0.026243093922651933,57,146
America,Uruguay,3449299,2020-05-16,8,0,732,19,0.2122170330841136,0.025956284153005466,58,146
America,Uruguay,3449299,2020-05-17,1,0,733,19,0.2125069470637367,0.02592087312414734,59,146
America,Uruguay,3449299,2020-05-18,1,1,734,20,0.21279686104335985,0.027247956403269755,60,146
America,Uruguay,3449299,2020-05-19,3,0,737,20,0.21366660298222914,0.027137042062415198,61,146
America,Uruguay,3449299,2020-05-20,1,0,738,20,0.21395651696185225,0.02710027100271003,62,146
America,Uruguay,3449299,2020-05-21,8,0,746,20,0.2162758287988371,0.02680965147453083,63,146
America,Uruguay,3449299,2020-05-22,3,0,749,20,0.2171455707377064,0.0267022696929239,64,146
America,Uruguay,3449299,2020-05-23,4,0,753,20,0.21830522665619884,0.02656042496679947,65,146
America,Uruguay,3449299,2020-05-24,11,2,764,22,0.22149428043205302,0.028795811518324606,66,146
America,Uruguay,3449299,2020-05-25,5,0,769,22,0.22294385033016853,0.02860858257477243,67,146
America,Uruguay,3449299,2020-05-26,18,0,787,22,0.22816230196338444,0.02795425667090216,68,146
America,Uruguay,3449299,2020-05-27,2,0,789,22,0.22874212992263065,0.02788339670468948,69,146
Asia,Uzbekistan,32955400,2020-04-12,172,1,796,4,0.024153856424136862,0.005025125628140704,0,147
Asia,Uzbekistan,32955400,2020-04-13,69,0,865,4,0.026247595234771843,0.004624277456647399,1,147
Asia,Uzbekistan,32955400,2020-04-14,133,0,998,4,0.0302833526523726,0.004008016032064128,2,147
Asia,Uzbekistan,32955400,2020-04-15,167,0,1165,4,0.03535080745492392,0.0034334763948497852,3,147
Asia,Uzbekistan,32955400,2020-04-16,137,0,1302,4,0.03950794103546004,0.0030721966205837174,4,147
Asia,Uzbekistan,32955400,2020-04-17,78,0,1380,4,0.04187477621269959,0.002898550724637681,5,147
Asia,Uzbekistan,32955400,2020-04-18,70,0,1450,4,0.043998859064068405,0.002758620689655172,6,147
Asia,Uzbekistan,32955400,2020-04-19,45,1,1495,5,0.04536434089709122,0.0033444816053511705,7,147
Asia,Uzbekistan,32955400,2020-04-20,70,0,1565,5,0.04748842374846004,0.003194888178913738,8,147
Asia,Uzbekistan,32955400,2020-04-21,92,0,1657,5,0.050280075495973346,0.0030175015087507543,9,147
Asia,Uzbekistan,32955400,2020-04-22,35,1,1692,6,0.05134211692165776,0.0035460992907801418,10,147
Asia,Uzbekistan,32955400,2020-04-23,24,1,1716,7,0.052070373899269926,0.004079254079254079,11,147
Asia,Uzbekistan,32955400,2020-04-24,62,0,1778,7,0.05395170442476802,0.003937007874015748,12,147
Asia,Uzbekistan,32955400,2020-04-25,58,1,1836,8,0.05571165878733075,0.004357298474945534,13,147
Asia,Uzbekistan,32955400,2020-04-26,29,0,1865,8,0.05659163596861212,0.004289544235924933,14,147
Asia,Uzbekistan,32955400,2020-04-27,22,0,1887,8,0.05725920486475661,0.0042395336512983575,15,147
Asia,Uzbekistan,32955400,2020-04-28,17,0,1904,8,0.05777505355723189,0.004201680672268907,16,147
Asia,Uzbekistan,32955400,2020-04-29,35,0,1939,8,0.0588370949829163,0.0041258380608561115,17,147
Asia,Uzbekistan,32955400,2020-04-30,63,1,2002,9,0.06074876954914824,0.004495504495504496,18,147
Asia,Uzbekistan,32955400,2020-05-01,44,0,2046,9,0.062083907341437206,0.004398826979472141,19,147
Asia,Uzbekistan,32955400,2020-05-02,48,0,2094,9,0.06354042129666154,0.004297994269340974,20,147
Asia,Uzbekistan,32955400,2020-05-03,33,0,2127,9,0.06454177464087828,0.004231311706629055,21,147
Asia,Uzbekistan,32955400,2020-05-04,22,1,2149,10,0.06520934353702276,0.004653327128897162,22,147
Asia,Uzbekistan,32955400,2020-05-05,40,0,2189,10,0.06642310516637638,0.0045682960255824575,23,147
Asia,Uzbekistan,32955400,2020-05-06,18,0,2207,10,0.0669692978995855,0.004531037607612143,24,147
Asia,Uzbekistan,32955400,2020-05-07,26,0,2233,10,0.06775824295866535,0.0044782803403493054,25,147
Asia,Uzbekistan,32955400,2020-05-08,65,0,2298,10,0.06973060560636497,0.004351610095735422,26,147
Asia,Uzbekistan,32955400,2020-05-09,38,0,2336,10,0.0708836791542509,0.004280821917808219,27,147
Asia,Uzbekistan,32955400,2020-05-10,51,0,2387,10,0.07243122523167675,0.0041893590280687055,28,147
Asia,Uzbekistan,32955400,2020-05-11,31,0,2418,10,0.0733718904944258,0.0041356492969396195,29,147
Asia,Uzbekistan,32955400,2020-05-12,91,0,2509,10,0.07613319820120527,0.0039856516540454365,30,147
Asia,Uzbekistan,32955400,2020-05-13,38,0,2547,10,0.0772862717490912,0.0039261876717707105,31,147
Asia,Uzbekistan,32955400,2020-05-14,65,1,2612,11,0.07925863439679082,0.004211332312404288,32,147
Asia,Uzbekistan,32955400,2020-05-15,33,0,2645,11,0.08025998774100755,0.004158790170132325,33,147
Asia,Uzbekistan,32955400,2020-05-16,46,0,2691,11,0.0816558136147642,0.004087699739873653,34,147
Asia,Uzbekistan,32955400,2020-05-17,50,0,2741,11,0.08317301565145621,0.004013133892739876,35,147
Asia,Uzbekistan,32955400,2020-05-18,12,1,2753,12,0.0835371441402623,0.004358881220486742,36,147
Asia,Uzbekistan,32955400,2020-05-19,49,1,2802,13,0.08502400213622047,0.0046395431834403995,37,147
Asia,Uzbekistan,32955400,2020-05-20,78,0,2880,13,0.087390837313460007,0.0045138888888888885,38,147
Asia,Uzbekistan,32955400,2020-05-21,70,0,2950,13,0.08951492016482883,0.004406779661016949,39,147
Asia,Uzbekistan,32955400,2020-05-22,56,0,3006,13,0.09121418644592388,0.004324683965402528,40,147
Asia,Uzbekistan,32955400,2020-05-23,72,0,3078,13,0.09339895737876039,0.004223521767381416,41,147
Asia,Uzbekistan,32955400,2020-05-24,54,0,3132,13,0.09503753557838776,0.004150702426564496,42,147
Asia,Uzbekistan,32955400,2020-05-25,32,0,3164,13,0.09600854488187066,0.0041087231352718075,43,147
Asia,Uzbekistan,32955400,2020-05-26,97,0,3261,13,0.09895191683305316,0.003986507206378411,44,147
Asia,Uzbekistan,32955400,2020-05-27,72,1,3333,14,0.10113668776588965,0.0042004200420042,45,147
Africa,Zambia,17351822,2020-05-13,174,0,441,7,0.025415198473105593,0.015873015873015872,0,148
Africa,Zambia,17351822,2020-05-14,5,0,446,7,0.0257033526508052,0.01569506726457399,1,148
Africa,Zambia,17351822,2020-05-15,208,0,654,7,0.03769056644310897,0.010703363914373088,2,148
Africa,Zambia,17351822,2020-05-16,14,0,668,7,0.038497398140667875,0.010479041916167664,3,148
Africa,Zambia,17351822,2020-05-17,11,0,679,7,0.03913133733160702,0.010309278350515464,4,148
Africa,Zambia,17351822,2020-05-18,74,0,753,7,0.04339601916156125,0.009296148738379814,5,148
Africa,Zambia,17351822,2020-05-19,8,0,761,7,0.04385706584588062,0.009198423127463863,6,148
Africa,Zambia,17351822,2020-05-20,11,0,772,7,0.04449100503681976,0.009067357512953367,7,148
Africa,Zambia,17351822,2020-05-21,60,0,832,7,0.04794885516921508,0.008413461538461538,8,148
Africa,Zambia,17351822,2020-05-22,34,0,866,7,0.049908303577572435,0.008083140877598153,9,148
Africa,Zambia,17351822,2020-05-23,54,0,920,7,0.053020368696728215,0.007608695652173913,10,148
Africa,Zambia,17351822,2020-05-24,0,0,920,7,0.053020368696728215,0.007608695652173913,11,148
Africa,Zambia,17351822,2020-05-25,0,0,920,7,0.053020368696728215,0.007608695652173913,12,148
Africa,Zambia,17351822,2020-05-26,0,0,920,7,0.053020368696728215,0.007608695652173913,13,148
Africa,Zambia,17351822,2020-05-27,0,0,920,7,0.053020368696728215,0.007608695652173913,14,148
Europe,Iceland,364134,2020-03-02,6,0,10,0,0.027462417681403,0,0,66
Europe,Iceland,364134,2020-03-03,5,0,15,0,0.041193626522104496,0,1,66
Europe,Iceland,364134,2020-03-04,14,0,29,0,0.0796410112760687,0,2,66
Europe,Iceland,364134,2020-03-05,8,0,37,0,0.10161094542119109,0,3,66
Europe,Iceland,364134,2020-03-06,10,0,47,0,0.1290733631025941,0,4,66
Europe,Iceland,364134,2020-03-07,7,0,54,0,0.1482970554795762,0,5,66
Europe,Iceland,364134,2020-03-08,5,0,59,0,0.1620282643202777,0,6,66
Europe,Iceland,364134,2020-03-09,9,0,68,0,0.1867444402335404,0,7,66
Europe,Iceland,364134,2020-03-10,14,0,82,0,0.2251918249875046,0,8,66
Europe,Iceland,364134,2020-03-11,24,0,106,0,0.29110162742287177,0,9,66
Europe,Iceland,364134,2020-03-12,16,0,122,0,0.3350414957131166,0,10,66
Europe,Iceland,364134,2020-03-13,20,0,142,0,0.3899663310759226,0,11,66
Europe,Iceland,364134,2020-03-14,24,0,166,0,0.45587613351128975,0,12,66
Europe,Iceland,364134,2020-03-15,20,0,186,0,0.5108009688740958,0,13,66
Europe,Iceland,364134,2020-03-16,25,0,211,0,0.5794570130776032,0,14,66
Europe,Iceland,364134,2020-03-17,53,0,264,0,0.7250078267890392,0,15,66
Europe,Iceland,364134,2020-03-18,78,0,342,0,0.9392146847039826,0,16,66
Europe,Iceland,364134,2020-03-19,77,0,419,0,1.1506753008507857,0,17,66
Europe,Iceland,364134,2020-03-20,60,0,479,0,1.3154498069392035,0,18,66
Europe,Iceland,364134,2020-03-21,91,0,570,0,1.565357807839971,0,19,66
Europe,Iceland,364134,2020-03-22,22,0,592,0,1.6257751267390574,0,20,66
Europe,Iceland,364134,2020-03-23,67,0,659,0,1.8097733252044577,0,21,66
Europe,Iceland,364134,2020-03-24,106,1,765,1,2.1008749526273296,0.00130718954248366,22,66
Europe,Iceland,364134,2020-03-25,42,0,807,1,2.2162171068892222,0.0012391573729863693,23,66
Europe,Iceland,364134,2020-03-26,87,0,894,1,2.4551401407174285,0.0011185682326621924,24,66
Europe,Iceland,364134,2020-03-27,70,0,964,1,2.647377064487249,0.001037344398340249,25,66
Europe,Iceland,364134,2020-03-28,56,0,1020,1,2.801166603503106,9.80392156862745e-4,26,66
Europe,Iceland,364134,2020-03-29,66,0,1086,1,2.9824185602003657,9.208103130755065e-4,27,66
Europe,Iceland,364134,2020-03-30,51,0,1137,1,3.122476890375521,8.795074758135445e-4,28,66
Europe,Iceland,364134,2020-03-31,83,0,1220,1,3.350414957131166,8.19672131147541e-4,29,66
Europe,Iceland,364134,2020-04-01,99,2,1319,3,3.6222928921770556,0.002274450341167551,30,66
Europe,Iceland,364134,2020-04-02,45,0,1364,3,3.745873771743369,0.0021994134897360706,31,66
Europe,Iceland,364134,2020-04-03,54,0,1418,3,3.894170827222945,0.0021156558533145277,32,66
Europe,Iceland,364134,2020-04-04,70,0,1488,3,4.086407750992766,0.0020161290322580645,33,66
Europe,Iceland,364134,2020-04-05,74,2,1562,5,4.289629641835149,0.003201024327784891,34,66
Europe,Iceland,364134,2020-04-06,24,1,1586,6,4.355539444270516,0.0037831021437578815,35,66
Europe,Iceland,364134,2020-04-07,30,0,1616,6,4.437926697314725,0.0037128712871287127,36,66
Europe,Iceland,364134,2020-04-08,32,0,1648,6,4.525806433895214,0.0036407766990291263,37,66
Europe,Iceland,364134,2020-04-09,27,1,1675,7,4.599954961635002,0.00417910447761194,38,66
Europe,Iceland,364134,2020-04-10,14,1,1689,8,4.6384023463889665,0.004736530491415038,39,66
Europe,Iceland,364134,2020-04-11,12,0,1701,8,4.67135724760665,0.004703115814226925,40,66
Europe,Iceland,364134,2020-04-12,10,0,1711,8,4.698819665288053,0.004675628287551139,41,66
Europe,Iceland,364134,2020-04-13,9,0,1720,8,4.723535841201316,0.004651162790697674,42,66
Europe,Iceland,364134,2020-04-14,7,0,1727,8,4.7427595335782975,0.004632310364794441,43,66
Europe,Iceland,364134,2020-04-15,12,0,1739,8,4.775714434795982,0.004600345025876941,44,66
Europe,Iceland,364134,2020-04-16,15,1,1754,9,4.816908061318086,0.005131128848346636,45,66
Europe,Iceland,364134,2020-04-17,6,0,1760,9,4.833385511926928,0.005113636363636364,46,66
Europe,Iceland,364134,2020-04-18,11,0,1771,9,4.863594171376471,0.005081874647092038,47,66
Europe,Iceland,364134,2020-04-19,2,1,1773,10,4.869086654912752,0.0056401579244218835,48,66
Europe,Iceland,364134,2020-04-20,5,0,1778,10,4.882817863753454,0.00562429696287964,49,66
Europe,Iceland,364134,2020-04-21,7,0,1785,10,4.902041556130436,0.0056022408963585435,50,66
Europe,Iceland,364134,2020-04-22,4,0,1789,10,4.913026523202997,0.005589714924538848,51,66
Europe,Iceland,364134,2020-04-23,0,0,1789,10,4.913026523202997,0.005589714924538848,52,66
Europe,Iceland,364134,2020-04-24,1,0,1790,10,4.915772764971138,0.00558659217877095,53,66
Europe,Iceland,364134,2020-04-25,2,0,1792,10,4.921265248507418,0.005580357142857143,54,66
Europe,Iceland,364134,2020-04-26,0,0,1792,10,4.921265248507418,0.005580357142857143,55,66
Europe,Iceland,364134,2020-04-27,3,0,1795,10,4.929503973811839,0.005571030640668524,56,66
Europe,Iceland,364134,2020-04-28,2,0,1797,10,4.934996457348119,0.005564830272676683,57,66
Europe,Iceland,364134,2020-04-29,0,0,1797,10,4.934996457348119,0.005564830272676683,58,66
Europe,Iceland,364134,2020-04-30,1,0,1798,10,4.937742699116259,0.0055617352614015575,59,66
Europe,Iceland,364134,2020-05-01,0,0,1798,10,4.937742699116259,0.0055617352614015575,60,66
Europe,Iceland,364134,2020-05-02,1,0,1799,10,4.9404889408844,0.005558643690939411,61,66
Europe,Iceland,364134,2020-05-03,0,0,1799,10,4.9404889408844,0.005558643690939411,62,66
Europe,Iceland,364134,2020-05-04,0,0,1799,10,4.9404889408844,0.005558643690939411,63,66
Europe,Iceland,364134,2020-05-05,0,0,1799,10,4.9404889408844,0.005558643690939411,64,66
Europe,Iceland,364134,2020-05-06,2,0,1801,10,4.945981424420681,0.00555247084952804,65,66
Europe,Iceland,364134,2020-05-07,0,0,1801,10,4.945981424420681,0.00555247084952804,66,66
Europe,Iceland,364134,2020-05-08,0,0,1801,10,4.945981424420681,0.00555247084952804,67,66
Europe,Iceland,364134,2020-05-09,0,0,1801,10,4.945981424420681,0.00555247084952804,68,66
Europe,Iceland,364134,2020-05-10,0,0,1801,10,4.945981424420681,0.00555247084952804,69,66
Europe,Iceland,364134,2020-05-11,0,0,1801,10,4.945981424420681,0.00555247084952804,70,66
Europe,Iceland,364134,2020-05-12,1,0,1802,10,4.94872766618882,0.005549389567147614,71,66
Europe,Iceland,364134,2020-05-13,0,0,1802,10,4.94872766618882,0.005549389567147614,72,66
Europe,Iceland,364134,2020-05-14,0,0,1802,10,4.94872766618882,0.005549389567147614,73,66
Europe,Iceland,364134,2020-05-15,0,0,1802,10,4.94872766618882,0.005549389567147614,74,66
Europe,Iceland,364134,2020-05-16,0,0,1802,10,4.94872766618882,0.005549389567147614,75,66
Europe,Iceland,364134,2020-05-17,0,0,1802,10,4.94872766618882,0.005549389567147614,76,66
Europe,Iceland,364134,2020-05-18,0,0,1802,10,4.94872766618882,0.005549389567147614,77,66
Europe,Iceland,364134,2020-05-19,1,0,1803,10,4.951473907956961,0.005546311702717693,78,66
Europe,Iceland,364134,2020-05-20,0,0,1803,10,4.951473907956961,0.005546311702717693,79,66
Europe,Iceland,364134,2020-05-21,0,0,1803,10,4.951473907956961,0.005546311702717693,80,66
Europe,Iceland,364134,2020-05-22,1,0,1804,10,4.954220149725101,0.005543237250554324,81,66
Europe,Iceland,364134,2020-05-23,0,0,1804,10,4.954220149725101,0.005543237250554324,82,66
Europe,Iceland,364134,2020-05-24,0,0,1804,10,4.954220149725101,0.005543237250554324,83,66
Europe,Iceland,364134,2020-05-25,0,0,1804,10,4.954220149725101,0.005543237250554324,84,66
